Rk,Player,Nation,Pos,Squad,Comp,AGE,Born,90s,Tkl,TklW,Def 3rd,Mid 3rd,Att 3rd,Tkl_on_dribbler,Att,Tkl%,Lost,Blocks,Sh,Pass,Int,Tkl+Int,Clr,Err
1,Max Aarons,eng ENG,DF,Bournemouth,eng Premier League,25.32876712,2000,1,2,2,1,1,0,1,1,100,0,3,1,2,1,3,0,0
2,Max Aarons,eng ENG,"DF,MF",Valencia,es La Liga,25.32876712,2000,1.2,3,3,2,1,0,3,3,100,0,1,0,1,0,3,3,0
3,Rodrigo Abajas,es ESP,DF,Valencia,es La Liga,21.97808219,2003,0.7,3,2,2,1,0,3,3,100,0,1,0,1,1,4,0,0
4,James Abankwah,ie IRL,"DF,MF",Udinese,it Serie A,21.29589041,2004,1,4,2,4,0,0,2,3,66.7,1,2,1,1,1,5,3,0
5,Keyliane Abdallah,fr FRA,FW,Marseille,fr Ligue 1,19.07945205,2006,0,1,1,1,0,0,1,1,100,0,0,0,0,0,1,0,0
6,Yunis Abdelhamid,ma MAR,DF,Saint-Étienne,fr Ligue 1,37.59726027,1987,10.9,17,11,15,2,0,10,16,62.5,6,26,18,8,13,30,57,1
7,Himad Abdelli,dz ALG,"MF,FW",Angers,fr Ligue 1,25.46027397,1999,28.6,45,31,11,20,14,14,43,32.6,29,20,1,19,23,68,23,2
8,Mohamed Abdelmoneim,eg EGY,DF,Nice,fr Ligue 1,26.25205479,1999,9.5,21,14,12,6,3,13,22,59.1,9,11,5,6,15,36,56,1
9,Ali Abdi,tn TUN,"DF,MF",Nice,fr Ligue 1,31.36986301,1993,14.9,43,25,18,14,11,28,43,65.1,15,20,6,14,20,63,34,0
10,Saud Abdulhamid,sa KSA,DF,Roma,it Serie A,25.79452055,1999,2.3,3,2,2,0,1,1,1,100,0,2,0,2,2,5,0,0
11,Abel,es ESP,DF,Osasuna,es La Liga,24.70136986,2000,22.4,59,35,28,24,7,37,59,62.7,22,28,4,24,18,77,61,2
12,Nabil Aberdin,fr FRA,MF,Getafe,es La Liga,22.69589041,2002,2.9,6,4,3,3,0,1,1,100,0,3,0,3,0,6,5,0
13,Oliver Abildgaard,dk DEN,MF,Como,it Serie A,28.89863014,1996,0.1,0,0,0,0,0,0,0,,0,1,0,1,0,0,0,0
14,Matthis Abline,fr FRA,FW,Nantes,fr Ligue 1,22.10136986,2003,27.8,11,5,2,4,5,3,9,33.3,6,15,1,14,3,14,32,1
15,Abner,br BRA,DF,Lyon,fr Ligue 1,24.9369863,2000,12.1,29,20,12,10,7,21,32,65.6,11,15,2,13,5,34,41,0
16,Zakaria Aboukhlal,ma MAR,"MF,FW",Toulouse,fr Ligue 1,25.20547945,2000,20.5,19,11,6,7,6,4,21,19,17,16,1,15,6,25,8,0
17,Abdel Abqar,ma MAR,DF,Alavés,es La Liga,26.15068493,1999,27.4,36,23,24,11,1,20,34,58.8,14,28,18,10,39,75,146,1
18,Tammy Abraham,eng ENG,FW,Roma,it Serie A,27.58630137,1997,0,0,0,0,0,0,0,1,0,1,0,0,0,0,0,0,0
19,Tammy Abraham,eng ENG,FW,Milan,it Serie A,27.58630137,1997,13.1,17,11,2,10,5,6,8,75,2,13,0,13,2,19,16,0
20,Federico Accornero,it ITA,MF,Genoa,it Serie A,21.24109589,2004,0.1,0,0,0,0,0,0,0,,0,0,0,0,0,0,0,0
21,Francesco Acerbi,it ITA,DF,Inter,it Serie A,37.22739726,1988,17.5,23,19,16,7,0,11,17,64.7,6,21,15,6,26,49,75,0
22,Joshua Acheampong,eng ENG,DF,Chelsea,eng Premier League,18.99726027,2006,1.9,2,1,2,0,0,2,2,100,0,1,0,1,1,3,2,0
23,Akor Adams,ng NGA,FW,Sevilla,es La Liga,25.26027397,2000,1.5,0,0,0,0,0,0,0,,0,1,0,1,0,0,1,0
24,Akor Adams,ng NGA,FW,Montpellier,fr Ligue 1,25.26027397,2000,11.9,4,3,1,2,1,3,4,75,1,2,1,1,1,5,5,1
25,Che Adams,sct SCO,FW,Torino,it Serie A,28.80821918,1996,26.5,10,5,1,4,5,0,4,0,4,10,5,5,2,12,17,0
26,Tyler Adams,us USA,MF,Bournemouth,eng Premier League,26.21643836,1999,19,75,46,24,44,7,35,66,53,31,33,10,23,32,107,38,0
27,Junior Adamu,at AUT,FW,Freiburg,de Bundesliga,23.90958904,2001,14.4,6,3,2,2,2,2,9,22.2,7,11,0,11,10,16,16,0
28,Tosin Adarabioyo,eng ENG,DF,Chelsea,eng Premier League,27.60821918,1997,13.7,14,10,10,4,0,8,12,66.7,4,9,7,2,10,24,62,0
29,Martin Adeline,fr FRA,MF,Reims,fr Ligue 1,21.41917808,2003,0.3,1,1,0,1,0,1,2,50,1,0,0,0,0,1,2,0
30,Karim Adeyemi,de GER,"FW,MF",Dortmund,de Bundesliga,23.29041096,2002,14.3,20,14,6,6,8,8,20,40,12,13,1,12,6,26,5,0
31,Simon Adingra,ci CIV,"FW,MF",Brighton,eng Premier League,23.3369863,2002,9.9,21,13,9,8,4,9,21,42.9,12,11,0,11,8,29,5,1
32,Amine Adli,ma MAR,"MF,FW",Leverkusen,de Bundesliga,24.98356164,2000,7,12,7,3,1,8,4,10,40,6,10,0,10,0,12,4,0
33,Yacine Adli,fr FRA,MF,Fiorentina,it Serie A,24.76438356,2000,13.4,32,19,11,16,5,17,38,44.7,21,12,1,11,6,38,19,0
34,Adrián,es ESP,GK,Betis,es La Liga,38.33150685,1987,14,0,0,0,0,0,0,2,0,2,0,0,0,0,0,9,2
35,Adryelson,br BRA,DF,Lyon,fr Ligue 1,27.11506849,1998,0,0,0,0,0,0,0,0,,0,0,0,0,1,1,1,0
36,Vasilije Adžić,me MNE,"MF,FW",Juventus,it Serie A,18.97808219,2006,0.3,2,2,0,1,1,0,1,0,1,0,0,0,0,2,0,0
37,Michel Aebischer,ch SUI,MF,Bologna,it Serie A,28.32328767,1997,7.2,16,11,6,7,3,9,13,69.2,4,4,1,3,6,22,6,0
38,Oladapo Afolayan,eng ENG,"FW,MF",St. Pauli,de Bundesliga,27.22191781,1998,16.9,16,8,4,8,4,6,18,33.3,12,16,1,15,8,24,18,0
39,Emmanuel Agbadou,ci CIV,DF,Wolves,eng Premier League,27.87945205,1997,12.7,27,18,18,9,0,11,17,64.7,6,16,12,4,9,36,77,0
40,Emmanuel Agbadou,ci CIV,DF,Reims,fr Ligue 1,27.87945205,1997,14,25,17,19,3,3,19,26,73.1,7,22,13,9,19,44,64,1
41,Asher Agbinone,eng ENG,MF,Crystal Palace,eng Premier League,19.59726027,2005,0.1,2,1,0,2,0,0,0,,0,0,0,0,0,2,0,0
42,Jeremy Agbonifo,se SWE,"FW,MF",Lens,fr Ligue 1,19.5260274,2005,3.3,7,6,6,0,1,3,7,42.9,4,2,1,1,1,8,0,1
43,Julen Agirrezabala,es ESP,GK,Athletic Club,es La Liga,24.35342466,2000,13.4,0,0,0,0,0,0,1,0,1,0,0,0,0,0,4,0
44,Lucien Agoume,fr FRA,MF,Sevilla,es La Liga,23.23013699,2002,18.5,51,22,16,28,7,20,27,74.1,7,22,9,13,30,81,31,0
45,Felix Agu,de GER,DF,Werder Bremen,de Bundesliga,25.6,1999,17.8,28,13,11,13,4,12,21,57.1,9,23,8,15,18,46,47,0
46,Álvaro Aguado,es ESP,MF,Espanyol,es La Liga,29.00821918,1996,4.8,4,2,2,2,0,2,8,25,6,6,1,5,4,8,5,1
47,Lorenzo Aguado,es ESP,DF,Real Madrid,es La Liga,22.62191781,2002,0.1,0,0,0,0,0,0,0,,0,0,0,0,0,0,2,0
48,Nayef Aguerd,ma MAR,DF,Real Sociedad,es La Liga,29.09589041,1996,18.6,30,24,17,12,1,12,18,66.7,6,21,15,6,13,43,88,0
49,Ruben Aguilar,fr FRA,"DF,MF",Lens,fr Ligue 1,32.02191781,1993,11.6,34,18,17,12,5,24,38,63.2,14,23,3,20,13,47,22,0
50,Naouirou Ahamada,fr FRA,"MF,FW",Rennes,fr Ligue 1,23.09863014,2002,0.6,0,0,0,0,0,0,0,,0,0,0,0,2,2,2,0
51,Honest Ahanor,it ITA,"DF,MF",Genoa,it Serie A,17.19178082,2008,1.9,4,3,0,2,2,4,6,66.7,2,1,0,1,0,4,3,0
52,Erik Ahlstrand,se SWE,"FW,MF",St. Pauli,de Bundesliga,23.55342466,2001,0.5,0,0,0,0,0,0,0,,0,1,0,1,1,1,1,0
53,Jean-Eudes Aholou,ci CIV,MF,Angers,fr Ligue 1,31.12328767,1994,21.8,56,36,26,20,10,22,48,45.8,26,34,14,20,33,89,32,0
54,Joseph Aidoo,gh GHA,DF,Valladolid,es La Liga,29.59452055,1995,6,5,5,3,2,0,2,3,66.7,1,6,3,3,4,9,22,1
55,Joseph Aidoo,gh GHA,DF,Celta Vigo,es La Liga,29.59452055,1995,0,1,0,1,0,0,0,0,,0,0,0,0,0,1,0,0
56,Ayman Aiki,fr FRA,"FW,MF",Saint-Étienne,fr Ligue 1,19.85753425,2005,1.4,3,3,1,2,0,1,1,100,0,1,0,1,1,4,0,0
57,Ola Aina,ng NGA,DF,Nott'ham Forest,eng Premier League,28.56986301,1996,29.4,54,41,39,14,1,35,62,56.5,27,32,12,20,31,85,99,3
58,Rayan Aït-Nouri,dz ALG,DF,Wolves,eng Premier League,23.90958904,2001,31.8,82,52,50,25,7,41,67,61.2,26,40,6,34,24,106,67,1
59,Junior Ajayi,ci CIV,FW,Hellas Verona,it Serie A,20.56164384,2004,0.1,0,0,0,0,0,0,0,,0,0,0,0,0,0,0,0
60,Kristoffer Ajer,no NOR,DF,Brentford,eng Premier League,27.04657534,1998,15.5,25,17,14,10,1,14,26,53.8,12,17,4,13,12,37,49,0
61,Ludovic Ajorque,fr FRA,FW,Brest,fr Ligue 1,31.18630137,1994,25,23,16,3,10,10,7,29,24.1,22,19,5,14,6,29,21,0
62,Manuel Akanji,ch SUI,DF,Manchester City,eng Premier League,29.79178082,1995,19.4,16,11,9,4,3,8,13,61.5,5,11,8,3,7,23,57,3
63,Ümit Akdag,ro ROU,DF,Toulouse,fr Ligue 1,21.57534247,2003,5.5,8,4,3,4,1,5,12,41.7,7,10,8,2,11,19,19,0
64,Nathan Aké,nl NED,DF,Manchester City,eng Premier League,30.20547945,1995,7.5,9,7,7,2,0,4,6,66.7,2,7,2,5,3,12,22,1
65,Ilias Akhomach,ma MAR,"MF,FW",Villarreal,es La Liga,21.04931507,2004,6.5,12,7,4,4,4,6,12,50,6,8,0,8,3,15,13,0
66,Sergio Akieme,es ESP,DF,Reims,fr Ligue 1,27.38082192,1997,26.5,31,21,28,2,1,21,34,61.8,13,26,9,17,17,48,93,4
67,Maghnes Akliouche,fr FRA,"FW,MF",Monaco,fr Ligue 1,23.18630137,2002,25.6,50,31,12,23,15,19,41,46.3,22,20,0,20,14,64,12,0
68,Paul Akouokou,ci CIV,MF,Lyon,fr Ligue 1,27.36986301,1997,0.2,1,0,0,1,0,0,0,,0,0,0,0,1,2,0,1
69,Clément Akpa,ci CIV,DF,Auxerre,fr Ligue 1,23.44109589,2001,24.9,53,33,35,12,6,30,45,66.7,15,37,13,24,39,92,129,2
70,Jean-Daniel Akpa-Akpro,ci CIV,"MF,DF",Monza,it Serie A,32.56164384,1992,6.7,17,11,8,8,1,7,15,46.7,8,17,4,13,9,26,10,1
71,David Akpan Ankeye,ng NGA,"FW,MF",Genoa,it Serie A,23.21643836,2002,0.5,0,0,0,0,0,0,1,0,1,0,0,0,0,0,1,0
72,Kevin Akpoguma,ng NGA,DF,Hoffenheim,de Bundesliga,30.04109589,1995,22.7,50,24,32,12,6,27,40,67.5,13,62,35,27,25,75,107,1
73,Chuba Akpom,eng ENG,FW,Lille,fr Ligue 1,29.56712329,1995,5.8,7,4,0,3,4,1,4,25,3,7,0,7,0,7,3,0
74,David Alaba,at AUT,DF,Real Madrid,es La Liga,32.86027397,1992,3.5,1,0,1,0,0,0,0,,0,5,5,0,6,7,7,0
75,Andreas Albers,dk DEN,FW,St. Pauli,de Bundesliga,35.11506849,1990,0.7,1,1,0,0,1,0,1,0,1,0,0,0,0,1,1,0
76,Raúl Albiol,es ESP,DF,Villarreal,es La Liga,39.6630137,1985,13.2,10,9,9,1,0,6,10,60,4,10,9,1,6,16,69,1
77,Carlos Alcaraz,ar ARG,MF,Southampton,eng Premier League,22.42465753,2002,0.1,0,0,0,0,0,0,0,,0,0,0,0,1,1,0,0
78,Carlos Alcaraz,ar ARG,"FW,MF",Everton,eng Premier League,22.42465753,2002,6.4,11,5,5,3,3,3,9,33.3,6,6,1,5,4,15,7,0
79,Omar Alderete,py PAR,DF,Getafe,es La Liga,28.35342466,1996,30.4,41,27,29,10,2,20,30,66.7,10,33,21,12,36,77,207,1
80,Carles Aleñá,es ESP,"MF,FW",Getafe,es La Liga,27.3260274,1998,5,6,3,2,3,1,4,13,30.8,9,9,1,8,0,6,7,0
81,Carles Aleñá,es ESP,"MF,FW",Alavés,es La Liga,27.3260274,1998,8.5,17,10,6,6,5,7,15,46.7,8,7,0,7,2,19,3,0
82,Ben Alexander Voll,de GER,"GK,MF",St. Pauli,de Bundesliga,24.4,2000,0,0,0,0,0,0,0,0,,0,0,0,0,0,0,0,0
83,Trent Alexander-Arnold,eng ENG,DF,Liverpool,eng Premier League,26.57260274,1998,24.9,70,49,43,18,9,48,101,47.5,53,25,8,17,30,100,54,4
84,Alfon,es ESP,"FW,MF",Celta Vigo,es La Liga,26,1999,12.7,6,2,2,2,2,2,10,20,8,6,0,6,4,10,5,1
85,Mohamed Ali Cho,fr FRA,"FW,MF",Nice,fr Ligue 1,21.28767123,2004,17.9,13,9,4,5,4,4,12,33.3,8,17,1,16,5,18,8,0
86,Faride Alidou,de GER,"FW,MF",Hellas Verona,it Serie A,23.79452055,2001,0.8,0,0,0,0,0,0,0,,0,1,0,1,1,1,3,1
87,Alisson,br BRA,GK,Liverpool,eng Premier League,32.58630137,1992,23.9,1,0,1,0,0,0,1,0,1,0,0,0,0,1,13,1
88,Tadeo Allende,ar ARG,FW,Celta Vigo,es La Liga,26.2,1999,0,0,0,0,0,0,0,0,,0,0,0,0,0,0,0,0
89,Jim Allevinah,ga GAB,FW,Angers,fr Ligue 1,30.18082192,1995,17.8,15,9,5,7,3,3,22,13.6,19,9,0,9,11,26,16,0
90,Dele Alli,eng ENG,MF,Como,it Serie A,29.0630137,1996,0.1,0,0,0,0,0,0,0,,0,0,0,0,0,0,0,0
91,Thiago Almada,ar ARG,"MF,FW",Lyon,fr Ligue 1,24.02191781,2001,7.7,10,7,6,3,1,5,17,29.4,12,2,0,2,5,15,5,3
92,Domingos André Ribeiro Almeida,pt POR,"MF,FW",Valencia,es La Liga,24.92876712,2000,19.5,44,28,16,19,9,14,34,41.2,20,18,2,16,8,52,14,1
93,Iker Almena,es ESP,"FW,DF",Girona,es La Liga,21,2004,0.5,0,0,0,0,0,0,1,0,1,1,0,1,0,0,2,0
94,Miguel Almirón,py PAR,FW,Newcastle Utd,eng Premier League,31.22739726,1994,1.7,3,2,2,0,1,2,3,66.7,1,2,0,2,0,3,0,0
95,Pontus Almqvist,se SWE,"FW,MF",Parma,it Serie A,25.81643836,1999,12.4,17,13,7,7,3,8,17,47.1,9,13,0,13,19,36,8,0
96,Marcos Alonso,es ESP,DF,Celta Vigo,es La Liga,34.34794521,1990,26,31,20,16,12,3,22,39,56.4,17,21,7,14,31,62,115,4
97,Giorgio Altare,it ITA,DF,Venezia,it Serie A,26.73424658,1998,8.4,13,12,8,3,2,8,15,53.3,7,21,11,10,17,30,49,0
98,Adrià Altimira,es ESP,"DF,FW",Leganés,es La Liga,24.10136986,2001,14.1,32,16,21,9,2,17,31,54.8,14,11,6,5,14,46,43,2
99,Sergi Altimira,es ESP,MF,Betis,es La Liga,23.69041096,2001,18.5,53,32,14,33,6,31,53,58.5,22,26,1,25,17,70,35,1
100,Edson Álvarez,mx MEX,MF,West Ham,eng Premier League,27.5260274,1997,18.1,44,23,24,12,8,15,33,45.5,18,21,8,13,16,60,39,1
101,Hugo Álvarez,es ESP,"MF,DF",Celta Vigo,es La Liga,21.83835616,2003,16,23,9,11,10,2,9,17,52.9,8,18,1,17,8,31,26,1
102,Julián Álvarez,ar ARG,FW,Atlético Madrid,es La Liga,25.25479452,2000,25.2,24,16,5,10,9,8,28,28.6,20,14,0,14,0,24,10,1
103,Yeray Álvarez,es ESP,DF,Athletic Club,es La Liga,30.2739726,1995,17.8,24,13,13,9,2,14,20,70,6,10,6,4,33,57,104,1
104,Skelly Alvero,fr FRA,MF,Werder Bremen,de Bundesliga,23,2002,2.6,11,6,5,5,1,4,5,80,1,4,0,4,2,13,10,0
105,Will Alves,eng ENG,FW,Leicester City,eng Premier League,20.24657534,2005,0,0,0,0,0,0,0,0,,0,0,0,0,0,0,0,0
106,Selim Amallah,ma MAR,MF,Valladolid,es La Liga,28.46575342,1996,14,28,16,10,17,1,9,17,52.9,8,20,1,19,14,42,4,1
107,Harry Amass,eng ENG,DF,Manchester Utd,eng Premier League,18.13424658,2007,1.8,4,1,4,0,0,1,3,33.3,2,3,0,3,1,5,8,0
108,Amath,sn SEN,"FW,DF",Valladolid,es La Liga,28.8,1996,3.9,2,0,2,0,0,1,7,14.3,6,7,1,6,2,4,6,0
109,Jordan Amavi,fr FRA,DF,Brest,fr Ligue 1,31.15342466,1994,8.8,24,17,10,11,3,15,21,71.4,6,10,2,8,7,31,18,0
110,Aurele Amenda,ch SUI,DF,Eint Frankfurt,de Bundesliga,21.75890411,2003,1,1,0,1,0,0,0,0,,0,2,2,0,1,2,8,0
111,Kelvin Amian,fr FRA,DF,Nantes,fr Ligue 1,27.23287671,1998,22.3,50,27,37,12,1,26,31,83.9,5,15,9,6,10,60,79,0
112,Michael Amir Murillo,pa PAN,DF,Marseille,fr Ligue 1,29.22465753,1996,24.1,42,26,27,9,6,26,40,65,14,18,7,11,17,59,62,4
113,Nadiem Amiri,de GER,MF,Mainz 05,de Bundesliga,28.51780822,1996,24.5,44,21,13,23,8,16,43,37.2,27,18,4,14,16,60,29,2
114,Samuel Amo-Ameyaw,eng ENG,"FW,DF",Southampton,eng Premier League,18.79452055,2006,0.3,1,0,0,1,0,1,1,100,0,0,0,0,0,1,0,0
115,Samuel Amo-Ameyaw,eng ENG,"DF,FW",Strasbourg,fr Ligue 1,18.79452055,2006,2.4,5,3,3,2,0,2,8,25,6,3,0,3,2,7,1,0
116,Mathis Amougou,fr FRA,MF,Chelsea,eng Premier League,19.29041096,2006,0.1,0,0,0,0,0,0,0,,0,0,0,0,0,0,0,0
117,Mathis Amougou,fr FRA,MF,Saint-Étienne,fr Ligue 1,19.29041096,2006,9.5,21,15,15,5,1,10,19,52.6,9,10,0,10,12,33,4,0
118,Mohamed Amoura,dz ALG,FW,Wolfsburg,de Bundesliga,24.98630137,2000,25.4,24,18,10,5,9,11,33,33.3,22,38,2,36,9,33,22,0
119,Sofyan Amrabat,ma MAR,MF,Fiorentina,it Serie A,28.70136986,1996,2,3,2,1,2,0,2,2,100,0,1,1,0,0,3,2,0
120,Joachim Andersen,dk DEN,DF,Crystal Palace,eng Premier League,28.9260274,1996,1,1,1,1,0,0,1,2,50,1,0,0,0,0,1,7,0
121,Joachim Andersen,dk DEN,DF,Fulham,eng Premier League,28.9260274,1996,25.7,25,17,18,6,1,13,20,65,7,33,26,7,30,55,162,1
122,Elliot Anderson,eng ENG,MF,Nott'ham Forest,eng Premier League,22.49041096,2002,26.4,79,50,48,24,7,42,94,44.7,52,41,8,33,28,107,62,3
123,André,br BRA,MF,Wolves,eng Premier League,23.8,2001,25,80,48,36,37,7,32,57,56.1,25,41,8,33,32,112,27,1
124,Benjamin André,fr FRA,MF,Lille,fr Ligue 1,34.75068493,1990,27.9,94,50,27,58,9,51,90,56.7,39,42,6,36,47,141,54,0
125,Marcos André,br BRA,FW,Valladolid,es La Liga,28.5369863,1996,13.1,10,6,3,5,2,5,13,38.5,8,18,2,16,3,13,10,0
126,Robert Andrich,de GER,"MF,DF",Leverkusen,de Bundesliga,30.61369863,1994,16.5,23,11,8,14,1,7,14,50,7,14,7,7,26,49,21,0
127,Angeliño,es ESP,DF,Roma,it Serie A,28.32876712,1997,31.3,44,23,18,24,2,17,34,50,17,32,9,23,26,70,89,0
128,Lorenzo Anghelè,it ITA,FW,Juventus,it Serie A,20.18356164,2005,0.1,0,0,0,0,0,0,0,,0,0,0,0,0,0,0,0
129,Faustino Anjorin,eng ENG,MF,Empoli,it Serie A,23.44383562,2001,11.6,27,12,7,14,6,9,18,50,9,16,3,13,11,38,19,0
130,Waldemar Anton,de GER,DF,Dortmund,de Bundesliga,28.7890411,1996,19.7,34,21,18,10,6,17,23,73.9,6,29,14,15,28,62,94,1
131,Leandro Antonetti,pr PUR,FW,Sevilla,es La Liga,22.30410959,2003,0.1,0,0,0,0,0,0,0,,0,0,0,0,0,0,0,0
132,Kyllian Antonio,fr FRA,"DF,MF",Lens,fr Ligue 1,17.32876712,2008,1.5,3,2,2,0,1,1,3,33.3,2,3,0,3,3,6,3,1
133,Michail Antonio,jm JAM,FW,West Ham,eng Premier League,35.10136986,1990,9.3,2,2,0,1,1,2,3,66.7,1,6,0,6,0,2,2,0
134,Antoniu,es ESP,"MF,FW",Espanyol,es La Liga,22.66027397,2002,9.1,18,8,7,7,4,8,17,47.1,9,12,2,10,7,25,9,1
135,Antony,br BRA,"DF,MF",Manchester Utd,eng Premier League,25.1890411,2000,1.6,6,3,4,2,0,2,5,40,3,2,0,2,2,8,0,0
136,Antony,br BRA,FW,Betis,es La Liga,25.1890411,2000,11.2,16,7,3,8,5,3,15,20,12,9,0,9,7,23,8,1
137,Anuar,ma MAR,"MF,FW",Valladolid,es La Liga,30.29863014,1995,16.6,34,23,20,9,5,13,25,52,12,22,7,15,15,49,19,1
138,Dennis Appiah,fr FRA,DF,Saint-Étienne,fr Ligue 1,32.90136986,1992,21.6,65,38,37,21,7,37,65,56.9,28,32,7,25,23,88,80,2
139,Aritz Arambarri,es ESP,DF,Leganés,es La Liga,27.25479452,1998,2,1,1,1,0,0,1,1,100,0,2,2,0,3,4,8,0
140,Mauro Arambarri,uy URU,MF,Getafe,es La Liga,29.59178082,1995,26.9,45,26,9,31,5,21,44,47.7,23,33,6,27,13,58,41,0
141,Jon Aramburu,ve VEN,DF,Real Sociedad,es La Liga,22.78082192,2002,24.5,91,65,52,29,10,60,89,67.4,29,34,8,26,28,119,92,0
142,Julian Araujo,mx MEX,DF,Bournemouth,eng Premier League,23.72328767,2001,4.7,8,3,4,4,0,5,12,41.7,7,3,0,3,6,14,16,0
143,Ronald Araújo,uy URU,DF,Barcelona,es La Liga,26.15890411,1999,7.1,12,9,6,5,1,4,4,100,0,6,4,2,8,20,19,0
144,Cameron Archer,eng ENG,FW,Southampton,eng Premier League,23.78630137,2001,15.3,11,7,6,3,2,2,9,22.2,7,5,1,4,2,13,9,0
145,Carlens Arcus,ht HAI,DF,Angers,fr Ligue 1,28.84931507,1996,19.7,46,31,27,14,5,29,48,60.4,19,22,4,18,24,70,69,2
146,Alphonse Areola,fr FRA,GK,West Ham,eng Premier League,32.18082192,1993,22.1,2,2,2,0,0,2,3,66.7,1,0,0,0,0,2,15,2
147,Adu Ares,es ESP,FW,Athletic Club,es La Liga,23.55890411,2001,0.2,0,0,0,0,0,0,1,0,1,0,0,0,0,0,0,0
148,Jesús Areso,es ESP,DF,Osasuna,es La Liga,25.83835616,1999,30.2,45,34,29,11,5,35,51,68.6,16,25,4,21,8,53,79,0
149,David Argüelles,es ESP,MF,Getafe,es La Liga,23.3369863,2002,0.1,0,0,0,0,0,0,0,,0,2,0,2,0,0,0,0
150,Joe Aribo,ng NGA,"MF,DF",Southampton,eng Premier League,28.78630137,1996,21.2,44,30,15,23,6,17,34,50,17,24,9,15,20,64,29,3
151,Adam Armstrong,eng ENG,"FW,MF",Southampton,eng Premier League,28.22739726,1997,13.9,12,3,2,7,3,3,14,21.4,11,6,1,5,3,15,8,0
152,Harrison Armstrong,eng ENG,MF,Everton,eng Premier League,18.28767123,2007,0.5,0,0,0,0,0,0,1,0,1,0,0,0,0,0,1,0
153,José Arnaiz,es ESP,"MF,FW",Osasuna,es La Liga,30.05205479,1995,1.4,6,4,3,2,1,4,7,57.1,3,2,0,2,3,9,1,0
154,Hákon Arnar Haraldsson,is ISL,"MF,FW",Lille,fr Ligue 1,22.06575342,2003,17,32,15,9,15,8,13,29,44.8,16,9,1,8,7,39,4,0
155,Marko Arnautović,at AUT,FW,Inter,it Serie A,36.04109589,1989,5.9,7,6,1,3,3,3,5,60,2,3,0,3,1,8,1,0
156,Maximilian Arnold,de GER,MF,Wolfsburg,de Bundesliga,30.9369863,1994,25.2,33,20,13,18,2,15,33,45.5,18,21,11,10,24,57,69,2
157,Jann-Fiete Arp,de GER,"FW,MF",Holstein Kiel,de Bundesliga,25.32328767,2000,7.7,12,9,5,2,5,4,13,30.8,9,5,0,5,3,15,7,1
158,Sergio Arribas,es ESP,DF,Betis,es La Liga,22.22739726,2003,1,7,4,4,3,0,6,7,85.7,1,2,2,0,3,10,4,0
159,Kepa Arrizabalaga,es ESP,GK,Bournemouth,eng Premier League,30.58356164,1994,28,1,0,1,0,0,0,2,0,2,1,0,1,0,1,14,3
160,Arthur,br BRA,DF,Leverkusen,de Bundesliga,22.13150685,2003,7.1,14,11,3,9,2,5,10,50,5,7,0,7,9,23,23,0
161,Takuma Asano,jp JPN,"FW,MF",Mallorca,es La Liga,30.47945205,1994,10.6,13,9,5,7,1,6,11,54.5,5,6,0,6,5,18,8,0
162,Raúl Asencio,es ESP,DF,Real Madrid,es La Liga,22.21917808,2003,15.1,18,12,15,3,0,9,12,75,3,6,4,2,12,30,74,2
163,Marco Asensio,es ESP,"MF,FW",Aston Villa,eng Premier League,29.28219178,1996,6,7,5,0,7,0,3,9,33.3,6,2,0,2,1,8,3,0
164,Marco Asensio,es ESP,"FW,MF",Paris S-G,fr Ligue 1,29.28219178,1996,6.9,4,3,1,3,0,0,6,0,6,1,0,1,0,4,1,0
165,Kristjan Asllani,al ALB,MF,Inter,it Serie A,23.15342466,2002,9,13,2,8,4,1,7,19,36.8,12,8,1,7,7,20,12,1
166,Iago Aspas,es ESP,"FW,MF",Celta Vigo,es La Liga,37.75616438,1987,17.5,13,8,4,5,4,8,19,42.1,11,16,1,15,7,20,5,0
167,Yaser Asprilla,co COL,"FW,MF",Girona,es La Liga,21.45479452,2003,12.5,14,8,5,6,3,5,14,35.7,9,10,0,10,5,19,4,1
168,Lorenz Assignon,tg TOG,"DF,MF",Rennes,fr Ligue 1,24.86575342,2000,24.9,45,24,23,20,2,16,40,40,24,19,3,16,24,69,71,0
169,Dehmaine Assoumani,fr FRA,"MF,FW",Nantes,fr Ligue 1,20.04657534,2005,0.9,6,3,0,4,2,4,5,80,1,1,0,1,1,7,4,0
170,Valentin Atangana Edoa,fr FRA,MF,Reims,fr Ligue 1,19.69041096,2005,29.7,63,47,28,28,7,25,33,75.8,8,31,15,16,36,99,59,0
171,Arthur Atta,fr FRA,"MF,FW",Udinese,it Serie A,22.30136986,2003,12.2,19,11,9,9,1,10,15,66.7,5,6,4,2,7,26,15,1
172,Noah Atubolu,de GER,GK,Freiburg,de Bundesliga,22.94246575,2002,23.6,0,0,0,0,0,0,0,,0,0,0,0,0,0,13,4
173,Emil Audero,id IDN,GK,Como,it Serie A,28.29041096,1997,8,0,0,0,0,0,0,1,0,1,0,0,0,0,0,4,1
174,Tommaso Augello,it ITA,DF,Cagliari,it Serie A,30.67671233,1994,27.3,47,26,27,16,4,28,39,71.8,11,21,6,15,16,63,97,1
175,Carlos Augusto,br BRA,DF,Inter,it Serie A,26.32054795,1999,17,27,12,12,10,5,12,18,66.7,6,20,9,11,8,35,44,0
176,Yann Aurel Bisseck,de GER,DF,Inter,it Serie A,24.42739726,2000,16.1,15,11,9,4,2,10,13,76.9,3,16,8,8,15,30,59,1
177,Brandon Austin,eng ENG,GK,Tottenham,eng Premier League,26.31780822,1999,1,0,0,0,0,0,0,0,,0,0,0,0,0,0,1,0
178,Ezequiel Ávila,ar ARG,FW,Betis,es La Liga,31.23835616,1994,7.5,8,3,2,2,4,4,10,40,6,4,0,4,2,10,8,0
179,Taiwo Awoniyi,ng NGA,FW,Nott'ham Forest,eng Premier League,27.7260274,1997,4.5,6,3,0,3,3,4,5,80,1,1,0,1,0,6,7,0
180,Yasin Ayari,se SWE,MF,Brighton,eng Premier League,21.57534247,2003,19.3,53,29,15,28,10,20,50,40,30,22,6,16,20,73,23,0
181,Florian Ayé,fr FRA,FW,Auxerre,fr Ligue 1,28.28767123,1997,5.9,2,2,0,0,2,0,2,0,2,6,0,6,7,9,6,0
182,André Ayew,gh GHA,FW,Le Havre,fr Ligue 1,35.37808219,1989,14,17,9,3,6,8,7,11,63.6,4,9,2,7,3,20,21,1
183,Jordan Ayew,gh GHA,"FW,MF",Crystal Palace,eng Premier League,33.64383562,1991,0.2,1,0,0,0,1,0,0,,0,0,0,0,0,1,0,0
184,Jordan Ayew,gh GHA,"FW,MF",Leicester City,eng Premier League,33.64383562,1991,15.8,24,13,7,12,5,6,19,31.6,13,16,0,16,12,36,17,0
185,Neil El Aynaoui,fr FRA,MF,Lens,fr Ligue 1,23.83835616,2001,14.7,36,20,17,13,6,10,29,34.5,19,29,7,22,20,56,26,0
186,Ayman Azhil,ma MAR,MF,Dortmund,de Bundesliga,24.06575342,2001,0.3,1,1,1,0,0,0,0,,0,0,0,0,0,1,0,0
187,Adam Aznou,ma MAR,DF,Valladolid,es La Liga,18.92054795,2006,7.5,24,19,18,6,0,19,35,54.3,16,21,7,14,7,31,17,0
188,Adam Aznou,ma MAR,DF,Bayern Munich,de Bundesliga,18.92054795,2006,0.2,0,0,0,0,0,0,0,,0,0,0,0,0,0,1,0
189,César Azpilicueta,es ESP,DF,Atlético Madrid,es La Liga,35.68219178,1989,8.2,23,12,11,8,4,16,22,72.7,6,6,2,4,3,26,27,0
190,Paulo Azzi,br BRA,DF,Cagliari,it Serie A,30.80273973,1994,4.7,11,9,3,6,2,5,9,55.6,4,5,2,3,5,16,11,0
191,Oussama El Azzouzi,ma MAR,MF,Bologna,it Serie A,23.93150685,2001,0.1,0,0,0,0,0,0,0,,0,0,0,0,2,2,0,0
192,Papa Ba,es ESP,MF,Girona,es La Liga,20.64109589,2004,0.5,1,1,1,0,0,0,0,,0,1,0,1,0,1,1,0
193,Shavy Babicka,ga GAB,"MF,FW",Toulouse,fr Ligue 1,24.92328767,2000,13.1,21,12,6,11,4,10,21,47.6,11,14,0,14,3,24,4,3
194,Jacopo Bacci,it ITA,MF,Empoli,it Serie A,19.8739726,2005,0.3,1,0,1,0,0,1,1,100,0,0,0,0,1,2,1,0
195,Aliou Badara Baldé,gn GUI,"MF,FW",Bochum,de Bundesliga,22.39178082,2002,1,1,1,1,0,0,0,0,,0,2,0,2,0,1,0,0
196,Loïc Bade,fr FRA,DF,Sevilla,es La Liga,25.0630137,2000,27.2,42,25,33,9,0,21,28,75,7,19,11,8,28,70,143,2
197,Milan Badelj,hr CRO,MF,Genoa,it Serie A,36.18630137,1989,15.6,28,15,14,9,5,15,35,42.9,20,18,6,12,18,46,42,0
198,Benoît Badiashile,fr FRA,DF,Chelsea,eng Premier League,24.10684932,2001,3.7,9,6,5,4,0,4,5,80,1,2,2,0,6,15,12,2
199,Alex Baena,es ESP,MF,Villarreal,es La Liga,23.7890411,2001,25.2,26,14,6,13,7,9,33,27.3,24,28,2,26,21,47,19,2
200,Juma Bah,sl SLE,DF,Valladolid,es La Liga,19.0630137,2006,9.6,10,7,7,3,0,3,5,60,2,15,8,7,12,22,60,0
201,Juma Bah,sl SLE,DF,Lens,fr Ligue 1,19.0630137,2006,4.6,11,7,3,8,0,4,6,66.7,2,6,5,1,11,22,27,0
202,Leon Bailey,jm JAM,"FW,MF",Aston Villa,eng Premier League,27.73424658,1997,12.6,6,4,1,3,2,2,10,20,8,6,0,6,3,9,12,0
203,Eric Bailly,ci CIV,DF,Villarreal,es La Liga,31.06027397,1994,6.9,12,4,6,6,0,3,4,75,1,12,6,6,6,18,29,0
204,Theo Bair,ca CAN,FW,Auxerre,fr Ligue 1,25.68493151,1999,10.4,4,3,1,2,1,0,2,0,2,6,2,4,3,7,10,0
205,Stefan Bajcetic,es ESP,"MF,DF",Las Palmas,es La Liga,20.53150685,2004,9.3,25,13,12,10,3,9,24,37.5,15,24,4,20,14,39,24,1
206,Cédric Bakambu,cd COD,FW,Betis,es La Liga,34.0630137,1991,6.8,6,4,0,5,1,3,7,42.9,4,10,1,9,0,6,4,0
207,Mitchel Bakker,nl NED,MF,Atalanta,it Serie A,24.87123288,2000,0.2,1,0,1,0,0,1,1,100,0,0,0,0,0,1,0,0
208,Mitchel Bakker,nl NED,"FW,DF",Lille,fr Ligue 1,24.87123288,2000,12.1,23,13,6,11,6,10,17,58.8,7,9,1,8,11,34,15,0
209,Darryl Bakola,fr FRA,"DF,MF",Marseille,fr Ligue 1,17.42465753,2007,0.2,1,1,0,1,0,0,0,,0,0,0,0,0,1,0,0
210,Ridle Baku,de GER,"FW,MF",Wolfsburg,de Bundesliga,27.07123288,1998,13,23,15,9,9,5,8,19,42.1,11,22,1,21,15,38,15,0
211,Ridle Baku,de GER,"DF,MF",RB Leipzig,de Bundesliga,27.07123288,1998,13,21,18,9,11,1,8,20,40,12,16,2,14,7,28,44,0
212,Dilane Bakwa,fr FRA,"MF,DF",Strasbourg,fr Ligue 1,22.68767123,2002,25.9,26,14,11,8,7,12,23,52.2,11,20,1,19,12,38,26,0
213,Tommaso Baldanzi,it ITA,"MF,FW",Roma,it Serie A,22.11506849,2003,8.8,12,4,5,4,3,4,10,40,6,4,0,4,5,17,8,0
214,Alejandro Balde,es ESP,DF,Barcelona,es La Liga,21.54246575,2003,23.1,16,10,9,4,3,9,14,64.3,5,23,4,19,5,21,25,0
215,Keita Baldé,sn SEN,FW,Monza,it Serie A,30.15616438,1995,5.2,1,1,0,1,0,1,2,50,1,3,0,3,1,2,0,0
216,Carlos Baleba,cm CMR,MF,Brighton,eng Premier League,21.33150685,2004,25.7,71,41,24,32,15,44,72,61.1,28,43,10,33,40,111,37,1
217,Leonardo Balerdi,ar ARG,DF,Marseille,fr Ligue 1,26.26849315,1999,22.3,49,35,27,17,5,24,43,55.8,19,24,14,10,30,79,64,4
218,Iván Balliu,al ALB,DF,Rayo Vallecano,es La Liga,33.3369863,1992,10,12,9,4,5,3,4,12,33.3,8,13,3,10,10,22,30,0
219,Fodé Ballo-Touré,sn SEN,DF,Le Havre,fr Ligue 1,28.33150685,1997,4.3,7,6,2,4,1,4,7,57.1,3,5,1,4,2,9,21,0
220,Botond Balogh,hu HUN,DF,Parma,it Serie A,22.90958904,2002,20.7,28,11,18,10,0,16,22,72.7,6,32,24,8,24,52,130,2
221,Folarin Balogun,us USA,FW,Monaco,fr Ligue 1,23.83561644,2001,6.8,1,1,0,0,1,0,4,0,4,0,0,0,1,2,0,0
222,Mario Balotelli,it ITA,"FW,MF",Genoa,it Serie A,34.7260274,1990,0.7,0,0,0,0,0,0,0,,0,0,0,0,0,0,1,0
223,Abdoulaye Bamba,ci CIV,DF,Angers,fr Ligue 1,35.02465753,1990,16.8,22,12,17,4,1,14,19,73.7,5,14,8,6,19,41,79,0
224,Jonathan Bamba,ci CIV,"FW,MF",Celta Vigo,es La Liga,29.10684932,1996,9,12,7,4,6,2,5,12,41.7,7,6,0,6,5,17,6,0
225,Mohamed Bamba,ci CIV,MF,Reims,fr Ligue 1,20.56986301,2004,0.1,0,0,0,0,0,0,1,0,1,2,1,1,0,0,1,0
226,Samuel Bamba,de GER,"FW,MF",Bochum,de Bundesliga,21.21917808,2004,0.3,1,1,1,0,0,0,0,,0,0,0,0,0,1,0,0
227,Lameck Banda,zm ZAM,"FW,MF",Lecce,it Serie A,24.26027397,2001,6.4,8,5,4,2,2,3,11,27.3,8,6,0,6,2,10,6,1
228,Daniel Bandeira,pt POR,MF,Hellas Verona,it Serie A,25.0630137,2000,4.5,4,0,1,3,0,3,6,50,3,2,1,1,6,10,8,0
229,Mattia Bani,it ITA,DF,Genoa,it Serie A,31.39726027,1993,14.8,18,9,11,5,2,7,11,63.6,4,9,5,4,19,37,77,2
230,Noahkai Banks,us USA,DF,Augsburg,de Bundesliga,18.42191781,2006,3.1,11,5,6,4,1,3,7,42.9,4,4,1,3,5,16,28,0
231,Scott Banks,sct SCO,"FW,MF",St. Pauli,de Bundesliga,23.60273973,2001,1.1,1,1,1,0,0,0,2,0,2,0,0,0,2,3,2,0
232,Adrian Baquerin,es ESP,FW,Valladolid,es La Liga,18.16712329,2007,0.1,0,0,0,0,0,0,0,,0,0,0,0,0,0,1,0
233,Antonín Barák,cz CZE,MF,Fiorentina,it Serie A,30.41643836,1994,0.6,2,0,0,2,0,0,2,0,2,1,1,0,0,2,0,0
234,Federico Barba,it ITA,DF,Como,it Serie A,31.67123288,1993,4.8,2,2,1,1,0,1,4,25,3,2,2,0,4,6,15,0
235,Valentín Barco,ar ARG,"DF,FW",Sevilla,es La Liga,20.78082192,2004,3.2,15,9,8,3,4,12,15,80,3,0,0,0,2,17,5,0
236,Valentín Barco,ar ARG,"MF,DF",Strasbourg,fr Ligue 1,20.78082192,2004,11.1,29,17,22,6,1,16,24,66.7,8,7,3,4,10,39,25,1
237,Bradley Barcola,fr FRA,FW,Paris S-G,fr Ligue 1,22.66849315,2002,22.8,26,16,10,7,9,8,31,25.8,23,25,2,23,19,45,9,0
238,Melvin Bard,fr FRA,"DF,MF",Nice,fr Ligue 1,24.49041096,2000,19.5,48,34,32,12,4,24,42,57.1,18,34,13,21,27,75,56,3
239,Nicolò Barella,it ITA,MF,Inter,it Serie A,28.23561644,1997,26,47,30,17,19,11,25,56,44.6,31,24,3,21,10,57,14,1
240,Gabriel Bares,ch SUI,"MF,DF",Montpellier,fr Ligue 1,24.67945205,2000,0.6,2,2,2,0,0,1,2,50,1,0,0,0,1,3,3,0
241,Borna Barišić,hr CRO,DF,Leganés,es La Liga,32.47945205,1992,0.1,0,0,0,0,0,0,0,,0,0,0,0,0,0,0,0
242,Kike Barja,es ESP,"FW,MF",Osasuna,es La Liga,28.09041096,1997,2.9,5,4,1,3,1,2,3,66.7,1,5,0,5,3,8,4,0
243,Ross Barkley,eng ENG,MF,Aston Villa,eng Premier League,31.4109589,1993,6.3,14,3,4,10,0,9,14,64.3,5,9,3,6,10,24,5,0
244,Aymen Barkok,ma MAR,MF,Mainz 05,de Bundesliga,26.95342466,1998,0.8,2,1,1,1,0,1,1,100,0,1,1,0,2,4,0,0
245,Harvey Barnes,eng ENG,FW,Newcastle Utd,eng Premier League,27.4,1997,15.7,16,9,4,6,6,3,7,42.9,4,7,1,6,6,22,12,1
246,Enzo Barrenechea,ar ARG,MF,Valencia,es La Liga,23.95068493,2001,21.2,52,29,21,25,6,30,42,71.4,12,25,7,18,25,77,45,1
247,Ander Barrenetxea,es ESP,"MF,FW",Real Sociedad,es La Liga,23.35068493,2001,11.9,23,16,7,11,5,5,19,26.3,14,15,0,15,10,33,14,1
248,Pablo Barrios,es ESP,MF,Atlético Madrid,es La Liga,21.88493151,2003,24.6,44,25,21,20,3,22,45,48.9,23,14,4,10,33,77,33,7
249,Thierno Barry,fr FRA,FW,Villarreal,es La Liga,22.53424658,2002,24.3,11,8,2,5,4,4,10,40,6,15,2,13,0,11,18,0
250,Davide Bartesaghi,it ITA,"DF,MF",Milan,it Serie A,19.34520548,2005,0.6,2,1,1,1,0,2,2,100,0,1,1,0,2,4,1,0
251,Marc Bartra,es ESP,DF,Betis,es La Liga,34.29863014,1991,19.5,25,15,17,8,0,12,20,60,8,32,20,12,30,55,136,0
252,Federico Baschirotto,it ITA,DF,Lecce,it Serie A,28.61917808,1996,35,36,24,29,5,2,21,27,77.8,6,44,32,12,23,59,208,2
253,Daniele Baselli,it ITA,MF,Como,it Serie A,33.14520548,1992,0.2,0,0,0,0,0,0,0,,0,0,0,0,1,1,1,0
254,Calvin Bassey,ng NGA,DF,Fulham,eng Premier League,25.33972603,1999,32.2,52,33,34,18,0,21,30,70,9,37,17,20,18,70,105,8
255,Aboubacar Bassinga,ci CIV,MF,Las Palmas,es La Liga,19.80821918,2005,0,0,0,0,0,0,0,0,,0,0,0,0,0,0,0,0
256,Alessandro Bastoni,it ITA,DF,Inter,it Serie A,26.05753425,1999,24.8,40,20,20,14,6,18,27,66.7,9,22,10,12,21,61,48,1
257,Augusto Batalla,ar ARG,GK,Rayo Vallecano,es La Liga,29.0109589,1996,28,4,2,4,0,0,4,6,66.7,2,0,0,0,0,4,11,4
258,Michy Batshuayi,be BEL,FW,Eint Frankfurt,de Bundesliga,31.58630137,1993,2.8,1,1,1,0,0,1,1,100,0,2,0,2,1,2,0,0
259,Dylan Batubinsika,cd COD,DF,Saint-Étienne,fr Ligue 1,29.21369863,1996,21.9,25,13,19,5,1,13,22,59.1,9,23,14,9,38,63,139,3
260,Maximilian Bauer,de GER,DF,Augsburg,de Bundesliga,25.23013699,2000,7.3,14,8,5,7,2,9,14,64.3,5,10,4,6,6,20,35,1
261,Oliver Baumann,de GER,GK,Hoffenheim,de Bundesliga,34.92054795,1990,26,2,2,2,0,0,2,4,50,2,0,0,0,0,2,14,2
262,Christoph Baumgartner,at AUT,"MF,FW",RB Leipzig,de Bundesliga,25.75616438,1999,16.9,43,27,13,19,11,17,40,42.5,23,42,8,34,12,55,22,1
263,Rafael Bauza,es ESP,MF,Espanyol,es La Liga,20.25753425,2005,2,5,3,3,1,1,4,7,57.1,3,3,1,2,0,5,5,0
264,Altay Bayındır,tr TUR,GK,Manchester Utd,eng Premier League,27.05479452,1998,1,0,0,0,0,0,0,1,0,1,0,0,0,0,0,3,1
265,Adrian Beck,de GER,"MF,FW",Heidenheim,de Bundesliga,27.90136986,1997,16.4,36,17,18,12,6,12,35,34.3,23,29,2,27,9,45,16,0
266,Sheraldo Becker,sr SUR,"FW,MF",Real Sociedad,es La Liga,30.23013699,1995,11,2,2,0,2,0,0,2,0,2,4,0,4,1,3,10,0
267,Timo Becker,de GER,DF,Holstein Kiel,de Bundesliga,28.10958904,1997,24.2,46,29,32,9,5,30,40,75,10,27,15,12,16,62,94,1
268,Jan Bednarek,pl POL,DF,Southampton,eng Premier League,29.06027397,1996,27.1,35,18,22,13,0,15,30,50,15,44,33,11,54,89,177,5
269,Donny van de Beek,nl NED,MF,Girona,es La Liga,28.04383562,1997,15.8,29,18,17,7,5,13,26,50,13,19,3,16,10,39,12,0
270,Hannes Behrens,de GER,DF,Hoffenheim,de Bundesliga,0,,0.3,1,1,0,1,0,0,0,,0,1,0,1,2,3,0,0
271,Kevin Behrens,de GER,FW,Wolfsburg,de Bundesliga,34.24657534,1991,1.7,1,1,0,1,0,0,1,0,1,0,0,0,1,2,2,0
272,Maximilian Beier,de GER,"FW,MF",Dortmund,de Bundesliga,22.54520548,2002,17.7,25,16,8,11,6,12,31,38.7,19,15,1,14,7,32,14,1
273,Luken Beitia,es ESP,DF,Real Sociedad,es La Liga,20.84383562,2004,0.1,1,1,1,0,0,1,1,100,0,0,0,0,0,1,2,0
274,Ismael Bekhoucha,ma MAR,"DF,MF",Getafe,es La Liga,20.45205479,2004,0.1,0,0,0,0,0,0,0,,0,0,0,0,2,2,0,0
275,Reda Belahyane,ma MAR,MF,Hellas Verona,it Serie A,20.92328767,2004,18.4,36,26,16,13,7,13,17,76.5,4,20,9,11,10,46,22,1
276,Reda Belahyane,ma MAR,MF,Lazio,it Serie A,20.92328767,2004,2.2,8,6,8,0,0,6,6,100,0,3,2,1,1,9,5,0
277,Haris Belkebla,dz ALG,MF,Angers,fr Ligue 1,31.2630137,1994,19.9,56,38,38,15,3,26,45,57.8,19,30,9,21,35,91,46,1
278,Yassin Belkhdim,fr FRA,MF,Angers,fr Ligue 1,23.21643836,2002,14.9,50,25,24,20,6,24,51,47.1,27,21,6,15,19,69,34,1
279,Stefan Bell,de GER,DF,Mainz 05,de Bundesliga,33.69315068,1991,13.1,18,10,14,4,0,8,13,61.5,5,14,12,2,24,42,89,0
280,Armel Bella Kotchap,de GER,DF,Southampton,eng Premier League,23.39452055,2001,3.7,7,5,5,2,0,3,6,50,3,2,2,0,5,12,21,1
281,Raoul Bellanova,it ITA,DF,Torino,it Serie A,24.96438356,2000,1,0,0,0,0,0,0,1,0,1,0,0,0,0,0,4,0
282,Raoul Bellanova,it ITA,DF,Atalanta,it Serie A,24.96438356,2000,23.6,23,13,8,12,3,12,20,60,8,12,3,9,18,41,42,0
283,Jean-Ricner Bellegarde,fr FRA,"MF,FW",Wolves,eng Premier League,26.85205479,1998,17.2,37,22,17,17,3,13,19,68.4,6,19,3,16,10,47,17,1
284,Héctor Bellerín,es ESP,DF,Betis,es La Liga,30.1260274,1995,6.3,13,7,7,4,2,10,17,58.8,7,4,3,1,6,19,21,0
285,Jude Bellingham,eng ENG,MF,Real Madrid,es La Liga,21.84657534,2003,23.6,53,31,16,24,13,24,37,64.9,13,31,2,29,24,77,18,1
286,Jeanuël Belocian,fr FRA,"DF,MF",Leverkusen,de Bundesliga,20.20821918,2005,0.8,1,1,1,0,0,1,1,100,0,0,0,0,0,1,2,0
287,Andrea Belotti,it ITA,FW,Como,it Serie A,31.36986301,1993,6.6,7,5,1,4,2,1,4,25,3,4,0,4,1,8,8,0
288,Fran Beltrán,es ESP,MF,Celta Vigo,es La Liga,26.24657534,1999,22.8,42,30,19,18,5,19,47,40.4,28,23,5,18,23,65,28,3
289,Lucas Beltrán,ar ARG,"MF,FW",Fiorentina,it Serie A,24.09863014,2001,19.5,20,10,8,7,5,6,18,33.3,12,14,2,12,4,24,14,0
290,Eliesse Ben Seghir,ma MAR,"MF,FW",Monaco,fr Ligue 1,20.2109589,2005,18.4,29,21,10,12,7,17,30,56.7,13,17,0,17,12,41,3,0
291,Carlos Benavídez,uy URU,MF,Alavés,es La Liga,27.09589041,1998,4.4,12,9,6,4,2,4,8,50,4,4,2,2,8,20,11,1
292,Adrian Benedyczak,pl POL,"FW,MF",Parma,it Serie A,24.44109589,2000,2.4,0,0,0,0,0,0,1,0,1,3,1,2,0,0,8,0
293,László Bénes,sk SVK,"MF,FW",Union Berlin,de Bundesliga,27.64931507,1997,5.7,2,2,1,1,0,1,2,50,1,5,1,4,3,5,9,0
294,Iker Benito,es ESP,"FW,MF",Osasuna,es La Liga,22.73150685,2002,0.4,0,0,0,0,0,0,1,0,1,0,0,0,1,1,2,0
295,Ismaël Bennacer,dz ALG,MF,Milan,it Serie A,27.42191781,1997,3.3,5,4,1,3,1,1,7,14.3,6,5,3,2,3,8,1,0
296,Ismaël Bennacer,dz ALG,MF,Marseille,fr Ligue 1,27.42191781,1997,6,20,10,8,11,1,11,16,68.8,5,5,0,5,9,29,1,1
297,Saïd Benrahma,dz ALG,"FW,MF",Lyon,fr Ligue 1,29.73150685,1995,8.2,9,5,4,4,1,3,10,30,7,6,0,6,3,12,2,0
298,Ramy Bensebaini,dz ALG,DF,Dortmund,de Bundesliga,30.04931507,1995,20.5,45,21,22,17,6,27,45,60,18,40,8,32,27,72,77,1
299,Nabil Bentaleb,dz ALG,"MF,FW",Lille,fr Ligue 1,30.44109589,1994,1.9,4,3,2,0,2,3,5,60,2,1,0,1,3,7,5,1
300,Rodrigo Bentancur,uy URU,MF,Tottenham,eng Premier League,27.85753425,1997,16.9,38,20,17,17,4,19,39,48.7,20,24,8,16,36,74,33,1
301,Daniel Bentley,eng ENG,GK,Wolves,eng Premier League,31.80821918,1993,1,0,0,0,0,0,0,0,,0,0,0,0,0,0,0,0
302,Lucas Beraldo,br BRA,DF,Paris S-G,fr Ligue 1,21.44109589,2003,21.2,37,30,29,8,0,22,35,62.9,13,13,6,7,20,57,60,3
303,Yuri Berchiche,es ESP,DF,Athletic Club,es La Liga,35.22739726,1990,18.7,32,20,18,11,3,19,30,63.3,11,20,3,17,20,52,47,2
304,Álex Berenguer,es ESP,"FW,MF",Athletic Club,es La Liga,29.83287671,1995,22,28,12,3,16,9,13,24,54.2,11,17,2,15,9,37,16,0
305,Sander Berge,no NOR,MF,Fulham,eng Premier League,27.21643836,1998,23.2,48,28,22,22,4,25,37,67.6,12,26,8,18,20,68,34,1
306,Lucas Bergvall,se SWE,MF,Tottenham,eng Premier League,19.24931507,2006,13.5,39,19,14,20,5,17,32,53.1,15,18,8,10,24,63,22,3
307,Medon Berisha,al ALB,MF,Lecce,it Serie A,21.53424658,2003,7,12,8,7,3,2,4,8,50,4,5,0,5,10,22,4,2
308,Mergim Berisha,de GER,"FW,MF",Hoffenheim,de Bundesliga,26.98082192,1998,3.7,3,3,1,2,0,0,3,0,3,2,1,1,0,3,3,0
309,Mergim Berisha,de GER,FW,Augsburg,de Bundesliga,26.98082192,1998,0.4,1,0,0,1,0,1,1,100,0,2,1,1,0,1,0,0
310,Adrian Bernabe,es ESP,MF,Parma,it Serie A,23.93972603,2001,15.1,28,18,16,8,4,14,30,46.7,16,22,9,13,6,34,24,1
311,Marc Bernal,es ESP,MF,Barcelona,es La Liga,17.93972603,2007,2.7,8,6,2,5,1,7,8,87.5,1,5,1,4,1,9,4,0
312,Bernardo,br BRA,DF,Bochum,de Bundesliga,29.97260274,1995,17.8,44,26,31,12,1,27,35,77.1,8,33,16,17,25,69,91,4
313,Juan Bernat,es ESP,"DF,MF",Villarreal,es La Liga,32.17534247,1993,2.4,9,7,7,1,1,4,5,80,1,3,1,2,1,10,4,0
314,Juan Bernat,es ESP,"MF,DF",Getafe,es La Liga,32.17534247,1993,7,16,12,8,5,3,6,11,54.5,5,8,3,5,2,18,8,0
315,Maxime Bernauer,fr FRA,DF,Saint-Étienne,fr Ligue 1,26.84109589,1998,6.5,8,7,5,1,2,5,7,71.4,2,6,2,4,4,12,36,1
316,Antoine Bernede,fr FRA,MF,Hellas Verona,it Serie A,25.93972603,1999,5.6,14,7,4,8,2,9,15,60,6,6,1,5,5,19,3,0
317,Alexander Bernhardsson,se SWE,"FW,MF",Holstein Kiel,de Bundesliga,26.65205479,1998,11.6,23,13,6,8,9,16,26,61.5,10,14,0,14,3,26,16,0
318,Victor Bernth Kristiansen,dk DEN,DF,Leicester City,eng Premier League,22.38082192,2002,26.4,85,50,54,26,5,47,87,54,40,37,14,23,40,125,72,3
319,Matúš Bero,sk SVK,MF,Bochum,de Bundesliga,29.65753425,1995,27,60,32,30,20,10,26,57,45.6,31,37,9,28,17,77,35,1
320,Juan Berrocal,es ESP,DF,Getafe,es La Liga,26,1999,10.6,14,7,10,4,0,10,13,76.9,3,3,2,1,13,27,50,0
321,Dimitry Bertaud,cd COD,GK,Montpellier,fr Ligue 1,26.90958904,1998,3,0,0,0,0,0,0,0,,0,0,0,0,0,0,2,0
322,Jan-Niklas Beste,de GER,"FW,MF",Freiburg,de Bundesliga,26.32876712,1999,2.2,1,0,0,0,1,0,6,0,6,3,0,3,1,2,7,0
323,Beto,gw GNB,FW,Everton,eng Premier League,27.25479452,1998,14.1,14,6,2,8,4,5,8,62.5,3,8,1,7,3,17,19,1
324,Sam Beukema,nl NED,DF,Bologna,it Serie A,26.46027397,1998,31.5,53,28,26,24,3,22,41,53.7,19,33,18,15,27,80,108,0
325,Alessandro Bianco,it ITA,MF,Monza,it Serie A,22.5890411,2002,25.2,45,25,21,16,8,24,36,66.7,12,39,14,25,19,64,45,4
326,Alessandro Bianco,it ITA,MF,Fiorentina,it Serie A,22.5890411,2002,0.2,0,0,0,0,0,0,1,0,1,0,0,0,0,0,0,0
327,Mika Biereth,dk DEN,FW,Monaco,fr Ligue 1,22.23287671,2003,12.8,4,4,0,2,2,2,6,33.3,4,10,0,10,4,8,6,0
328,Jaka Bijol,si SVN,DF,Udinese,it Serie A,26.24109589,1999,32,43,25,32,10,1,21,38,55.3,17,37,18,19,37,80,178,1
329,El Bilal Touré,ml MLI,"FW,MF",Stuttgart,de Bundesliga,23.58356164,2001,4,4,1,1,1,2,3,3,100,0,1,0,1,0,4,1,0
330,Philip Billing,dk DEN,MF,Bournemouth,eng Premier League,28.89589041,1996,2,14,5,7,6,1,3,4,75,1,3,0,3,5,19,2,0
331,Philip Billing,dk DEN,MF,Napoli,it Serie A,28.89589041,1996,1.8,9,6,4,4,1,1,2,50,1,4,1,3,4,13,5,0
332,Cristiano Biraghi,it ITA,DF,Torino,it Serie A,32.67123288,1992,9.9,12,9,8,2,2,7,12,58.3,5,10,3,7,8,20,36,0
333,Cristiano Biraghi,it ITA,DF,Fiorentina,it Serie A,32.67123288,1992,4.8,4,4,1,3,0,2,7,28.6,5,2,0,2,4,8,11,0
334,Samuele Birindelli,it ITA,"DF,MF",Monza,it Serie A,25.79178082,1999,12.3,17,13,8,4,5,5,10,50,5,10,2,8,8,25,22,1
335,Tom Bischof,de GER,"MF,FW",Hoffenheim,de Bundesliga,19.84931507,2005,26.7,90,49,33,44,13,37,72,51.4,35,62,11,51,29,119,49,1
336,Yves Bissouma,ml MLI,MF,Tottenham,eng Premier League,28.67671233,1996,13.4,44,28,17,24,3,17,32,53.1,15,7,4,3,14,58,32,4
337,Leonardo Bittencourt,de GER,MF,Werder Bremen,de Bundesliga,31.37260274,1993,10.6,25,9,15,7,3,6,18,33.3,12,8,0,8,14,39,11,0
338,Emmanuel Biumla,fr FRA,DF,Angers,fr Ligue 1,19.9890411,2005,14.6,19,12,14,5,0,12,18,66.7,6,18,8,10,8,27,83,1
339,Marco Bizot,nl NED,GK,Brest,fr Ligue 1,34.15068493,1991,29,2,1,2,0,0,1,1,100,0,0,0,0,0,2,26,0
340,Bjarki Bjarkason,is ISL,"DF,MF",Venezia,it Serie A,24.98082192,2000,1.8,3,2,2,1,0,1,2,50,1,1,0,1,2,5,4,0
341,Antonio Blanco,es ESP,MF,Alavés,es La Liga,24.78082192,2000,26.6,60,37,20,36,4,31,71,43.7,40,27,6,21,39,99,43,1
342,Ludovic Blas,fr FRA,"MF,FW",Rennes,fr Ligue 1,27.33972603,1997,23.7,37,24,9,12,16,22,40,55,18,16,2,14,13,50,9,0
343,Daley Blind,nl NED,DF,Girona,es La Liga,35.15342466,1990,25.9,40,23,22,14,4,25,37,67.6,12,28,8,20,22,62,78,1
344,Myron Boadu,nl NED,FW,Bochum,de Bundesliga,24.30136986,2001,9.7,2,1,0,0,2,1,5,20,4,3,0,3,1,3,4,0
345,Augustine Boakye,gh GHA,"FW,MF",Saint-Étienne,fr Ligue 1,24.49863014,2000,8.1,7,3,3,4,0,3,11,27.3,8,5,0,5,6,13,4,0
346,Oscar Bobb,no NOR,FW,Manchester City,eng Premier League,21.8109589,2003,0.2,0,0,0,0,0,0,0,,0,0,0,0,0,0,0,0
347,Mathéo Bodmer,fr FRA,MF,Le Havre,fr Ligue 1,20.99452055,2004,0.1,0,0,0,0,0,0,0,,0,0,0,0,0,0,1,0
348,Sacha Boey,fr FRA,DF,Bayern Munich,de Bundesliga,24.63835616,2000,6.3,18,5,6,4,8,11,15,73.3,4,6,0,6,2,20,13,0
349,Jeremie Boga,ci CIV,"MF,FW",Nice,fr Ligue 1,28.33150685,1997,11.3,9,5,2,5,2,4,8,50,4,13,0,13,3,12,2,1
350,Lamare Bogarde,nl NED,"DF,MF",Aston Villa,eng Premier League,21.3260274,2004,5.3,14,6,6,6,2,10,16,62.5,6,5,3,2,1,15,13,0
351,Emil Bohinen,no NOR,MF,Genoa,it Serie A,26.14520548,1999,1.8,4,4,3,0,1,2,5,40,3,2,0,2,1,5,6,0
352,Adama Boiro,es ESP,DF,Athletic Club,es La Liga,22.86575342,2002,11.1,20,11,11,7,2,10,14,71.4,4,8,3,5,12,32,26,1
353,Willy Boly,ci CIV,DF,Nott'ham Forest,eng Premier League,34.24657534,1991,1.7,6,1,5,1,0,4,4,100,0,4,2,2,3,9,12,0
354,Moïse Bombito,ca CAN,DF,Nice,fr Ligue 1,25.09589041,2000,22.4,35,23,20,12,3,24,35,68.6,11,34,19,15,18,53,115,7
355,Warren Bondo,fr FRA,MF,Monza,it Serie A,21.63287671,2003,18,35,24,19,12,4,13,19,68.4,6,16,6,10,5,40,8,4
356,Warren Bondo,fr FRA,MF,Milan,it Serie A,21.63287671,2003,1.8,5,3,4,1,0,3,3,100,0,1,0,1,0,5,2,0
357,Victor Boniface,ng NGA,FW,Leverkusen,de Bundesliga,24.36164384,2000,11.2,5,4,0,3,2,3,4,75,1,1,0,1,0,5,5,0
358,Kevin Bonifazi,it ITA,DF,Lecce,it Serie A,28.95890411,1996,0.7,1,1,1,0,0,1,1,100,0,1,1,0,2,3,3,0
359,Ange-Yoan Bonny,fr FRA,FW,Parma,it Serie A,21.52328767,2003,25.3,29,13,3,21,5,8,14,57.1,6,17,2,15,3,32,16,0
360,Sebastiaan Bornauw,be BEL,DF,Wolfsburg,de Bundesliga,26.11780822,1999,8.7,9,6,4,4,1,4,8,50,4,14,12,2,12,21,35,0
361,Sven Botman,nl NED,DF,Newcastle Utd,eng Premier League,25.30684932,2000,2.6,6,4,3,3,0,2,3,66.7,1,2,1,1,4,10,13,0
362,Saïmon Bouabré,fr FRA,"MF,FW",Monaco,fr Ligue 1,18.92328767,2006,0.8,0,0,0,0,0,0,3,0,3,1,0,1,0,0,0,0
363,Ayyoub Bouaddi,fr FRA,MF,Lille,fr Ligue 1,17.58630137,2007,11.6,48,30,21,20,7,18,31,58.1,13,10,3,7,10,58,11,1
364,Badredine Bouanani,dz ALG,"MF,FW",Nice,fr Ligue 1,20.40273973,2004,10.5,11,4,4,4,3,6,17,35.3,11,14,3,11,9,20,4,0
365,Benjamin Bouchouari,ma MAR,MF,Saint-Étienne,fr Ligue 1,23.47123288,2001,18.4,31,24,14,12,5,15,42,35.7,27,18,1,17,17,48,15,2
366,Hicham Boudaoui,dz ALG,MF,Nice,fr Ligue 1,25.6109589,1999,25.1,72,49,27,34,11,29,49,59.2,20,38,11,27,21,93,43,1
367,Carlo Boukhalfa,ma MAR,MF,St. Pauli,de Bundesliga,26.00273973,1999,16.3,24,10,7,16,1,6,17,35.3,11,18,3,15,12,36,21,1
368,Justin Bourgault,fr FRA,DF,Brest,fr Ligue 1,19.63561644,2005,1.4,2,1,1,1,0,0,0,,0,0,0,0,0,2,1,0
369,Benjamin Bourigeaud,fr FRA,MF,Rennes,fr Ligue 1,31.30136986,1994,0.9,1,0,0,1,0,0,2,0,2,2,1,1,2,3,1,0
370,Edoardo Bove,it ITA,"MF,FW",Fiorentina,it Serie A,22.96712329,2002,9.5,24,17,7,14,3,14,28,50,14,12,0,12,6,30,8,0
371,Jarrod Bowen,eng ENG,"FW,MF",West Ham,eng Premier League,28.36986301,1996,29.2,36,23,13,9,14,17,37,45.9,20,21,3,18,16,52,23,0
372,Enzo Boyomo,cm CMR,DF,Osasuna,es La Liga,23.57260274,2001,29.2,61,37,42,15,4,26,33,78.8,7,33,19,14,36,97,114,3
373,Enzo Boyomo,cm CMR,DF,Valladolid,es La Liga,23.57260274,2001,3,6,2,4,2,0,3,3,100,0,4,3,1,1,7,7,0
374,Domagoj Bradarić,hr CRO,DF,Hellas Verona,it Serie A,25.39726027,1999,19.6,32,24,20,8,4,16,26,61.5,10,17,4,13,14,46,46,1
375,Conor Bradley,nir NIR,DF,Liverpool,eng Premier League,21.81917808,2003,5.9,11,8,5,4,2,8,16,50,8,4,0,4,3,14,21,0
376,Bilal Brahimi,dz ALG,MF,Nice,fr Ligue 1,25.13972603,2000,0.8,0,0,0,0,0,0,0,,0,1,0,1,0,0,2,0
377,Julian Brandt,de GER,MF,Dortmund,de Bundesliga,29.00547945,1996,23.7,22,10,11,8,3,14,36,38.9,22,17,0,17,14,36,12,1
378,Jarrad Branthwaite,eng ENG,DF,Everton,eng Premier League,22.85205479,2002,26.1,36,20,26,10,0,20,27,74.1,7,30,22,8,23,59,183,4
379,Darko Brašanac,rs SRB,MF,Leganés,es La Liga,33.22191781,1992,16.3,25,10,5,14,6,9,16,56.3,7,22,10,12,13,38,31,0
380,Lilian Brassier,fr FRA,DF,Marseille,fr Ligue 1,25.50136986,1999,8.7,8,6,8,0,0,5,6,83.3,1,8,3,5,9,17,28,2
381,Lilian Brassier,fr FRA,DF,Rennes,fr Ligue 1,25.50136986,1999,11.7,13,10,10,3,0,8,10,80,2,16,10,6,21,34,54,0
382,Matthias Braunöder,at AUT,MF,Como,it Serie A,23.10410959,2002,3,10,4,6,3,1,7,11,63.6,4,3,0,3,2,12,4,1
383,Iker Bravo,es ESP,"FW,MF",Udinese,it Serie A,20.30410959,2005,7.2,9,5,2,5,2,4,8,50,4,3,0,3,1,10,4,0
384,James Bree,eng ENG,DF,Southampton,eng Premier League,27.56164384,1997,9.9,15,10,5,9,1,7,17,41.2,10,8,3,5,8,23,24,0
385,Tim Breithaupt,de GER,MF,Augsburg,de Bundesliga,23.23561644,2002,1.3,1,1,0,1,0,0,4,0,4,1,0,1,2,3,0,0
386,Gleison Bremer,br BRA,DF,Juventus,it Serie A,28.12876712,1997,6,15,7,9,5,1,4,5,80,1,15,11,4,6,21,16,0
387,Brenner,br BRA,"MF,FW",Udinese,it Serie A,25.29589041,2000,4.3,6,4,2,3,1,3,8,37.5,5,4,0,4,1,7,6,0
388,Ben Brereton,cl CHI,FW,Southampton,eng Premier League,26.04383562,1999,5,3,2,0,2,1,1,9,11.1,8,2,1,1,0,3,4,0
389,Marco Brescianini,it ITA,MF,Atalanta,it Serie A,25.28493151,2000,9.4,15,9,4,7,4,7,9,77.8,2,13,1,12,2,17,5,0
390,Maximilian Breunig,de GER,"FW,MF",Heidenheim,de Bundesliga,24.72054795,2000,3.9,4,3,1,2,1,3,6,50,3,9,2,7,1,5,3,0
391,Anthony Briançon,fr FRA,DF,Saint-Étienne,fr Ligue 1,30.43013699,1994,0,0,0,0,0,0,0,0,,0,0,0,0,0,0,0,0
392,Nathan Broadhead,wls WAL,"MF,FW",Ipswich Town,eng Premier League,27.07945205,1998,6.7,7,3,2,5,0,3,9,33.3,6,6,1,5,4,11,5,0
393,Armando Broja,al ALB,FW,Everton,eng Premier League,23.64657534,2001,3.7,3,1,1,1,1,0,0,,0,3,0,3,1,4,4,0
394,David Brooks,wls WAL,"FW,MF",Bournemouth,eng Premier League,27.82191781,1997,9.2,11,4,2,6,3,1,14,7.1,13,16,2,14,5,16,8,1
395,Arvid Brorsson,se SWE,DF,Monza,it Serie A,25.9890411,1999,1.2,2,2,1,1,0,2,2,100,0,5,4,1,0,2,13,1
396,Moritz Broschinski,de GER,"FW,MF",Bochum,de Bundesliga,24.6109589,2000,15.3,18,14,6,6,6,5,14,35.7,9,18,0,18,1,19,18,0
397,Nathaniel Brown,de GER,"DF,MF",Eint Frankfurt,de Bundesliga,21.88219178,2003,18.7,59,38,31,15,13,39,49,79.6,10,29,0,29,13,72,54,1
398,Jacob Bruun Larsen,dk DEN,"FW,MF",Hoffenheim,de Bundesliga,26.62191781,1998,4.4,4,3,1,2,1,3,8,37.5,5,5,1,4,1,5,2,0
399,Jacob Bruun Larsen,dk DEN,"MF,FW",Stuttgart,de Bundesliga,26.62191781,1998,4.5,1,1,1,0,0,0,2,0,2,7,0,7,1,2,3,1
400,Tajon Buchanan,ca CAN,"DF,FW",Inter,it Serie A,26.23287671,1999,1.1,3,0,2,0,1,1,2,50,1,0,0,0,0,3,3,0
401,Tajon Buchanan,ca CAN,MF,Villarreal,es La Liga,26.23287671,1999,3.3,7,4,5,2,0,5,8,62.5,3,4,0,4,1,8,1,0
402,Ante Budimir,hr CRO,FW,Osasuna,es La Liga,33.78356164,1991,29.1,20,9,3,11,6,3,12,25,9,18,4,14,2,22,19,0
403,Emi Buendía,ar ARG,"MF,FW",Aston Villa,eng Premier League,28.35616438,1996,1.1,6,6,3,2,1,0,5,0,5,5,1,4,0,6,2,0
404,Emi Buendía,ar ARG,MF,Leverkusen,de Bundesliga,28.35616438,1996,2.2,5,4,1,3,1,4,7,57.1,3,4,0,4,0,5,0,0
405,Manu Bueno,es ESP,"MF,FW",Sevilla,es La Liga,20.76986301,2004,1.3,4,3,0,1,3,1,2,50,1,0,0,0,0,4,2,0
406,Santiago Bueno,uy URU,DF,Wolves,eng Premier League,26.48219178,1998,18.7,40,21,21,18,1,17,22,77.3,5,35,20,15,15,55,70,0
407,Endika Buján,es ESP,FW,Athletic Club,es La Liga,22.29589041,2003,0.1,0,0,0,0,0,0,1,0,1,0,0,0,0,0,0,0
408,Marius Bülter,de GER,"FW,DF",Hoffenheim,de Bundesliga,32.09863014,1993,17.7,11,9,3,6,2,8,15,53.3,7,9,2,7,3,14,12,0
409,Facundo Buonanotte,ar ARG,"FW,MF",Leicester City,eng Premier League,20.36164384,2004,16.4,53,32,17,22,14,21,67,31.3,46,32,6,26,11,64,14,0
410,Alessandro Buongiorno,it ITA,DF,Napoli,it Serie A,25.90958904,1999,21.4,39,23,26,12,1,24,32,75,8,30,18,12,35,74,73,2
411,Cameron Burgess,au AUS,DF,Ipswich Town,eng Premier League,29.53424658,1995,16.1,15,10,12,3,0,7,9,77.8,2,18,13,5,14,29,116,3
412,Jonathan Burkardt,de GER,FW,Mainz 05,de Bundesliga,24.81369863,2000,20.5,11,6,1,4,6,4,8,50,4,10,1,9,1,12,13,0
413,Oliver Burke,sct SCO,FW,Werder Bremen,de Bundesliga,28.0739726,1997,9.2,11,4,5,1,5,4,5,80,1,19,0,19,2,13,6,0
414,Dan Burn,eng ENG,DF,Newcastle Utd,eng Premier League,32.98630137,1992,33,33,19,20,12,1,17,32,53.1,15,32,23,9,25,58,171,3
415,Rareș-Cătălin Burnete,ro ROU,FW,Lecce,it Serie A,21.25479452,2004,0.3,0,0,0,0,0,0,1,0,1,0,0,0,0,0,0,0
416,Wes Burns,wls WAL,"FW,DF",Ipswich Town,eng Premier League,30.44383562,1994,10.3,13,11,1,9,3,4,10,40,6,7,2,5,10,23,13,2
417,Marnon Busch,de GER,"DF,MF",Heidenheim,de Bundesliga,30.40273973,1994,15.4,26,17,19,7,0,23,32,71.9,9,23,10,13,13,39,65,5
418,Gianluca Busio,us USA,MF,Venezia,it Serie A,22.93424658,2002,26,45,31,24,12,9,20,47,42.6,27,32,8,24,18,63,49,0
419,Aurélio Buta,pt POR,DF,Reims,fr Ligue 1,28.22739726,1997,21.2,36,23,21,11,4,21,42,50,21,18,4,14,21,57,59,0
420,Jean Butez,fr FRA,GK,Como,it Serie A,29.90410959,1995,17,0,0,0,0,0,0,2,0,2,0,0,0,0,0,16,1
421,Nathan Butler-Oyedeji,eng ENG,FW,Arsenal,eng Premier League,22.32876712,2003,0.1,0,0,0,0,0,0,0,,0,0,0,0,0,0,0,0
422,Marcin Bułka,pl POL,GK,Nice,fr Ligue 1,25.58082192,1999,32,0,0,0,0,0,0,1,0,1,0,0,0,0,0,16,6
423,Pau Cabanes,es ESP,"MF,FW",Villarreal,es La Liga,20.20821918,2005,1.8,4,4,0,3,1,3,4,75,1,5,0,5,3,7,2,1
424,Pau Cabanes,es ESP,"MF,FW",Alavés,es La Liga,20.20821918,2005,2,7,2,4,2,1,5,11,45.5,6,1,0,1,0,7,1,0
425,Rémy Cabella,fr FRA,"FW,MF",Lille,fr Ligue 1,35.15616438,1990,10,34,18,15,10,9,18,31,58.1,13,9,1,8,8,42,4,0
426,Leandro Cabrera,uy URU,DF,Espanyol,es La Liga,33.87945205,1991,28,36,20,25,8,3,17,28,60.7,11,32,22,10,28,64,182,1
427,Liberato Cacace,nz NZL,"DF,MF",Empoli,it Serie A,24.6,2000,21.3,32,21,18,12,2,19,28,67.9,9,24,8,16,20,52,55,0
428,Anthony Caci,fr FRA,DF,Mainz 05,de Bundesliga,27.84109589,1997,27.2,58,38,22,24,12,28,43,65.1,15,32,8,24,22,80,45,2
429,Mathieu Cafaro,fr FRA,"MF,FW",Saint-Étienne,fr Ligue 1,28.10958904,1997,8.1,10,7,4,4,2,4,15,26.7,11,7,1,6,7,17,3,0
430,Moisés Caicedo,ec ECU,MF,Chelsea,eng Premier League,23.50136986,2001,33.2,100,63,36,50,14,50,80,62.5,30,44,9,35,47,147,47,1
431,Tom Cairney,sct SCO,MF,Fulham,eng Premier League,34.28493151,1991,5.5,11,5,4,2,5,4,7,57.1,3,5,1,4,4,15,1,1
432,Jens Cajuste,se SWE,MF,Ipswich Town,eng Premier League,25.73150685,1999,19.8,39,19,18,20,1,19,47,40.4,28,24,9,15,25,64,33,2
433,Davide Calabria,it ITA,DF,Bologna,it Serie A,28.40821918,1996,5.9,12,8,5,5,2,5,11,45.5,6,3,0,3,1,13,19,1
434,Davide Calabria,it ITA,DF,Milan,it Serie A,28.40821918,1996,3.5,10,7,10,0,0,4,7,57.1,3,1,0,1,8,18,8,0
435,Riccardo Calafiori,it ITA,DF,Arsenal,eng Premier League,22.95890411,2002,10.3,26,18,15,9,2,18,29,62.1,11,12,6,6,9,35,25,0
436,Luca Caldirola,it ITA,DF,Monza,it Serie A,34.25205479,1991,8.3,9,5,7,2,0,3,6,50,3,8,6,2,10,19,37,0
437,Fernando Calero,es ESP,"DF,MF",Espanyol,es La Liga,29.63561644,1995,5.1,10,5,7,3,0,4,5,80,1,10,6,4,12,22,30,0
438,Duje Ćaleta-Car,hr CRO,DF,Lyon,fr Ligue 1,28.62739726,1996,15.9,18,10,10,8,0,9,17,52.9,8,29,23,6,16,34,89,2
439,Hakan Çalhanoğlu,tr TUR,MF,Inter,it Serie A,31.23287671,1994,19.7,39,21,6,22,11,18,33,54.5,15,13,6,7,17,56,21,0
440,Dominic Calvert-Lewin,eng ENG,FW,Everton,eng Premier League,28.13424658,1997,17.6,9,7,1,4,4,2,6,33.3,4,6,2,4,6,15,19,0
441,Drissa Camara,ci CIV,"MF,FW",Parma,it Serie A,23.20547945,2002,4.6,9,7,2,6,1,1,9,11.1,8,7,0,7,3,12,1,0
442,Issiaga Camara,gn GUI,MF,Nice,fr Ligue 1,20.24931507,2005,0.2,2,1,0,2,0,0,1,0,1,0,0,0,3,5,0,0
443,Lamine Camara,sn SEN,MF,Monaco,fr Ligue 1,21.3369863,2004,21,63,38,21,32,10,26,46,56.5,20,27,4,23,28,91,29,1
444,Mahdi Camara,fr FRA,"MF,FW",Brest,fr Ligue 1,26.84383562,1998,26.6,66,37,13,36,17,22,42,52.4,20,39,4,35,30,96,28,0
445,Francesco Camarda,it ITA,"FW,MF",Milan,it Serie A,17.15068493,2008,1.8,5,2,0,2,3,2,6,33.3,4,1,1,0,0,5,3,0
446,Eduardo Camavinga,fr FRA,"MF,DF",Real Madrid,es La Liga,22.47945205,2002,12.2,42,26,23,16,3,19,33,57.6,14,24,8,16,18,60,23,0
447,Nicolò Cambiaghi,it ITA,FW,Bologna,it Serie A,24.34794521,2000,4.6,12,8,5,5,2,4,9,44.4,5,8,0,8,2,14,2,0
448,Andrea Cambiaso,it ITA,"DF,FW",Juventus,it Serie A,25.2,2000,22.3,41,26,24,11,6,25,41,61,16,21,3,18,14,55,30,5
449,Axel Camblan,fr FRA,"MF,FW",Brest,fr Ligue 1,21.67671233,2003,0.3,1,1,0,0,1,1,2,50,1,1,0,1,0,1,0,0
450,Sergio Camello,es ESP,FW,Rayo Vallecano,es La Liga,24.22739726,2001,12.6,9,3,2,5,2,4,6,66.7,2,8,1,7,4,13,16,0
451,José Campaña,es ESP,MF,Las Palmas,es La Liga,31.9260274,1993,12.2,18,14,7,9,2,9,16,56.3,7,8,0,8,18,36,19,2
452,Thomas Campaniello,it ITA,FW,Empoli,it Serie A,17.17534247,2008,0.3,0,0,0,0,0,0,1,0,1,0,0,0,0,0,0,0
453,Cole Campbell,us USA,"MF,FW",Dortmund,de Bundesliga,19.2,2006,0.2,0,0,0,0,0,0,0,,0,0,0,0,0,0,1,0
454,Emre Can,de GER,"DF,MF",Dortmund,de Bundesliga,31.30684932,1994,23.1,48,28,30,15,3,17,35,48.6,18,30,17,13,20,68,89,3
455,Peio Canales,es ESP,"MF,FW",Athletic Club,es La Liga,20.29315068,2005,2.1,2,2,0,0,2,1,1,100,0,1,0,1,2,4,1,0
456,Matteo Cancellieri,it ITA,"FW,MF",Parma,it Serie A,23.22191781,2002,15.8,26,16,15,9,2,11,32,34.4,21,15,1,14,13,39,30,0
457,Fali Candé,gw GNB,DF,Venezia,it Serie A,27.2739726,1998,14,21,17,12,8,1,13,19,68.4,6,15,10,5,12,33,72,2
458,Antonio Candela,it ITA,DF,Venezia,it Serie A,25.01917808,2000,11.2,31,21,13,11,7,18,26,69.2,8,7,5,2,8,39,22,2
459,Antonio Candela,it ITA,DF,Valladolid,es La Liga,25.01917808,2000,8,8,6,5,2,1,3,7,42.9,4,9,5,4,5,13,20,0
460,Sergi Canós,es ESP,"MF,FW",Valencia,es La Liga,28.24931507,1997,4,11,7,3,4,4,4,10,40,6,5,1,4,5,16,4,0
461,Jaydee Canvot,fr FRA,"DF,MF",Toulouse,fr Ligue 1,18.76438356,2006,10.3,20,9,13,5,2,11,17,64.7,6,9,2,7,10,30,43,1
462,Pierrick Capelle,fr FRA,MF,Angers,fr Ligue 1,38.05205479,1987,5.4,24,17,10,9,5,9,18,50,9,4,1,3,11,35,5,1
463,Gianluca Caprari,it ITA,"MF,FW",Monza,it Serie A,31.76164384,1993,15.1,19,11,8,8,3,7,13,53.8,6,13,0,13,5,24,2,1
464,Elia Caprile,it ITA,GK,Cagliari,it Serie A,23.69041096,2001,16,0,0,0,0,0,0,2,0,2,0,0,0,0,0,8,1
465,Elia Caprile,it ITA,GK,Napoli,it Serie A,23.69041096,2001,3.6,0,0,0,0,0,0,0,,0,0,0,0,0,0,2,0
466,Gabin Capuano,fr FRA,FW,Lens,fr Ligue 1,19.02191781,2006,0.1,0,0,0,0,0,0,0,,0,0,0,0,0,0,0,0
467,Francesco Caputo,it ITA,FW,Empoli,it Serie A,37.74246575,1987,0.1,0,0,0,0,0,0,0,,0,0,0,0,0,0,0,0
468,Maxence Caqueret,fr FRA,MF,Como,it Serie A,25.21369863,2000,10.2,31,17,13,16,2,18,34,52.9,16,13,1,12,6,37,4,1
469,Maxence Caqueret,fr FRA,MF,Lyon,fr Ligue 1,25.21369863,2000,6.4,21,11,5,11,5,4,22,18.2,18,12,2,10,7,28,2,0
470,Simon Cara,fr FRA,"MF,FW",Montpellier,fr Ligue 1,19.9260274,2005,0.1,0,0,0,0,0,0,0,,0,0,0,0,0,0,0,0
471,Andrea Carboni,it ITA,DF,Monza,it Serie A,24.24383562,2001,21.3,54,30,34,16,4,30,48,62.5,18,26,14,12,24,78,93,3
472,Franco Carboni,it ITA,DF,Venezia,it Serie A,22.08219178,2003,2.5,5,3,5,0,0,5,8,62.5,3,1,1,0,0,5,11,0
473,Valentin Carboni,ar ARG,"MF,FW",Marseille,fr Ligue 1,20.16438356,2005,1.1,2,2,0,1,1,0,1,0,1,1,0,1,1,3,1,0
474,Cárdenas,es ESP,GK,Rayo Vallecano,es La Liga,28.10136986,1997,6,0,0,0,0,0,0,0,,0,0,0,0,0,0,3,0
475,Irvin Cardona,fr FRA,"FW,MF",Espanyol,es La Liga,27.7369863,1997,6.7,8,5,2,4,2,6,16,37.5,10,5,1,4,4,12,10,0
476,Irvin Cardona,fr FRA,FW,Saint-Étienne,fr Ligue 1,27.7369863,1997,9.1,5,4,3,2,0,2,12,16.7,10,15,3,12,2,7,5,2
477,Marc Cardona,es ESP,"FW,DF",Las Palmas,es La Liga,29.82191781,1995,1.2,2,1,1,1,0,0,1,0,1,0,0,0,0,2,0,0
478,Sergi Cardona,es ESP,DF,Villarreal,es La Liga,25.82191781,1999,30.7,66,44,40,19,7,45,73,61.6,28,48,7,41,33,99,114,1
479,Johnny Cardoso,us USA,MF,Betis,es La Liga,23.61917808,2001,21.7,51,28,12,31,8,20,50,40,30,26,12,14,46,97,58,1
480,Tiago Cardoso,lu LUX,GK,Gladbach,de Bundesliga,19.0739726,2006,4.2,1,0,1,0,0,1,1,100,0,0,0,0,0,1,2,2
481,Patrik Carlgren,se SWE,GK,Nantes,fr Ligue 1,33.31780822,1992,4.6,0,0,0,0,0,0,0,,0,0,0,0,0,0,0,0
482,Diego Carlos,br BRA,DF,Aston Villa,eng Premier League,32.1369863,1993,9.2,8,3,6,1,1,4,6,66.7,2,13,7,6,5,13,36,2
483,Carmona,es ESP,DF,Sevilla,es La Liga,23.26027397,2002,29.5,76,54,47,21,8,36,68,52.9,32,32,10,22,63,139,87,3
484,Marco Carnesecchi,it ITA,GK,Atalanta,it Serie A,24.84109589,2000,31,0,0,0,0,0,0,0,,0,1,0,1,0,0,21,2
485,Sergio Carreira,es ESP,"MF,DF",Celta Vigo,es La Liga,24.55616438,2000,15.8,27,16,15,6,6,14,23,60.9,9,18,2,16,16,43,34,0
486,Dani Carvajal,es ESP,DF,Real Madrid,es La Liga,33.30958904,1992,6.8,12,8,7,3,2,9,12,75,3,8,3,5,10,22,19,1
487,Fabio Carvalho,pt POR,"FW,MF",Brentford,eng Premier League,22.67671233,2002,5.1,13,9,4,4,5,6,13,46.2,7,6,1,5,3,16,2,0
488,William Carvalho,pt POR,MF,Betis,es La Liga,33.0739726,1992,3.7,4,3,1,3,0,3,5,60,2,4,1,3,3,7,4,0
489,Cesare Casadei,it ITA,"MF,FW",Torino,it Serie A,22.31232877,2003,9.3,10,4,4,6,0,5,9,55.6,4,3,2,1,5,15,20,0
490,Marc Casado,es ESP,MF,Barcelona,es La Liga,21.63561644,2003,17.9,44,25,7,30,7,20,41,48.8,21,20,5,15,22,66,22,1
491,Nicolò Casale,it ITA,DF,Bologna,it Serie A,27.21643836,1998,8,7,4,4,3,0,3,7,42.9,4,11,7,4,13,20,40,2
492,Nicolò Casale,it ITA,DF,Lazio,it Serie A,27.21643836,1998,1.5,5,3,4,1,0,0,0,,0,4,3,1,1,6,2,0
493,Casemiro,br BRA,MF,Manchester Utd,eng Premier League,33.19178082,1992,14.8,77,46,45,23,9,41,66,62.1,25,33,10,23,12,89,48,3
494,Kaelan Casey,eng ENG,DF,West Ham,eng Premier League,20.51506849,2004,0,0,0,0,0,0,0,0,,0,0,0,0,0,0,1,0
495,Matty Cash,pl POL,DF,Aston Villa,eng Premier League,27.73972603,1997,20,47,27,25,19,3,24,34,70.6,10,18,7,11,21,68,57,2
496,Eiran Cashin,ie IRL,DF,Brighton,eng Premier League,23.48219178,2001,0.2,0,0,0,0,0,0,1,0,1,0,0,0,0,0,2,0
497,Josué Casimir,fr FRA,"FW,MF",Le Havre,fr Ligue 1,23.60821918,2001,19.2,31,21,14,13,4,9,17,52.9,8,15,0,15,5,36,34,1
498,Federico Cassa,it ITA,"MF,FW",Atalanta,it Serie A,19.25205479,2006,0.2,0,0,0,0,0,0,0,,0,1,0,1,0,0,0,0
499,Cristian Cásseres Jr.,ve VEN,MF,Toulouse,fr Ligue 1,25.28493151,2000,28,90,58,41,38,11,42,81,51.9,39,32,7,25,38,128,35,1
500,Timothy Castagne,be BEL,DF,Fulham,eng Premier League,29.4109589,1995,18.3,46,29,28,15,3,26,45,57.8,19,15,6,9,22,68,83,0
501,Valentín Castellanos,ar ARG,FW,Lazio,it Serie A,26.58356164,1998,22.5,11,5,1,4,6,1,9,11.1,8,16,2,14,5,16,20,0
502,Jean-Charles Castelletto,cm CMR,"DF,MF",Nantes,fr Ligue 1,30.26849315,1995,26.1,30,14,14,14,2,16,25,64,9,25,17,8,24,54,133,0
503,Santiago Castro,ar ARG,FW,Bologna,it Serie A,20.59452055,2004,23.9,17,9,4,9,4,5,15,33.3,10,13,2,11,3,20,19,0
504,Gaetano Castrovilli,it ITA,MF,Monza,it Serie A,28.20821918,1997,5.2,12,7,10,2,0,4,10,40,6,7,2,5,2,14,7,0
505,Gaetano Castrovilli,it ITA,"MF,FW",Lazio,it Serie A,28.20821918,1997,1.6,5,2,3,1,1,2,4,50,2,3,0,3,3,8,1,0
506,Danilo Cataldi,it ITA,MF,Fiorentina,it Serie A,30.74246575,1994,19.2,25,16,13,10,2,14,27,51.9,13,17,8,9,22,47,35,0
507,Catena,es ESP,DF,Osasuna,es La Liga,30.51506849,1994,30.2,43,25,32,9,2,25,41,61,16,35,21,14,31,74,193,1
508,Maximiliano Caufriez,be BEL,DF,Valencia,es La Liga,28.2109589,1997,1,1,1,1,0,0,1,1,100,0,2,1,1,1,2,4,0
509,Dani Ceballos,es ESP,MF,Real Madrid,es La Liga,28.73972603,1996,10,34,18,15,14,5,16,26,61.5,10,15,3,12,13,47,9,1
510,Abdoulie Ceesay,gm GAM,FW,St. Pauli,de Bundesliga,21.3260274,2004,0.7,3,3,1,1,1,2,3,66.7,1,2,0,2,0,3,1,0
511,Zeki Çelik,tr TUR,DF,Roma,it Serie A,28.20821918,1997,21.2,54,32,20,26,8,21,37,56.8,16,24,6,18,12,66,71,2
512,Fabien Centonze,fr FRA,DF,Nantes,fr Ligue 1,29.29589041,1996,1.1,3,1,1,1,1,1,3,33.3,2,1,0,1,1,4,8,0
513,Alberto Cerri,it ITA,FW,Como,it Serie A,29.04931507,1996,1,0,0,0,0,0,0,0,,0,2,0,2,0,0,1,0
514,Franco Cervi,ar ARG,"FW,MF",Celta Vigo,es La Liga,30.93972603,1994,2.9,8,3,2,6,0,3,7,42.9,4,4,0,4,8,16,6,0
515,Julian Chabot,de GER,DF,Stuttgart,de Bundesliga,27.22191781,1998,23.2,33,21,17,14,2,14,30,46.7,16,26,17,9,35,68,128,0
516,El Chadaille Bitshiabu,fr FRA,DF,RB Leipzig,de Bundesliga,19.96712329,2005,10.6,22,16,12,9,1,8,17,47.1,9,21,12,9,11,33,81,1
517,Fares Chaïbi,dz ALG,"FW,MF",Eint Frankfurt,de Bundesliga,22.43013699,2002,10.1,13,9,4,5,4,7,18,38.9,11,10,0,10,10,23,31,1
518,Trevoh Chalobah,eng ENG,DF,Crystal Palace,eng Premier League,25.83013699,1999,11.8,20,16,7,12,1,12,23,52.2,11,19,9,10,19,39,57,3
519,Trevoh Chalobah,eng ENG,DF,Chelsea,eng Premier League,25.83013699,1999,8.3,7,4,3,4,0,5,6,83.3,1,4,2,2,7,14,39,1
520,Timothy Chandler,us USA,DF,Eint Frankfurt,de Bundesliga,35.09863014,1990,0.3,0,0,0,0,0,0,0,,0,0,0,0,3,3,2,0
521,Conor Chaplin,eng ENG,"MF,FW",Ipswich Town,eng Premier League,28.2109589,1997,7.9,12,5,4,6,2,6,13,46.2,7,8,1,7,3,15,3,0
522,Brendan Chardonnet,fr FRA,DF,Brest,fr Ligue 1,30.36438356,1994,25.8,41,31,26,12,3,21,36,58.3,15,45,28,17,28,69,163,2
523,Gabriel Charpentier,cg CGO,FW,Parma,it Serie A,25.96438356,1999,3,4,3,2,1,1,3,4,75,1,3,0,3,0,4,9,0
524,Raúl Chasco,es ESP,DF,Valladolid,es La Liga,21.63835616,2003,1.4,4,1,3,1,0,2,4,50,2,1,0,1,2,6,2,0
525,Anrie Chase,jp JPN,DF,Stuttgart,de Bundesliga,21.11232877,2004,8.2,10,4,6,4,0,5,7,71.4,2,10,6,4,9,19,35,0
526,Pep Chavarría,es ESP,"DF,FW",Rayo Vallecano,es La Liga,27.06575342,1998,25.4,39,30,25,13,1,24,38,63.2,14,31,8,23,26,65,98,1
527,Arthur Chaves,br BRA,DF,Hoffenheim,de Bundesliga,24.26027397,2001,22.3,46,32,26,16,4,22,46,47.8,24,44,18,26,31,77,122,3
528,Jhoanner Chávez,ec ECU,"DF,MF",Lens,fr Ligue 1,23.02465753,2002,6.6,9,5,4,4,1,2,7,28.6,5,10,1,9,6,15,13,0
529,Walid Cheddira,ma MAR,FW,Napoli,it Serie A,27.27945205,1998,0.1,0,0,0,0,0,0,0,,0,0,0,0,0,0,0,0
530,Walid Cheddira,ma MAR,FW,Espanyol,es La Liga,27.27945205,1998,6.8,5,0,1,1,3,0,1,0,1,4,0,4,1,6,6,0
531,Chema,es ESP,MF,Real Madrid,es La Liga,20.02465753,2005,0.1,0,0,0,0,0,0,0,,0,0,0,0,0,0,1,0
532,Théo Chennahi,fr FRA,"MF,DF",Montpellier,fr Ligue 1,20.23835616,2005,0.1,0,0,0,0,0,0,0,,0,1,0,1,0,0,0,0
533,Sidiki Cherif,fr FRA,FW,Angers,fr Ligue 1,18.38356164,2006,3.6,5,5,1,3,1,3,4,75,1,4,1,3,0,5,0,1
534,Rayan Cherki,fr FRA,"FW,MF",Lyon,fr Ligue 1,21.71232877,2003,20.4,14,11,3,7,4,5,26,19.2,21,6,0,6,7,21,6,0
535,Youssef Chermiti,pt POR,"FW,MF",Everton,eng Premier League,20.94520548,2004,0.5,0,0,0,0,0,0,1,0,1,0,0,0,0,0,0,0
536,Lucas Chevalier,fr FRA,GK,Lille,fr Ligue 1,23.49041096,2001,31,3,2,3,0,0,3,4,75,1,0,0,0,0,3,12,4
537,Fabio Chiarodia,it ITA,DF,Gladbach,de Bundesliga,19.91232877,2005,3.2,9,3,5,4,0,4,5,80,1,7,2,5,7,16,49,1
538,Julián Chicco,ar ARG,MF,Leganés,es La Liga,27.30410959,1998,2.3,8,5,1,6,1,4,6,66.7,2,2,0,2,2,10,3,0
539,Leandro Chichizola,ar ARG,GK,Parma,it Serie A,35.10410959,1990,1,0,0,0,0,0,0,0,,0,0,0,0,0,0,2,0
540,Federico Chiesa,it ITA,FW,Liverpool,eng Premier League,27.52328767,1997,0.4,0,0,0,0,0,0,2,0,2,1,0,1,0,0,0,0
541,Ben Chilwell,eng ENG,DF,Crystal Palace,eng Premier League,28.36712329,1996,1.5,4,4,2,2,0,0,3,0,3,3,1,2,4,8,11,0
542,Chiquinho,pt POR,MF,Wolves,eng Premier League,25.24109589,2000,0.1,0,0,0,0,0,0,0,,0,0,0,0,0,0,0,0
543,Chiquinho,pt POR,"MF,FW",Mallorca,es La Liga,25.24109589,2000,1.6,1,0,0,1,0,0,7,0,7,3,0,3,2,3,0,0
544,Pedro Chirivella,es ESP,MF,Nantes,fr Ligue 1,27.94794521,1997,23.3,34,24,15,15,4,16,37,43.2,21,21,3,18,15,49,40,0
545,Joris Chotard,fr FRA,MF,Montpellier,fr Ligue 1,23.60821918,2001,17.7,32,21,16,15,1,17,40,42.5,23,26,8,18,19,51,51,1
546,Hamza Choudhury,bd BAN,"MF,DF",Leicester City,eng Premier League,27.5890411,1997,1.5,1,1,1,0,0,1,3,33.3,2,4,2,2,5,6,2,0
547,Andreas Christensen,dk DEN,DF,Barcelona,es La Liga,29.06575342,1996,1.3,1,1,0,1,0,1,1,100,0,0,0,0,0,1,3,0
548,Ryan Christie,sct SCO,MF,Bournemouth,eng Premier League,30.19452055,1995,23.5,54,33,19,27,8,27,64,42.2,37,44,11,33,30,84,51,3
549,Carney Chukwuemeka,eng ENG,MF,Dortmund,de Bundesliga,21.5369863,2003,2.6,6,5,3,1,2,1,1,100,0,5,0,5,1,7,1,0
550,Samuel Chukwueze,ng NGA,"FW,MF",Milan,it Serie A,25.95068493,1999,9.5,14,9,6,4,4,5,17,29.4,12,3,0,3,2,16,8,0
551,Aaron Ciammaglichella,it ITA,MF,Torino,it Serie A,20.26849315,2005,0,0,0,0,0,0,0,0,,0,0,0,0,0,0,0,0
552,Jasper Cillessen,nl NED,GK,Las Palmas,es La Liga,36.03287671,1989,25.9,1,0,1,0,0,1,4,25,3,0,0,0,0,1,11,2
553,Alessandro Circati,au AUS,DF,Parma,it Serie A,21.56438356,2003,4,4,2,3,1,0,1,1,100,0,5,4,1,2,6,29,1
554,Pathé Ciss,sn SEN,"MF,DF",Rayo Vallecano,es La Liga,31.13424658,1994,21,45,22,23,21,1,20,40,50,20,28,7,21,34,79,57,3
555,Alphadjo Cissè,it ITA,"FW,MF",Hellas Verona,it Serie A,18.53150685,2006,0.1,0,0,0,0,0,0,0,,0,0,0,0,0,0,0,0
556,Djaoui Cissé,fr FRA,MF,Rennes,fr Ligue 1,21.25479452,2004,10.5,30,16,12,12,6,15,25,60,10,24,4,20,13,43,8,0
557,Seydouba Cissé,gn GUI,MF,Leganés,es La Liga,24.22739726,2001,23.2,47,30,17,22,8,19,39,48.7,20,23,1,22,11,58,40,1
558,Yoann Cissé,fr FRA,MF,Auxerre,fr Ligue 1,20.3890411,2004,0.1,0,0,0,0,0,0,0,,0,0,0,0,1,1,0,0
559,Patrick Ciurria,it ITA,"MF,DF",Monza,it Serie A,30.23013699,1995,11.1,21,13,11,7,3,4,11,36.4,7,13,3,10,6,27,19,0
560,Harry Clarke,eng ENG,DF,Ipswich Town,eng Premier League,24.17260274,2001,4.2,5,3,3,2,0,3,6,50,3,5,4,1,4,9,14,3
561,Jack Clarke,eng ENG,"FW,MF",Ipswich Town,eng Premier League,24.44383562,2000,11.7,28,17,11,9,8,16,32,50,16,6,0,6,7,35,29,1
562,Alexis Claude-Maurice,fr FRA,"MF,FW",Augsburg,de Bundesliga,26.90958904,1998,21,38,24,10,15,13,16,31,51.6,15,14,0,14,15,53,8,1
563,Jonathan Clauss,fr FRA,"DF,MF",Nice,fr Ligue 1,32.60547945,1992,23.7,49,35,26,17,6,27,53,50.9,26,23,2,21,44,93,67,3
564,Silvi Clúa,es ESP,MF,Girona,es La Liga,20.26027397,2005,1.8,8,7,4,3,1,4,6,66.7,2,1,0,1,2,10,6,0
565,Nathaniel Clyne,eng ENG,"DF,MF",Crystal Palace,eng Premier League,34.07945205,1991,5.4,12,8,8,3,1,6,11,54.5,5,4,2,2,3,15,14,1
566,Conor Coady,eng ENG,DF,Leicester City,eng Premier League,32.18630137,1993,16,12,8,6,5,1,3,6,50,3,27,20,7,13,25,62,2
567,Marcus Coco,fr FRA,DF,Nantes,fr Ligue 1,28.86027397,1996,10.6,27,21,15,9,3,16,31,51.6,15,16,5,11,10,37,46,0
568,Saúl Coco,gq EQG,DF,Torino,it Serie A,26.23013699,1999,31.6,46,26,31,14,1,19,30,63.3,11,49,31,18,38,84,157,4
569,Séamus Coleman,ie IRL,DF,Everton,eng Premier League,36.56164384,1988,2.2,2,1,1,1,0,2,3,66.7,1,5,3,2,1,3,7,0
570,Nathan Collins,ie IRL,DF,Brentford,eng Premier League,24.0109589,2001,34,36,21,21,11,4,21,31,67.7,10,69,49,20,32,68,209,2
571,Nnamdi Collins,de GER,DF,Eint Frankfurt,de Bundesliga,21.31232877,2004,15.4,29,20,20,7,2,15,20,75,5,22,11,11,14,43,66,3
572,Toby Collyer,eng ENG,MF,Manchester Utd,eng Premier League,21.33150685,2004,2,12,9,6,6,0,5,6,83.3,1,2,1,1,2,14,3,0
573,Lorenzo Colombo,it ITA,"FW,MF",Empoli,it Serie A,23.15616438,2002,23.6,28,13,7,14,7,6,20,30,14,32,2,30,2,30,15,1
574,Andrea Colpani,it ITA,"FW,MF",Fiorentina,it Serie A,25.98082192,1999,15.7,15,9,5,7,3,4,12,33.3,8,6,0,6,9,24,10,0
575,Levi Colwill,eng ENG,DF,Chelsea,eng Premier League,22.18356164,2003,31,40,28,20,17,3,16,25,64,9,34,24,10,31,71,99,4
576,Florinel Coman,ro ROU,"FW,MF",Cagliari,it Serie A,27.06575342,1998,2.9,5,3,3,1,1,2,2,100,0,2,0,2,1,6,3,0
577,Kingsley Coman,fr FRA,FW,Bayern Munich,de Bundesliga,28.89041096,1996,12.9,15,10,5,5,5,6,10,60,4,10,0,10,8,23,15,0
578,Eray Cömert,ch SUI,"DF,MF",Valladolid,es La Liga,27.24383562,1998,16.9,22,12,14,8,0,10,17,58.8,7,25,15,10,21,43,59,1
579,Santi Comesaña,es ESP,MF,Villarreal,es La Liga,28.57808219,1996,26.1,83,47,42,32,9,40,70,57.1,30,49,17,32,17,100,47,1
580,Pietro Comuzzo,it ITA,DF,Fiorentina,it Serie A,20.2,2005,22.2,38,18,24,11,3,20,26,76.9,6,29,18,11,25,63,101,4
581,Francisco Conceição,pt POR,"FW,MF",Juventus,it Serie A,22.38630137,2002,12.4,17,9,4,7,6,9,25,36,16,6,0,6,4,21,4,0
582,Diego Conde,es ESP,GK,Villarreal,es La Liga,26.51506849,1998,20.8,2,2,2,0,0,2,4,50,2,0,0,0,1,3,9,2
583,Tomás Conechny,ar ARG,"FW,MF",Alavés,es La Liga,27.09589041,1998,8.8,12,9,4,6,2,8,24,33.3,16,13,2,11,6,18,8,0
584,Alois Confais,fr FRA,MF,Le Havre,fr Ligue 1,28.65479452,1996,0,0,0,0,0,0,0,0,,0,0,0,0,0,0,0,0
585,Sirlord Conteh,de GER,"FW,MF",Heidenheim,de Bundesliga,28.81917808,1996,9.9,9,5,3,6,0,2,7,28.6,5,1,1,0,1,10,8,0
586,Lewis Cook,eng ENG,"MF,DF",Bournemouth,eng Premier League,28.24657534,1997,31.3,80,42,41,35,4,36,66,54.5,30,30,11,19,40,120,66,0
587,Copete,es ESP,DF,Mallorca,es La Liga,25.56438356,1999,15.3,26,14,16,9,1,9,10,90,1,22,15,7,16,42,113,1
588,Diego Coppola,it ITA,DF,Hellas Verona,it Serie A,21.34794521,2003,29.5,64,34,46,14,4,26,37,70.3,11,41,24,17,66,130,160,2
589,Francis Coquelin,fr FRA,"MF,FW",Nantes,fr Ligue 1,33.97534247,1991,0.7,3,1,1,2,0,0,1,0,1,1,1,0,3,6,2,0
590,Iker Córdoba,es ESP,DF,Valencia,es La Liga,19.47671233,2005,0.2,0,0,0,0,0,0,0,,0,0,0,0,0,0,1,0
591,Derek Cornelius,ca CAN,DF,Marseille,fr Ligue 1,27.43835616,1997,14.8,23,16,14,8,1,16,21,76.2,5,14,8,6,14,37,47,0
592,Maxwel Cornet,ci CIV,FW,Southampton,eng Premier League,28.6,1996,0.8,5,5,1,4,0,0,4,0,4,0,0,0,0,5,2,0
593,Maxwel Cornet,ci CIV,"FW,MF",Genoa,it Serie A,28.6,1996,2.6,2,1,1,0,1,0,1,0,1,1,1,0,2,4,1,0
594,Pierre Cornud,fr FRA,DF,Saint-Étienne,fr Ligue 1,28.39178082,1996,6.4,12,10,6,4,2,8,17,47.1,9,9,4,5,9,21,28,1
595,Ángel Correa,ar ARG,"FW,MF",Atlético Madrid,es La Liga,30.15342466,1995,8.1,8,2,4,1,3,4,14,28.6,10,9,0,9,4,12,7,0
596,Joaquín Correa,ar ARG,"FW,MF",Inter,it Serie A,30.72328767,1994,5.7,8,3,3,5,0,2,9,22.2,7,2,0,2,0,8,4,0
597,Thierry Correia,pt POR,DF,Valencia,es La Liga,26.15342466,1999,8.5,27,18,19,5,3,13,23,56.5,10,10,1,9,4,31,18,0
598,Alberto costa,pt POR,"DF,MF",Juventus,it Serie A,21.59452055,2003,1.3,6,4,5,1,0,2,3,66.7,1,4,0,4,1,7,3,0
599,Coba da Costa,es ESP,"MF,FW",Getafe,es La Liga,22.77260274,2002,9.9,27,12,9,15,3,12,24,50,12,21,0,21,7,34,7,0
600,Danny da Costa,de GER,DF,Mainz 05,de Bundesliga,31.80821918,1993,20,39,22,21,14,4,16,24,66.7,8,19,10,9,24,63,87,3
601,David Costa,pt POR,"MF,FW",Lens,fr Ligue 1,24.3260274,2001,3.9,2,0,1,1,0,1,4,25,3,5,1,4,1,3,0,0
602,Logan Costa,cv CPV,DF,Villarreal,es La Liga,24.09041096,2001,24.7,35,19,22,12,1,22,25,88,3,20,11,9,17,52,100,1
603,Logan Costa,cv CPV,DF,Toulouse,fr Ligue 1,24.09041096,2001,1,2,1,0,2,0,1,1,100,0,2,2,0,2,4,4,0
604,Samu Costa,pt POR,MF,Mallorca,es La Liga,24.43287671,2000,24.6,75,36,36,37,2,27,66,40.9,39,39,12,27,28,103,73,1
605,Grégoire Coudert,fr FRA,GK,Brest,fr Ligue 1,26.08493151,1999,2,0,0,0,0,0,0,0,,0,0,0,0,0,0,1,0
606,Vladimír Coufal,cz CZE,DF,West Ham,eng Premier League,32.69863014,1992,9.6,17,11,10,5,2,7,18,38.9,11,13,11,2,8,25,37,1
607,Lassana Coulibaly,ml MLI,MF,Lecce,it Serie A,29.06575342,1996,26.6,44,26,16,25,3,22,57,38.6,35,40,12,28,16,60,41,1
608,Lasso Coulibaly,gh GHA,"FW,MF",Auxerre,fr Ligue 1,22.53972603,2002,0.4,0,0,0,0,0,0,0,,0,0,0,0,0,0,0,0
609,Mamadou Coulibaly,fr FRA,MF,Monaco,fr Ligue 1,21.03561644,2004,0.1,1,0,0,1,0,0,0,,0,0,0,0,0,1,0,0
610,Soumaïla Coulibaly,fr FRA,DF,Brest,fr Ligue 1,21.55342466,2003,4.9,4,2,2,2,0,1,1,100,0,7,2,5,5,9,26,0
611,Tanguy Coulibaly,fr FRA,"FW,MF",Montpellier,fr Ligue 1,24.20547945,2001,12.8,24,18,8,13,3,9,24,37.5,15,15,1,14,9,33,2,0
612,Woyo Coulibaly,fr FRA,DF,Leicester City,eng Premier League,25.95616438,1999,1.2,6,4,4,2,0,2,2,100,0,3,1,2,5,11,1,0
613,Woyo Coulibaly,fr FRA,DF,Parma,it Serie A,25.95616438,1999,12,13,10,9,2,2,5,11,45.5,6,19,2,17,8,21,25,0
614,Marius Courcoul,fr FRA,"DF,MF",Angers,fr Ligue 1,18.3369863,2007,0.8,2,0,1,1,0,0,2,0,2,1,0,1,0,2,1,0
615,Thibaut Courtois,be BEL,GK,Real Madrid,es La Liga,32.98082192,1992,27,0,0,0,0,0,0,0,,0,0,0,0,1,1,13,1
616,Yan Couto,br BRA,"DF,FW",Dortmund,de Bundesliga,22.91780822,2002,9.9,24,16,17,2,5,14,25,56,11,12,1,11,9,33,30,2
617,Nicolas Cozza,fr FRA,"DF,MF",Nantes,fr Ligue 1,26.31780822,1999,22.5,57,40,34,17,6,30,46,65.2,16,24,10,14,25,82,69,0
618,Aaron Cresswell,eng ENG,DF,West Ham,eng Premier League,35.38356164,1989,6.5,8,4,3,4,1,6,8,75,2,7,4,3,6,14,30,0
619,Charlie Cresswell,eng ENG,DF,Toulouse,fr Ligue 1,22.71232877,2002,27.8,35,23,19,15,1,28,45,62.2,17,43,27,16,28,63,180,3
620,Bryan Cristante,it ITA,MF,Roma,it Serie A,30.16986301,1995,19,41,25,15,20,6,14,25,56,11,17,9,8,16,57,30,1
621,Domen Črnigoj,si SVN,MF,Venezia,it Serie A,29.45753425,1995,1.5,4,2,0,1,3,1,2,50,1,5,2,3,4,8,4,0
622,Juan Cruz Armada,es ESP,DF,Osasuna,es La Liga,32.76712329,1992,13,20,10,9,10,1,11,19,57.9,8,14,4,10,8,28,44,0
623,Juan Cruz,es ESP,"FW,MF",Leganés,es La Liga,25.02465753,2000,22.4,30,19,13,15,2,16,32,50,16,14,2,12,11,41,27,0
624,Juan Cuadrado,co COL,"DF,MF",Atalanta,it Serie A,36.93972603,1988,8.9,19,9,9,6,4,11,23,47.8,12,14,2,12,7,26,9,0
625,Pau Cubarsí,es ESP,DF,Barcelona,es La Liga,18.27945205,2007,26,28,18,18,7,3,16,25,64,9,10,8,2,13,41,75,1
626,Cucho,co COL,FW,Betis,es La Liga,26.03835616,1999,8.8,12,8,1,5,6,5,9,55.6,4,12,1,11,6,18,3,0
627,Marc Cucurella,es ESP,DF,Chelsea,eng Premier League,26.78356164,1998,29.2,58,38,29,24,5,25,50,50,25,40,13,27,23,81,76,3
628,Jorge Cuenca,es ESP,DF,Fulham,eng Premier League,25.46027397,1999,2.9,2,2,2,0,0,2,5,40,3,3,3,0,2,4,21,0
629,Matheus Cunha,br BRA,"MF,FW",Wolves,eng Premier League,25.9369863,1999,26.9,35,21,16,15,4,11,36,30.6,25,19,1,18,17,52,23,0
630,Patrick Cutrone,it ITA,FW,Como,it Serie A,27.33150685,1998,21.7,15,11,0,9,6,6,13,46.2,7,11,0,11,4,19,7,0
631,Tomáš Čvančara,cz CZE,FW,Gladbach,de Bundesliga,24.72328767,2000,8.8,4,1,3,1,0,2,7,28.6,5,6,3,3,5,9,17,0
632,Wylan Cyprien,fr FRA,MF,Parma,it Serie A,30.2630137,1995,0.3,0,0,0,0,0,0,1,0,1,1,0,1,1,1,0,0
633,Danilo D'Ambrosio,it ITA,DF,Monza,it Serie A,36.64931507,1988,12.2,28,15,17,10,1,14,23,60.9,9,12,8,4,15,43,36,2
634,Lucas Da Cunha,fr FRA,MF,Como,it Serie A,23.90136986,2001,26.2,39,20,14,16,9,18,34,52.9,16,15,3,12,14,53,29,1
635,Samuel Dahl,se SWE,"DF,MF",Roma,it Serie A,25.16712329,2000,0.5,2,2,0,2,0,1,2,50,1,2,0,2,0,2,0,0
636,Finn Dahmen,de GER,GK,Augsburg,de Bundesliga,27.10410959,1998,16,1,0,1,0,0,1,2,50,1,0,0,0,0,1,8,0
637,Thomas Dähne,de GER,GK,Holstein Kiel,de Bundesliga,31.32876712,1994,6,0,0,0,0,0,0,0,,0,0,0,0,0,0,6,1
638,Mahmoud Dahoud,de GER,MF,Eint Frankfurt,de Bundesliga,29.3369863,1996,4,9,4,4,5,0,4,6,66.7,2,5,1,4,2,11,5,0
639,Patson Daka,zm ZAM,"FW,MF",Leicester City,eng Premier League,26.56712329,1998,7.3,17,9,4,9,4,7,17,41.2,10,7,1,6,1,18,10,0
640,Ameen Al-Dakhil,be BEL,DF,Stuttgart,de Bundesliga,23.16164384,2002,4.8,6,6,4,2,0,4,4,100,0,12,8,4,9,15,30,1
641,Thijs Dallinga,nl NED,FW,Bologna,it Serie A,24.75068493,2000,10.7,10,5,0,4,6,3,3,100,0,10,1,9,1,11,11,1
642,Diogo Dalot,pt POR,DF,Manchester Utd,eng Premier League,26.12876712,1999,31,67,39,39,22,6,34,52,65.4,18,22,9,13,37,104,72,0
643,Mikkel Damsgaard,dk DEN,"MF,FW",Brentford,eng Premier League,24.83561644,2000,28.6,74,41,27,24,23,27,71,38,44,34,2,32,25,99,30,2
644,Maat Daniel Caprini,it ITA,FW,Fiorentina,it Serie A,19.22465753,2006,0.1,0,0,0,0,0,0,0,,0,0,0,0,0,0,0,0
645,Flavius Daniliuc,at AUT,DF,Hellas Verona,it Serie A,24.01917808,2001,11,24,19,13,8,3,14,23,60.9,9,10,3,7,7,31,26,0
646,Danilo,br BRA,"MF,FW",Nott'ham Forest,eng Premier League,24.01369863,2001,3,6,3,5,1,0,2,4,50,2,2,1,1,3,9,3,0
647,Danilo,br BRA,DF,Juventus,it Serie A,33.80273973,1991,6.5,10,4,7,2,1,5,10,50,5,4,3,1,9,19,21,1
648,Arnaut Danjuma,nl NED,FW,Villarreal,es La Liga,28.25479452,1997,2.2,2,1,0,1,1,0,1,0,1,1,0,1,0,2,0,0
649,Arnaut Danjuma,nl NED,"FW,MF",Girona,es La Liga,28.25479452,1997,14.6,8,6,3,3,2,2,7,28.6,5,5,1,4,2,10,4,0
650,Jayden Danns,eng ENG,MF,Liverpool,eng Premier League,19.29589041,2006,0.1,0,0,0,0,0,0,1,0,1,0,0,0,0,0,0,0
651,Kévin Danois,fr FRA,MF,Auxerre,fr Ligue 1,20.84931507,2004,16.2,49,30,20,22,7,20,46,43.5,26,17,3,14,20,69,20,0
652,Kevin Danso,at AUT,DF,Tottenham,eng Premier League,26.62191781,1998,5.4,5,4,2,3,0,4,6,66.7,2,6,6,0,2,7,35,1
653,Kevin Danso,at AUT,DF,Lens,fr Ligue 1,26.62191781,1998,12,19,7,12,5,2,12,16,75,4,25,19,6,20,39,62,1
654,Dante,br BRA,DF,Nice,fr Ligue 1,41.54246575,1983,20.3,30,13,16,12,2,14,27,51.9,13,26,12,14,31,61,68,1
655,Pape Daouda Diongue,sn SEN,"MF,FW",Strasbourg,fr Ligue 1,0,,0.9,2,0,1,1,0,1,2,50,1,0,0,0,3,5,2,0
656,Mohamed Daramy,dk DEN,FW,Reims,fr Ligue 1,23.32054795,2002,0.2,0,0,0,0,0,0,0,,0,0,0,0,0,0,1,0
657,Bence Dárdai,hu HUN,MF,Wolfsburg,de Bundesliga,19.2739726,2006,14.3,24,14,9,13,2,16,29,55.2,13,20,4,16,12,36,28,1
658,Sergi Darder,es ESP,"MF,FW",Mallorca,es La Liga,31.36438356,1993,25.7,36,22,15,14,7,14,38,36.8,24,18,1,17,14,50,19,1
659,Matteo Darmian,it ITA,DF,Inter,it Serie A,35.41917808,1989,17.8,25,15,11,11,3,13,24,54.2,11,12,5,7,7,32,35,0
660,Lukas Daschner,de GER,"MF,FW",Bochum,de Bundesliga,26.5890411,1998,4.6,4,2,1,2,1,2,9,22.2,7,5,0,5,0,4,5,0
661,Juan David Cabal,co COL,DF,Juventus,it Serie A,24.31780822,2001,5.1,10,4,7,3,0,8,12,66.7,4,2,0,2,2,12,14,1
662,Jonathan David,ca CAN,FW,Lille,fr Ligue 1,25.30136986,2000,25.6,20,5,3,10,7,8,17,47.1,9,13,2,11,4,24,9,1
663,Alphonso Davies,ca CAN,DF,Bayern Munich,de Bundesliga,24.50136986,2000,17.3,30,17,7,17,6,17,26,65.4,9,14,1,13,13,43,22,2
664,Ben Davies,wls WAL,DF,Tottenham,eng Premier League,32.02739726,1993,11.5,13,9,6,7,0,6,13,46.2,7,23,15,8,11,24,62,1
665,Keinan Davis,eng ENG,FW,Udinese,it Serie A,27.21917808,1998,9.9,8,3,1,4,3,3,5,60,2,2,1,1,1,9,5,0
666,Leif Davis,eng ENG,DF,Ipswich Town,eng Premier League,25.30684932,2000,28.5,45,26,32,9,4,29,46,63,17,24,8,16,25,70,72,3
667,Zuriko Davitashvili,ge GEO,"FW,MF",Saint-Étienne,fr Ligue 1,24.21369863,2001,27.9,21,13,8,7,6,14,46,30.4,32,20,0,20,12,33,12,0
668,Paweł Dawidowicz,pl POL,"DF,MF",Hellas Verona,it Serie A,29.95616438,1995,18.7,42,22,19,20,3,18,27,66.7,9,15,5,10,20,62,62,2
669,Craig Dawson,eng ENG,DF,Wolves,eng Premier League,34.99452055,1990,10.8,15,3,8,6,1,12,15,80,3,16,11,5,9,24,52,1
670,Kevin De Bruyne,be BEL,"MF,FW",Manchester City,eng Premier League,33.84931507,1991,17.1,17,9,7,5,5,5,23,21.7,18,8,0,8,7,24,10,1
671,Bobby De Cordova-Reid,jm JAM,FW,Leicester City,eng Premier League,32.24931507,1993,8.3,9,4,3,6,0,4,14,28.6,10,6,1,5,0,9,10,0
672,Charles De Ketelaere,be BEL,"MF,FW",Atalanta,it Serie A,24.15068493,2001,20.4,12,8,2,8,2,4,13,30.8,9,11,3,8,3,15,8,0
673,Rodrigo De Paul,ar ARG,MF,Atlético Madrid,es La Liga,30.94520548,1994,20,28,23,11,13,4,13,30,43.3,17,22,2,20,5,33,13,3
674,Théo De Percin,mq MTQ,GK,Auxerre,fr Ligue 1,24.24931507,2001,2,0,0,0,0,0,0,1,0,1,0,0,0,0,0,3,0
675,Mattia De Sciglio,it ITA,DF,Empoli,it Serie A,32.5369863,1992,8.5,18,13,10,8,0,14,17,82.4,3,10,3,7,8,26,35,1
676,Lorenzo De Silvestri,it ITA,DF,Bologna,it Serie A,36.94794521,1988,9.3,11,6,7,1,3,7,15,46.7,8,10,3,7,8,19,28,0
677,Thibault De Smet,be BEL,DF,Reims,fr Ligue 1,26.91232877,1998,2.1,6,4,5,1,0,4,4,100,0,5,3,2,4,10,12,0
678,Koni De Winter,be BEL,DF,Genoa,it Serie A,22.89315068,2002,21.1,30,18,19,8,3,15,22,68.2,7,10,6,4,21,51,105,3
679,Amar Dedić,ba BIH,DF,Marseille,fr Ligue 1,22.70958904,2002,3.2,5,4,2,2,1,3,10,30,7,0,0,0,3,8,10,1
680,Alessandro Deiola,it ITA,MF,Cagliari,it Serie A,29.75616438,1995,13.8,27,17,7,17,3,9,28,32.1,19,24,11,13,12,39,34,0
681,Romain Del Castillo,fr FRA,FW,Brest,fr Ligue 1,29.09863014,1996,12.2,29,21,9,12,8,18,31,58.1,13,15,0,15,6,35,4,0
682,Enrico Del Prato,it ITA,DF,Parma,it Serie A,25.47945205,1999,29.7,31,17,22,8,1,19,24,79.2,5,67,34,33,18,49,125,2
683,Thomas Delaine,fr FRA,DF,Strasbourg,fr Ligue 1,33.11232877,1992,0.1,1,1,1,0,0,1,1,100,0,0,0,0,1,2,1,0
684,Liam Delap,eng ENG,FW,Ipswich Town,eng Premier League,22.23287671,2003,27.7,10,7,3,2,5,2,14,14.3,12,8,0,8,2,12,28,0
685,Fisayo Dele-Bashiru,ng NGA,"MF,FW",Lazio,it Serie A,24.23835616,2001,9.9,9,5,3,2,4,2,6,33.3,4,10,2,8,4,13,5,0
686,Andy Delort,dz ALG,FW,Montpellier,fr Ligue 1,33.56712329,1991,5.7,4,3,1,2,1,1,2,50,1,3,1,2,0,4,3,0
687,Olivier Deman,be BEL,DF,Werder Bremen,de Bundesliga,25.07671233,2000,0.7,6,3,2,4,0,2,7,28.6,5,3,1,2,3,9,4,0
688,Ali Dembélé,fr FRA,DF,Torino,it Serie A,21.3260274,2004,2,6,4,3,3,0,4,4,100,0,1,1,0,0,6,6,1
689,Ousmane Dembélé,fr FRA,FW,Paris S-G,fr Ligue 1,27.96986301,1997,18.4,11,5,0,7,4,4,12,33.3,8,3,0,3,9,20,2,1
690,Ermedin Demirović,ba BIH,FW,Stuttgart,de Bundesliga,27.10958904,1998,20.1,11,6,2,4,5,2,10,20,8,14,3,11,3,14,11,0
691,Sepp van den Berg,nl NED,DF,Brentford,eng Premier League,23.36986301,2001,24.7,35,22,22,9,4,16,25,64,9,48,34,14,19,54,117,2
692,Rémy Descamps,fr FRA,GK,Lyon,fr Ligue 1,28.85753425,1996,1,0,0,0,0,0,0,0,,0,0,0,0,0,0,0,0
693,Arthur Desmas,fr FRA,GK,Le Havre,fr Ligue 1,31.0739726,1994,18,0,0,0,0,0,0,1,0,1,0,0,0,0,0,9,1
694,Justin Devenny,nir NIR,MF,Crystal Palace,eng Premier League,21.56164384,2003,4.8,14,9,6,7,1,7,14,50,7,3,0,3,0,14,10,0
695,Kiernan Dewsbury-Hall,eng ENG,"MF,FW",Chelsea,eng Premier League,26.65753425,1998,2.9,8,5,1,1,6,4,6,66.7,2,2,0,2,1,9,8,1
696,Michele Di Gregorio,it ITA,GK,Juventus,it Serie A,27.76986301,1997,29,0,0,0,0,0,0,0,,0,0,0,0,0,0,11,0
697,Giovanni Di Lorenzo,it ITA,DF,Napoli,it Serie A,31.74794521,1993,34,65,43,34,25,6,41,63,65.1,22,18,6,12,29,94,76,1
698,Boulaye Dia,sn SEN,"MF,FW",Lazio,it Serie A,28.4630137,1996,21.1,20,8,5,10,5,6,15,40,9,10,1,9,5,25,13,1
699,Mouctar Diakhaby,gn GUI,DF,Valencia,es La Liga,28.37260274,1996,4.1,5,1,5,0,0,3,5,60,2,6,5,1,3,8,32,0
700,Mamadou Diakhon,fr FRA,"FW,MF",Reims,fr Ligue 1,19.61369863,2005,9.2,12,8,4,3,5,9,17,52.9,8,5,1,4,4,16,5,0
701,Bafodé Diakité,fr FRA,DF,Lille,fr Ligue 1,24.32328767,2001,29.7,31,18,17,11,3,18,26,69.2,8,30,17,13,27,58,96,5
702,Oumar Diakité,ci CIV,FW,Reims,fr Ligue 1,21.36986301,2003,18.1,20,13,7,8,5,9,19,47.4,10,12,2,10,3,23,9,0
703,Amad Diallo,ci CIV,"FW,MF",Manchester Utd,eng Premier League,22.81369863,2002,17.7,33,26,6,19,8,15,26,57.7,11,10,0,10,11,44,16,0
704,Assane Diao,sn SEN,"FW,MF",Como,it Serie A,19.65479452,2005,13.9,25,14,9,10,6,12,28,42.9,16,8,1,7,3,28,19,0
705,Assane Diao,sn SEN,FW,Betis,es La Liga,19.65479452,2005,3.1,5,3,1,3,1,4,9,44.4,5,3,0,3,0,5,3,0
706,Habib Diarra,sn SEN,"MF,FW",Strasbourg,fr Ligue 1,21.33150685,2004,24.9,22,13,6,13,3,8,20,40,12,21,6,15,13,35,44,2
707,Moussa Diarra,ml MLI,DF,Alavés,es La Liga,24.47945205,2000,19.7,38,23,19,16,3,17,28,60.7,11,14,5,9,21,59,40,1
708,Rúben Dias,pt POR,DF,Manchester City,eng Premier League,27.97260274,1997,22.2,16,10,6,9,1,7,11,63.6,4,17,14,3,18,34,59,3
709,Krépin Diatta,sn SEN,DF,Monaco,fr Ligue 1,26.18630137,1999,4.9,18,12,13,2,3,14,23,60.9,9,5,1,4,7,25,11,2
710,Kandet Diawara,gn GUI,FW,Le Havre,fr Ligue 1,25.22739726,2000,0,0,0,0,0,0,0,0,,0,1,0,1,0,0,1,0
711,Mahamadou Diawara,fr FRA,MF,Le Havre,fr Ligue 1,20.20821918,2005,6.2,20,12,10,8,2,8,13,61.5,5,13,6,7,13,33,10,1
712,Mahamadou Diawara,fr FRA,MF,Lyon,fr Ligue 1,20.20821918,2005,0.2,1,0,0,1,0,1,3,33.3,2,2,0,2,0,1,0,0
713,Brahim Díaz,ma MAR,"FW,MF",Real Madrid,es La Liga,25.75068493,1999,14.2,23,18,8,12,3,6,17,35.3,11,16,1,15,4,27,1,1
714,Daniel Díaz,es ESP,MF,Real Sociedad,es La Liga,18.86575342,2006,0.1,1,1,1,0,0,0,0,,0,1,0,1,0,1,0,0
715,Luis Díaz,co COL,FW,Liverpool,eng Premier League,28.30410959,1997,24.7,33,21,10,17,6,13,34,38.2,21,18,0,18,7,40,7,1
716,Pedro Díaz,es ESP,MF,Rayo Vallecano,es La Liga,26.91232877,1998,11.5,21,13,6,13,2,12,35,34.3,23,13,0,13,6,27,6,1
717,Tyler Dibling,eng ENG,"FW,MF",Southampton,eng Premier League,19.14520548,2006,19.4,34,20,13,18,3,16,26,61.5,10,19,5,14,8,42,15,1
718,Diego,es ESP,"FW,MF",Leganés,es La Liga,25.04383562,2000,10.2,0,0,0,0,0,0,4,0,4,2,1,1,2,2,10,0
719,Justin Diehl,de GER,"FW,DF",Stuttgart,de Bundesliga,20.43287671,2004,1.2,1,0,0,1,0,1,1,100,0,2,0,2,0,1,0,0
720,Bamba Dieng,sn SEN,FW,Angers,fr Ligue 1,25.11506849,2000,5.9,4,1,1,2,1,0,2,0,2,2,0,2,0,4,3,0
721,Eric Dier,eng ENG,DF,Bayern Munich,de Bundesliga,31.29863014,1994,14.3,17,10,6,9,2,11,16,68.8,5,17,7,10,18,35,69,1
722,Lucas Digne,fr FRA,DF,Aston Villa,eng Premier League,31.7890411,1993,25.1,63,37,38,16,9,43,64,67.2,21,23,4,19,25,88,85,1
723,Kembo Diliwidi,fr FRA,DF,Lens,fr Ligue 1,19.24657534,2006,0,0,0,0,0,0,0,0,,0,0,0,0,0,0,0,0
724,Federico Dimarco,it ITA,"DF,FW",Inter,it Serie A,27.47945205,1997,22.3,23,13,9,11,3,8,17,47.1,9,21,3,18,12,35,31,2
725,Stole Dimitrievski,mk MKD,GK,Valencia,es La Liga,31.35616438,1993,4,0,0,0,0,0,0,0,,0,0,0,0,0,0,3,1
726,Junior Dina Ebimbe,fr FRA,"MF,FW",Eint Frankfurt,de Bundesliga,24.44931507,2000,3.3,3,2,1,2,0,1,3,33.3,2,4,0,4,7,10,6,0
727,Eren Dinkçi,de GER,"MF,FW",Freiburg,de Bundesliga,23.3890411,2001,13.3,21,13,8,8,5,7,23,30.4,16,22,2,20,7,28,7,0
728,Sinaly Diomande,ci CIV,DF,Auxerre,fr Ligue 1,24.06849315,2001,18.6,34,17,17,16,1,23,33,69.7,10,35,18,17,27,61,86,2
729,Yan Diomandé,ci CIV,"FW,MF",Leganés,es La Liga,18.46849315,2006,2.3,1,1,1,0,0,0,5,0,5,6,0,6,3,4,2,0
730,Lois Diony,fr FRA,FW,Angers,fr Ligue 1,32.36986301,1992,0.2,0,0,0,0,0,0,0,,0,0,0,0,0,0,0,0
731,Issa Diop,fr FRA,DF,Fulham,eng Premier League,28.31506849,1997,14.9,26,12,18,8,0,13,18,72.2,5,10,7,3,9,35,72,2
732,Sérigné Diop,sn SEN,FW,Brest,fr Ligue 1,19.97808219,2005,0,1,0,0,1,0,0,0,,0,1,0,1,0,1,0,0
733,Sofiane Diop,fr FRA,"MF,FW",Nice,fr Ligue 1,24.90136986,2000,11.3,23,16,16,3,4,9,22,40.9,13,19,2,17,16,39,7,1
734,Andy Diouf,fr FRA,MF,Lens,fr Ligue 1,21.96438356,2003,22.1,36,25,10,21,5,15,36,41.7,21,22,1,21,12,48,16,2
735,Yehvann Diouf,fr FRA,GK,Reims,fr Ligue 1,25.4630137,1999,32,2,1,2,0,0,1,3,33.3,2,0,0,0,1,3,21,3
736,Assane Dioussé,sn SEN,MF,Auxerre,fr Ligue 1,27.61917808,1997,6.3,14,7,8,5,1,5,12,41.7,7,5,2,3,10,24,13,0
737,Axel Disasi,fr FRA,DF,Aston Villa,eng Premier League,27.14794521,1998,5.4,8,5,7,1,0,3,7,42.9,4,4,1,3,5,13,18,0
738,Axel Disasi,fr FRA,DF,Chelsea,eng Premier League,27.14794521,1998,4,7,4,5,1,1,6,11,54.5,5,4,1,3,2,9,11,1
739,Roman Dixon,eng ENG,DF,Everton,eng Premier League,20.35342466,2004,1,5,5,3,2,0,4,4,100,0,1,0,1,1,6,3,0
740,Álvaro djaló,es ESP,FW,Athletic Club,es La Liga,25.71506849,1999,6.4,7,5,3,2,2,1,3,33.3,2,3,0,3,1,8,4,0
741,Djené,tg TOG,"DF,MF",Getafe,es La Liga,33.33972603,1991,27.3,25,13,12,11,2,12,31,38.7,19,18,8,10,21,46,104,3
742,Nasser Djiga,bf BFA,"DF,FW",Wolves,eng Premier League,22.46575342,2002,0.2,0,0,0,0,0,0,0,,0,0,0,0,2,2,3,1
743,Berat Djimsiti,al ALB,DF,Atalanta,it Serie A,32.20273973,1993,26.5,47,28,25,21,1,26,35,74.3,9,30,18,12,36,83,111,2
744,Marko Dmitrović,rs SRB,GK,Leganés,es La Liga,33.2739726,1992,27,1,1,1,0,0,1,2,50,1,0,0,0,0,1,24,3
745,Ritsu Doan,jp JPN,"FW,MF",Freiburg,de Bundesliga,26.88219178,1998,28.9,61,39,29,26,6,25,44,56.8,19,52,2,50,14,75,37,1
746,Dodô,br BRA,DF,Fiorentina,it Serie A,26.46027397,1998,31.6,41,28,23,10,8,23,45,51.1,22,21,5,16,33,74,56,2
747,Danilho Doekhi,nl NED,DF,Union Berlin,de Bundesliga,26.84383562,1998,32,35,22,17,15,3,13,23,56.5,10,31,15,16,42,77,163,1
748,Matt Doherty,ie IRL,DF,Wolves,eng Premier League,33.29589041,1992,21.8,37,20,25,12,0,16,24,66.7,8,26,15,11,21,58,91,3
749,Jeremy Doku,be BEL,"FW,MF",Manchester City,eng Premier League,22.9369863,2002,15.5,28,19,9,12,7,7,14,50,7,10,1,9,4,32,2,0
750,Marc Domenech,es ESP,"FW,MF",Mallorca,es La Liga,19.3369863,2006,2.1,2,2,1,1,0,2,4,50,2,2,0,2,0,2,0,0
751,Álex Domínguez,es ESP,GK,Toulouse,fr Ligue 1,26.76164384,1998,0.2,0,0,0,0,0,0,0,,0,0,0,0,0,0,0,0
752,Benjamín Domínguez,ar ARG,FW,Bologna,it Serie A,21.62191781,2003,12.8,18,7,2,11,5,6,20,30,14,14,1,13,4,22,7,0
753,Carlos Dominguez,es ESP,DF,Celta Vigo,es La Liga,24.22465753,2001,10,20,11,12,8,0,14,19,73.7,5,9,6,3,8,28,51,1
754,Israel Domínguez,es ESP,FW,Sevilla,es La Liga,21.99178082,2003,0.2,0,0,0,0,0,0,0,,0,0,0,0,0,0,0,0
755,Nicolás Domínguez,ar ARG,"MF,FW",Nott'ham Forest,eng Premier League,26.84931507,1998,18.5,75,40,35,29,11,29,64,45.3,35,34,11,23,27,102,44,1
756,Sergi Dominguez,es ESP,DF,Barcelona,es La Liga,20.09041096,2005,1.9,1,1,1,0,0,0,0,,0,0,0,0,3,4,7,0
757,Gianluigi Donnarumma,it ITA,GK,Paris S-G,fr Ligue 1,26.18630137,1999,22.2,1,1,1,0,0,1,2,50,1,0,0,0,0,1,12,0
758,Patrick Dorgu,dk DEN,DF,Manchester Utd,eng Premier League,20.52054795,2004,6.5,23,17,12,9,2,12,17,70.6,5,8,0,8,4,27,17,2
759,Patrick Dorgu,dk DEN,"DF,FW",Lecce,it Serie A,20.52054795,2004,20.4,45,27,21,19,5,23,45,51.1,22,24,6,18,18,63,42,2
760,Alfie Dorrington,eng ENG,DF,Tottenham,eng Premier League,20.03835616,2005,0.2,0,0,0,0,0,0,0,,0,0,0,0,0,0,0,0
761,Niklas Dorsch,de GER,MF,Augsburg,de Bundesliga,27.29863014,1998,0.4,0,0,0,0,0,0,0,,0,1,0,1,0,0,0,0
762,Niklas Dorsch,de GER,MF,Heidenheim,de Bundesliga,27.29863014,1998,13.5,25,14,11,14,0,12,20,60,8,14,1,13,15,40,17,2
763,Alberto Dossena,it ITA,DF,Como,it Serie A,26.55616438,1998,20.3,33,20,23,8,2,16,28,57.1,12,22,11,11,22,55,89,1
764,Abdoulaye Doucouré,ml MLI,MF,Everton,eng Premier League,32.3369863,1993,26.9,45,27,20,18,7,13,39,33.3,26,30,6,24,9,54,19,1
765,Cheick Doucouré,ml MLI,MF,Crystal Palace,eng Premier League,25.31780822,2000,5,16,8,6,8,2,5,11,45.5,6,4,0,4,11,27,10,1
766,Sékou Doucoure,fr FRA,DF,Nantes,fr Ligue 1,20.02191781,2005,0.1,0,0,0,0,0,0,0,,0,0,0,0,0,0,3,0
767,Désiré Doué,fr FRA,"FW,MF",Paris S-G,fr Ligue 1,19.91780822,2005,18.2,43,26,14,19,10,21,44,47.7,23,20,0,20,13,56,7,0
768,Guela Doué,ci CIV,DF,Strasbourg,fr Ligue 1,22.54520548,2002,28.5,61,42,38,14,9,36,52,69.2,16,37,6,31,32,93,143,1
769,Douglas,br BRA,MF,Nantes,fr Ligue 1,28.30410959,1997,23.6,63,37,28,27,8,25,42,59.5,17,48,11,37,29,92,43,0
770,Ismaël Doukouré,fr FRA,"DF,MF",Strasbourg,fr Ligue 1,21.77808219,2003,27.3,37,19,18,16,3,16,24,66.7,8,31,14,17,24,61,100,3
771,Issa Doumbia,ci CIV,MF,Venezia,it Serie A,21.54794521,2003,9.3,13,8,5,7,1,7,15,46.7,8,15,4,11,7,20,13,0
772,Kamory Doumbia,ml MLI,"MF,FW",Brest,fr Ligue 1,22.20547945,2003,12.3,34,23,14,16,4,11,27,40.7,16,15,1,14,24,58,12,1
773,Amidou Doumbouya,fr FRA,DF,Nice,fr Ligue 1,17.74520548,2007,0.5,1,1,0,0,1,1,1,100,0,3,1,2,1,2,1,0
774,Anastasios Douvikas,gr GRE,FW,Como,it Serie A,25.75342466,1999,4.5,3,2,0,3,0,1,3,33.3,2,3,0,3,1,4,2,0
775,Anastasios Douvikas,gr GRE,FW,Celta Vigo,es La Liga,25.75342466,1999,7.8,9,4,2,6,1,3,6,50,3,5,2,3,3,12,6,0
776,Artem Dovbyk,ua UKR,FW,Roma,it Serie A,27.86849315,1997,25.1,4,2,0,1,3,0,4,0,4,8,3,5,2,6,12,0
777,Flynn Downes,eng ENG,MF,Southampton,eng Premier League,26.28493151,1999,20.9,44,24,19,20,5,14,32,43.8,18,24,6,18,30,74,38,4
778,Tommy Doyle,eng ENG,MF,Wolves,eng Premier League,23.54520548,2001,5.4,11,6,6,3,2,6,15,40,9,11,5,6,5,16,11,1
779,Radu Drăgușin,ro ROU,DF,Tottenham,eng Premier League,23.24657534,2002,13.9,10,6,8,2,0,6,12,50,6,22,16,6,15,25,49,4
780,Patrick Drewes,de GER,GK,Bochum,de Bundesliga,32.24383562,1993,21,0,0,0,0,0,0,1,0,1,1,0,1,0,0,11,1
781,Tim Drexler,de GER,DF,Hoffenheim,de Bundesliga,20.16164384,2005,4,17,7,11,6,0,9,12,75,3,6,4,2,1,18,9,1
782,Domingos Duarte,pt POR,DF,Getafe,es La Liga,30.15068493,1995,17,23,11,18,4,1,13,17,76.5,4,24,14,10,13,36,124,1
783,Martin Dúbravka,sk SVK,GK,Newcastle Utd,eng Premier League,36.29863014,1989,10,0,0,0,0,0,0,0,,0,0,0,0,0,0,3,0
784,Marvin Ducksch,de GER,FW,Werder Bremen,de Bundesliga,31.15890411,1994,24.9,10,7,3,5,2,3,14,21.4,11,7,1,6,8,18,24,2
785,Ondrej Duda,sk SVK,MF,Hellas Verona,it Serie A,30.4109589,1994,24.6,43,26,20,20,3,29,61,47.5,32,24,7,17,31,74,30,4
786,Duk,cv CPV,"MF,FW",Leganés,es La Liga,25.2109589,2000,0.9,4,3,1,2,1,1,2,50,1,2,0,2,0,4,0,0
787,Denzel Dumfries,nl NED,"DF,FW",Inter,it Serie A,29.04383562,1996,19.9,25,18,12,9,4,14,24,58.3,10,25,5,20,6,31,21,1
788,Alfred Duncan,gh GHA,MF,Venezia,it Serie A,32.15068493,1993,10.6,17,8,4,11,2,5,14,35.7,9,7,2,5,8,25,8,0
789,Lewis Dunk,eng ENG,DF,Brighton,eng Premier League,33.44931507,1991,22.1,17,10,8,7,2,11,19,57.9,8,26,17,9,12,29,74,2
790,Jáder Durán,co COL,FW,Aston Villa,eng Premier League,21.3890411,2003,7.1,8,7,1,2,5,1,4,25,3,5,0,5,0,8,13,0
791,Pablo Durán,es ESP,"FW,MF",Celta Vigo,es La Liga,23.94246575,2001,12.8,12,7,3,7,2,3,12,25,9,8,2,6,8,20,9,0
792,Julien Duranville,be BEL,"FW,MF",Dortmund,de Bundesliga,18.99726027,2006,3.1,3,0,0,3,0,1,1,100,0,1,0,1,0,3,3,0
793,Hugo Duro,es ESP,FW,Valencia,es La Liga,25.47945205,1999,21.8,12,7,4,7,1,4,11,36.4,7,11,2,9,10,22,10,0
794,Jean-Kevin Duverne,ht HAI,DF,Nantes,fr Ligue 1,27.8109589,1997,6,21,12,13,4,4,15,27,55.6,12,10,3,7,8,29,23,0
795,Paulo Dybala,ar ARG,"FW,MF",Roma,it Serie A,31.46575342,1993,15.7,17,7,3,9,5,8,19,42.1,11,12,1,11,2,19,2,0
796,Stefan Džodić,rs SRB,"DF,MF",Montpellier,fr Ligue 1,20.1369863,2005,2.1,6,3,3,3,0,4,6,66.7,2,5,4,1,4,10,8,0
797,Adam Dźwigała,pl POL,"DF,MF",St. Pauli,de Bundesliga,29.60547945,1995,3.5,19,10,12,6,1,10,15,66.7,5,6,1,5,3,22,23,0
798,Aron Dønnum,no NOR,"DF,MF",Toulouse,fr Ligue 1,27.03835616,1998,28.9,55,34,24,24,7,31,55,56.4,24,29,4,25,28,83,37,1
799,Enzo Ebosse,cm CMR,DF,Udinese,it Serie A,26.14794521,1999,1,0,0,0,0,0,0,2,0,2,3,3,0,1,1,1,0
800,Tyronne Ebuehi,ng NGA,"DF,MF",Empoli,it Serie A,29.38082192,1995,0.7,2,1,0,2,0,1,1,100,0,1,0,1,2,4,0,0
801,Ederson,br BRA,GK,Manchester City,eng Premier League,31.71232877,1993,22.8,0,0,0,0,0,0,2,0,2,0,0,0,1,1,9,2
802,Éderson,br BRA,MF,Atalanta,it Serie A,25.82465753,1999,29.5,48,30,16,27,5,19,29,65.5,10,29,6,23,34,82,31,1
803,Noah Edjouma,fr FRA,"MF,FW",Toulouse,fr Ligue 1,19.58082192,2005,1.9,2,2,0,1,1,1,2,50,1,1,1,0,2,4,2,0
804,George Edmundson,eng ENG,DF,Ipswich Town,eng Premier League,27.6739726,1997,0,0,0,0,0,0,0,0,,0,0,0,0,0,0,0,0
805,Odsonne Édouard,fr FRA,"MF,FW",Crystal Palace,eng Premier League,27.29589041,1998,1.3,1,0,0,1,0,0,2,0,2,1,0,1,0,1,1,0
806,Odsonne Édouard,fr FRA,FW,Leicester City,eng Premier League,27.29589041,1998,0.3,1,1,1,0,0,0,0,,0,0,0,0,0,1,1,0
807,Samuel Edozie,eng ENG,"DF,FW",Southampton,eng Premier League,22.2630137,2003,0.7,3,1,0,1,2,2,2,100,0,0,0,0,0,3,0,0
808,Ronnie Edwards,eng ENG,DF,Southampton,eng Premier League,22.10136986,2003,0.1,0,0,0,0,0,0,0,,0,1,1,0,0,0,0,0
809,Johannes Eggestein,de GER,FW,St. Pauli,de Bundesliga,26.9890411,1998,20.3,5,3,0,2,3,1,5,20,4,5,0,5,0,5,8,0
810,Maximilian Eggestein,de GER,MF,Freiburg,de Bundesliga,28.40273973,1996,28.6,50,26,17,25,8,22,41,53.7,19,31,10,21,34,84,46,1
811,Kingsley Ehizibue,nl NED,DF,Udinese,it Serie A,29.94246575,1995,25.8,52,33,30,18,4,25,39,64.1,14,36,11,25,21,73,62,5
812,Chidera Ejuke,ng NGA,FW,Sevilla,es La Liga,27.33424658,1998,10.5,19,13,8,9,2,9,19,47.4,10,12,0,12,5,24,7,0
813,Jeff Ekhator,it ITA,"FW,MF",Genoa,it Serie A,18.47671233,2006,8.2,6,3,3,1,2,4,8,50,4,10,1,9,2,8,5,0
814,Hugo Ekitike,fr FRA,FW,Eint Frankfurt,de Bundesliga,22.87123288,2002,25.5,15,11,3,7,5,4,11,36.4,7,13,1,12,7,22,23,0
815,Jurgen Ekkelenkamp,nl NED,MF,Udinese,it Serie A,25.07945205,2000,18.9,35,24,10,21,4,17,32,53.1,15,25,4,21,12,47,22,0
816,Jacques Ekomie,ga GAB,DF,Angers,fr Ligue 1,21.70684932,2003,6.8,19,13,8,8,3,5,9,55.6,4,14,3,11,4,23,13,0
817,Emmanuel Ekong,se SWE,"MF,FW",Empoli,it Serie A,22.85753425,2002,2.1,4,3,0,2,2,3,3,100,0,2,1,1,1,5,1,0
818,Caleb Ekuban,gh GHA,FW,Genoa,it Serie A,31.11506849,1994,5.7,3,3,1,1,1,1,1,100,0,4,1,3,1,4,5,0
819,Pierre Ekwah Elimby,fr FRA,MF,Saint-Étienne,fr Ligue 1,23.29863014,2002,25.6,48,27,17,27,4,31,49,63.3,18,25,12,13,45,93,69,1
820,Anthony Elanga,se SWE,"FW,MF",Nott'ham Forest,eng Premier League,23.01917808,2002,23.8,17,12,7,8,2,4,16,25,12,11,1,10,5,22,25,0
821,Meschak Elia,cd COD,FW,Nantes,fr Ligue 1,27.74246575,1997,1.9,7,5,3,2,2,1,1,100,0,3,0,3,0,7,2,0
822,Mikael Ellertsson,is ISL,"DF,MF",Venezia,it Serie A,23.14794521,2002,24.7,51,24,33,11,7,29,54,53.7,25,39,4,35,13,64,71,0
823,Harvey Elliott,eng ENG,"MF,FW",Liverpool,eng Premier League,22.08219178,2003,2.2,4,3,2,1,1,1,4,25,3,4,1,3,1,5,2,0
824,Elif Elmas,mk MKD,"FW,MF",Torino,it Serie A,25.60821918,1999,9.5,8,5,3,5,0,4,7,57.1,3,7,2,5,6,14,5,2
825,Elif Elmas,mk MKD,MF,RB Leipzig,de Bundesliga,25.60821918,1999,0.5,3,1,3,0,0,1,3,33.3,2,2,0,2,0,3,2,0
826,Aritz Elustondo,es ESP,DF,Real Sociedad,es La Liga,31.10136986,1994,13.2,17,9,12,3,2,9,17,52.9,8,16,12,4,9,26,81,0
827,Nico Elvedi,ch SUI,DF,Gladbach,de Bundesliga,28.59178082,1996,22.2,36,23,26,6,4,17,23,73.9,6,35,27,8,29,65,153,0
828,Adri Embarba,es ESP,"FW,MF",Rayo Vallecano,es La Liga,32.99178082,1992,16.5,37,17,14,16,7,16,42,38.1,26,17,1,16,12,49,13,1
829,Breel Embolo,ch SUI,"FW,MF",Monaco,fr Ligue 1,28.21643836,1997,19.5,19,14,7,4,8,5,16,31.3,11,10,0,10,3,22,9,1
830,Emanuel Emegha,nl NED,FW,Strasbourg,fr Ligue 1,22.24657534,2003,25.5,6,6,1,2,3,2,6,33.3,4,18,5,13,1,7,30,0
831,Emerson,br BRA,DF,Milan,it Serie A,26.30136986,1999,15.3,45,28,24,16,5,16,34,47.1,18,13,2,11,14,59,56,0
832,Yunus Emre Konak,tr TUR,"FW,MF",Brentford,eng Premier League,19.31232877,2006,0.5,4,4,0,4,0,1,2,50,1,2,0,2,0,4,0,0
833,Julio Enciso,py PAR,"FW,MF",Ipswich Town,eng Premier League,21.27671233,2004,7.9,11,8,2,6,3,4,9,44.4,5,3,0,3,1,12,4,0
834,Julio Enciso,py PAR,"MF,FW",Brighton,eng Premier League,21.27671233,2004,3.3,0,0,0,0,0,0,2,0,2,2,0,2,0,0,1,0
835,Wataru Endo,jp JPN,MF,Liverpool,eng Premier League,32.23013699,1993,1.9,8,6,4,4,0,5,8,62.5,3,5,0,5,3,11,7,0
836,Endrick,br BRA,FW,Real Madrid,es La Liga,18.78630137,2006,2.5,1,1,1,0,0,1,3,33.3,2,0,0,0,3,4,1,0
837,Yannik Engelhardt,de GER,"MF,DF",Como,it Serie A,24.23561644,2001,12.2,28,11,12,13,3,15,26,57.7,11,10,5,5,10,38,26,0
838,Arne Engels,be BEL,"MF,FW",Augsburg,de Bundesliga,21.65205479,2003,0.9,0,0,0,0,0,0,0,,0,1,1,0,0,0,0,0
839,Christian Eriksen,dk DEN,MF,Manchester Utd,eng Premier League,33.21643836,1992,11,19,9,4,12,3,11,24,45.8,13,13,4,9,7,26,7,0
840,Martin Erlic,hr CRO,DF,Bologna,it Serie A,27.2739726,1998,3.4,2,0,0,2,0,1,2,50,1,5,4,1,2,4,9,0
841,Patrick Erras,de GER,DF,Holstein Kiel,de Bundesliga,30.28219178,1995,9.2,8,5,6,2,0,2,9,22.2,7,13,11,2,9,17,64,0
842,Alfonso Espino,uy URU,DF,Rayo Vallecano,es La Liga,33.3260274,1992,8.2,37,20,29,6,2,23,42,54.8,19,14,6,8,10,47,28,1
843,Sebastiano Esposito,it ITA,"FW,MF",Empoli,it Serie A,22.83835616,2002,23.3,50,26,14,27,9,15,31,48.4,16,20,2,18,12,62,13,0
844,Romain Esse,eng ENG,MF,Crystal Palace,eng Premier League,19.97534247,2005,0.4,2,2,2,0,0,2,2,100,0,1,0,1,1,3,0,0
845,Samuel Essende,cd COD,FW,Augsburg,de Bundesliga,27.27671233,1998,17.4,7,6,1,3,3,3,4,75,1,13,2,11,0,7,11,1
846,Dario Essugo,pt POR,MF,Las Palmas,es La Liga,20.13972603,2005,18.9,54,42,27,22,5,26,43,60.5,17,24,9,15,41,95,43,7
847,Estanis,es ESP,FW,Bologna,it Serie A,21.69315068,2003,0.1,0,0,0,0,0,0,0,,0,0,0,0,0,0,0,0
848,Nahuel Estévez,ar ARG,MF,Parma,it Serie A,29.46849315,1995,7.2,14,5,6,7,1,5,14,35.7,9,9,2,7,3,17,25,0
849,Pervis Estupiñán,ec ECU,DF,Brighton,eng Premier League,27.28219178,1998,23.7,54,36,29,18,7,29,44,65.9,15,16,2,14,30,84,53,2
850,Etienne Eto'o,cm CMR,FW,Rayo Vallecano,es La Liga,22.70958904,2002,0.4,0,0,0,0,0,0,1,0,1,0,0,0,0,0,1,0
851,Karl Etta,cm CMR,MF,Villarreal,es La Liga,21.55342466,2003,0,0,0,0,0,0,0,0,,0,0,0,0,0,0,0,0
852,Evanilson,br BRA,FW,Bournemouth,eng Premier League,25.57534247,1999,22.9,16,10,6,5,5,8,12,66.7,4,10,2,8,0,16,21,0
853,Jake Evans,,FW,Leicester City,eng Premier League,0,,0.1,0,0,0,0,0,0,1,0,1,0,0,0,0,0,1,0
854,Jonny Evans,nir NIR,DF,Manchester Utd,eng Premier League,37.33150685,1988,3.2,7,5,4,3,0,2,4,50,2,2,1,1,4,11,13,0
855,Edu Expósito,es ESP,MF,Espanyol,es La Liga,28.75616438,1996,7.2,14,7,5,9,0,6,17,35.3,11,3,0,3,10,24,15,1
856,Eberechi Eze,eng ENG,"MF,FW",Crystal Palace,eng Premier League,26.84657534,1998,26,37,22,13,15,9,17,35,48.6,18,26,0,26,11,48,9,3
857,Abde Ezzalzouli,ma MAR,"FW,MF",Betis,es La Liga,23.37808219,2001,19.2,34,24,16,15,3,14,25,56,11,20,3,17,6,40,13,0
858,Giovanni Fabbian,it ITA,MF,Bologna,it Serie A,22.30136986,2003,10.6,10,6,1,3,6,7,13,53.8,6,7,2,5,2,12,4,0
859,Łukasz Fabiański,pl POL,GK,West Ham,eng Premier League,40.04383562,1985,11.9,0,0,0,0,0,0,1,0,1,0,0,0,0,0,5,1
860,Alieu Fadera,gm GAM,"FW,DF",Como,it Serie A,23.49863014,2001,18.1,64,47,25,27,12,20,45,44.4,25,17,1,16,11,75,10,0
861,Wout Faes,be BEL,DF,Leicester City,eng Premier League,27.08493151,1998,28.3,39,23,25,12,2,23,43,53.5,20,45,33,12,26,65,160,4
862,Nicolò Fagioli,it ITA,MF,Fiorentina,it Serie A,24.22191781,2001,7.2,14,8,7,6,1,7,19,36.8,12,5,1,4,3,17,9,2
863,Nicolò Fagioli,it ITA,MF,Juventus,it Serie A,24.22191781,2001,6.3,14,10,7,6,1,6,9,66.7,3,4,0,4,2,16,5,0
864,Romain Faivre,fr FRA,"MF,FW",Brest,fr Ligue 1,26.80547945,1998,10,13,10,4,5,4,5,10,50,5,8,0,8,4,17,3,1
865,Wladimiro Falcone,it ITA,GK,Lecce,it Serie A,30.06027397,1995,35,0,0,0,0,0,0,0,,0,0,0,0,0,0,28,3
866,Davide Faraoni,it ITA,DF,Hellas Verona,it Serie A,33.52328767,1991,2.9,10,9,5,5,0,3,9,33.3,6,7,3,4,2,12,12,1
867,Abdul Fatawu Issahaku,gh GHA,FW,Leicester City,eng Premier League,21.15616438,2004,6.4,21,15,13,2,6,11,19,57.9,8,7,0,7,4,25,12,0
868,Ansu Fati,es ESP,FW,Barcelona,es La Liga,22.50684932,2002,2.6,4,1,0,2,2,1,2,50,1,1,0,1,1,5,0,1
869,Khalil Fayad,fr FRA,"MF,FW",Montpellier,fr Ligue 1,20.90136986,2004,9.4,30,15,12,16,2,14,24,58.3,10,16,1,15,8,38,15,1
870,Jacopo Fazzini,it ITA,MF,Empoli,it Serie A,22.13424658,2003,11.5,26,15,10,12,4,11,19,57.9,8,8,1,7,6,32,22,0
871,Nabil Fekir,fr FRA,MF,Betis,es La Liga,31.79452055,1993,2,3,2,1,1,1,1,2,50,1,2,0,2,0,3,0,0
872,Mattia Felici,it ITA,"MF,FW",Cagliari,it Serie A,24.04657534,2001,9.9,17,12,8,7,2,4,11,36.4,7,10,0,10,7,24,7,0
873,Luiz Felipe,it ITA,DF,Marseille,fr Ligue 1,28.11780822,1997,0.8,2,1,2,0,0,0,1,0,1,2,2,0,1,3,1,0
874,João Félix,pt POR,"FW,MF",Chelsea,eng Premier League,25.47945205,1999,4.1,8,3,2,5,1,5,9,55.6,4,2,0,2,3,11,2,0
875,João Félix,pt POR,"MF,FW",Milan,it Serie A,25.47945205,1999,5.6,4,4,1,2,1,3,10,30,7,1,0,1,0,4,8,0
876,Frank Feller,de GER,GK,Heidenheim,de Bundesliga,21.32054795,2004,0.3,0,0,0,0,0,0,0,,0,0,0,0,0,0,0,0
877,Kiko Femenía,es ESP,DF,Villarreal,es La Liga,34.24931507,1991,24.7,50,34,34,14,2,33,57,57.9,24,21,10,11,40,90,62,3
878,Evan Ferguson,ie IRL,FW,West Ham,eng Premier League,20.53972603,2004,1.6,2,0,0,1,1,0,0,,0,2,1,1,1,3,1,0
879,Evan Ferguson,ie IRL,FW,Brighton,eng Premier League,20.53972603,2004,2.7,4,3,0,3,1,2,5,40,3,3,1,2,0,4,4,0
880,Lewis Ferguson,sct SCO,MF,Bologna,it Serie A,25.69315068,1999,7.9,18,9,3,10,5,7,13,53.8,6,6,2,4,3,21,9,0
881,Zinedine Ferhat,dz ALG,"FW,MF",Angers,fr Ligue 1,32.17534247,1993,9.2,9,7,1,5,3,4,13,30.8,9,9,0,9,10,19,12,0
882,Bruno Fernandes,pt POR,MF,Manchester Utd,eng Premier League,30.65205479,1994,30.6,76,47,24,37,15,29,75,38.7,46,32,4,28,25,101,34,2
883,Edimilson Fernandes,ch SUI,MF,Brest,fr Ligue 1,29.05205479,1996,10.3,8,6,2,6,0,6,10,60,4,13,5,8,17,25,27,1
884,Mateus Fernandes,pt POR,MF,Southampton,eng Premier League,20.81643836,2004,29.3,86,46,43,28,15,33,64,51.6,31,40,6,34,21,107,31,6
885,Aitor Fernández,es ESP,GK,Osasuna,es La Liga,34.00273973,1991,1,0,0,0,0,0,0,0,,0,0,0,0,0,0,2,0
886,Álvaro Fernández,es ESP,GK,Sevilla,es La Liga,27.05753425,1998,7.3,0,0,0,0,0,0,1,0,1,0,0,0,0,0,7,0
887,Enzo Fernández,ar ARG,MF,Chelsea,eng Premier League,24.29315068,2001,28.8,61,30,16,28,17,29,78,37.2,49,32,5,27,11,72,22,4
888,Pelayo Fernandez,es ESP,DF,Rayo Vallecano,es La Liga,22.01369863,2003,1,0,0,0,0,0,0,0,,0,0,0,0,1,1,8,0
889,Roberto Férnandez,es ESP,FW,Espanyol,es La Liga,22.83561644,2002,12.1,4,4,2,1,1,0,2,0,2,5,1,4,3,7,21,0
890,Valery Fernández,es ESP,"MF,FW",Mallorca,es La Liga,25.44383562,1999,3.3,8,7,3,2,3,5,7,71.4,2,3,1,2,0,8,1,0
891,Matias Fernandez-Pardo,be BEL,"FW,MF",Lille,fr Ligue 1,20.24657534,2005,9.1,10,7,3,4,3,6,11,54.5,5,8,0,8,2,12,4,0
892,André Ferreira,pt POR,GK,Valladolid,es La Liga,28.93150685,1996,5,0,0,0,0,0,0,0,,0,0,0,0,0,0,4,2
893,Jordan Ferri,fr FRA,MF,Montpellier,fr Ligue 1,33.14520548,1992,17.3,38,19,16,20,2,16,39,41,23,15,2,13,9,47,17,0
894,Daniel Fila,cz CZE,FW,Venezia,it Serie A,22.70136986,2002,4.7,2,0,0,1,1,0,2,0,2,5,0,5,0,2,5,0
895,Karol Fila,pl POL,MF,Strasbourg,fr Ligue 1,26.89041096,1998,0.1,0,0,0,0,0,0,0,,0,0,0,0,0,0,0,0
896,Kilian Fischer,de GER,DF,Wolfsburg,de Bundesliga,24.55890411,2000,24.9,63,43,47,12,4,46,88,52.3,42,39,8,31,19,82,96,2
897,Mark Flekken,nl NED,GK,Brentford,eng Premier League,31.89041096,1993,32.4,4,4,4,0,0,3,9,33.3,6,2,0,2,0,4,26,3
898,Mateo Flores,es ESP,MF,Betis,es La Liga,21.0739726,2004,1.7,3,1,3,0,0,1,1,100,0,1,0,1,2,5,3,0
899,Phil Foden,eng ENG,"MF,FW",Manchester City,eng Premier League,24.93424658,2000,18.8,12,5,5,4,3,7,17,41.2,10,12,1,11,9,21,7,1
900,Malick Fofana,be BEL,"FW,MF",Lyon,fr Ligue 1,20.09315068,2005,14.7,19,9,8,9,2,7,15,46.7,8,10,0,10,8,27,6,0
901,Rayan Fofana,fr FRA,"FW,MF",Lens,fr Ligue 1,19.22191781,2006,0.3,2,2,1,1,0,0,0,,0,0,0,0,0,2,0,0
902,Seko Fofana,ci CIV,MF,Rennes,fr Ligue 1,29.99178082,1995,8.9,10,7,3,6,1,2,7,28.6,5,7,1,6,6,16,7,0
903,Wesley Fofana,fr FRA,DF,Chelsea,eng Premier League,24.37808219,2000,13,13,12,6,7,0,6,14,42.9,8,14,9,5,14,27,55,2
904,Yahia Fofana,ci CIV,GK,Angers,fr Ligue 1,24.70136986,2000,31,0,0,0,0,0,0,2,0,2,0,0,0,1,1,23,2
905,Youssouf Fofana,fr FRA,MF,Milan,it Serie A,26.31232877,1999,27.1,56,34,20,31,5,26,51,51,25,30,8,22,19,75,22,3
906,Jonas Föhrenbach,de GER,DF,Heidenheim,de Bundesliga,29.26849315,1996,20.2,44,23,24,15,5,22,35,62.9,13,29,3,26,16,60,57,0
907,Michael Folorunsho,it ITA,"FW,MF",Fiorentina,it Serie A,27.23561644,1998,6.9,19,12,9,6,4,8,20,40,12,9,1,8,4,23,10,0
908,Michael Folorunsho,it ITA,"FW,MF",Napoli,it Serie A,27.23561644,1998,0.4,3,2,0,3,0,2,4,50,2,0,0,0,1,4,1,1
909,Lamine Fomba,fr FRA,MF,Saint-Étienne,fr Ligue 1,27.26849315,1998,2.4,8,6,2,5,1,2,7,28.6,5,7,1,6,4,12,5,1
910,Carlos Forbs,pt POR,"MF,FW",Wolves,eng Premier League,21.1260274,2004,2.7,8,5,5,2,1,4,6,66.7,2,3,0,3,1,9,2,1
911,Pablo Fornals,es ESP,"MF,FW",Betis,es La Liga,29.19452055,1996,17.1,16,10,9,6,1,6,24,25,18,19,1,18,20,36,13,1
912,Omari Forson,eng ENG,"MF,DF",Monza,it Serie A,20.7890411,2004,1.3,2,2,1,1,0,1,2,50,1,2,0,2,0,2,0,0
913,Fraser Forster,eng ENG,GK,Tottenham,eng Premier League,37.13150685,1988,7,0,0,0,0,0,0,1,0,1,0,0,0,0,0,7,3
914,Héctor Fort,es ESP,DF,Barcelona,es La Liga,18.75342466,2006,6,13,8,6,4,3,10,15,66.7,5,11,0,11,7,20,14,0
915,Dimitri Foulquier,fr FRA,DF,Valencia,es La Liga,32.11506849,1993,24.9,48,31,29,13,6,24,36,66.7,12,21,5,16,16,64,84,1
916,Juan Foyth,ar ARG,DF,Villarreal,es La Liga,27.30684932,1998,13.9,23,14,14,5,4,10,15,66.7,5,22,13,9,17,40,97,3
917,Fran,es ESP,GK,Real Madrid,es La Liga,19.86027397,2005,1,0,0,0,0,0,0,0,,0,0,0,0,0,0,2,0
918,Matheus França,br BRA,"FW,MF",Crystal Palace,eng Premier League,21.09041096,2004,0.3,1,0,0,1,0,0,0,,0,0,0,0,0,1,0,0
919,Alejandro Francés,es ESP,DF,Girona,es La Liga,22.75616438,2002,10.6,29,21,15,13,1,22,31,71,9,12,5,7,15,44,37,0
920,Przemysław Frankowski,pl POL,DF,Lens,fr Ligue 1,30.06027397,1995,15.4,32,21,17,10,5,19,30,63.3,11,10,2,8,19,51,28,0
921,Enric Franquesa,es ESP,"DF,FW",Leganés,es La Liga,28.18356164,1997,6.8,17,9,9,6,2,9,13,69.2,4,7,1,6,5,22,12,0
922,Ryan Fraser,sct SCO,"FW,DF",Southampton,eng Premier League,31.1890411,1994,3.4,6,2,2,4,0,4,6,66.7,2,1,1,0,1,7,9,0
923,Davide Frattesi,it ITA,MF,Inter,it Serie A,25.53150685,1999,13.6,17,8,6,10,1,10,18,55.6,8,12,4,8,5,22,14,1
924,Tyler Fredricson,eng ENG,DF,Manchester Utd,eng Premier League,20.19178082,2005,1,4,2,2,2,0,0,1,0,1,0,0,0,1,5,4,0
925,Morten Frendrup,dk DEN,MF,Genoa,it Serie A,24.0739726,2001,31.5,99,59,22,50,27,33,72,45.8,39,57,15,42,44,143,53,0
926,Martin Frese,dk DEN,DF,Hellas Verona,it Serie A,27.32876712,1998,5,14,8,6,8,0,5,9,55.6,4,4,1,3,8,22,15,1
927,Remo Freuler,ch SUI,MF,Bologna,it Serie A,33.05205479,1992,32,72,36,26,37,9,32,72,44.4,40,35,4,31,35,107,54,1
928,Marco Friedl,at AUT,DF,Werder Bremen,de Bundesliga,27.13424658,1998,22,56,38,30,25,1,35,61,57.4,26,37,22,15,32,88,124,1
929,Marvin Friedrich,de GER,DF,Gladbach,de Bundesliga,29.3890411,1995,11,15,9,12,3,0,9,16,56.3,7,16,12,4,5,20,57,0
930,Jeremie Frimpong,nl NED,"DF,MF",Leverkusen,de Bundesliga,24.39726027,2000,23.9,31,23,13,11,7,15,28,53.6,13,24,0,24,8,39,20,1
931,Jorge de Frutos,es ESP,"FW,MF",Rayo Vallecano,es La Liga,28.2,1997,24.7,35,19,15,13,7,12,40,30,28,20,0,20,17,52,20,1
932,Darío Fuentes,es ESP,DF,Sevilla,es La Liga,22.30684932,2003,0.1,0,0,0,0,0,0,0,,0,0,0,0,0,0,0,0
933,Chris Führich,de GER,"MF,FW",Stuttgart,de Bundesliga,27.31506849,1998,20.8,13,8,3,5,5,11,25,44,14,21,2,19,6,19,19,0
934,Shiō Fukuda,jp JPN,"FW,MF",Gladbach,de Bundesliga,21.07123288,2004,0.6,0,0,0,0,0,0,0,,0,1,0,1,0,0,0,0
935,Angelo Fulgini,fr FRA,"MF,FW",Lens,fr Ligue 1,28.70410959,1996,11.6,14,10,6,4,4,6,16,37.5,10,11,1,10,2,16,3,0
936,Niclas Füllkrug,de GER,FW,West Ham,eng Premier League,32.23013699,1993,6.5,2,2,0,1,1,2,3,66.7,1,1,0,1,0,2,12,0
937,Kyogo Furuhashi,jp JPN,FW,Rennes,fr Ligue 1,30.28493151,1995,1.4,2,2,1,1,0,1,1,100,0,0,0,0,0,2,0,0
938,Manuel Fuster,es ESP,"FW,MF",Las Palmas,es La Liga,27.53150685,1997,8.8,16,8,3,8,5,14,26,53.8,12,13,3,10,4,20,14,0
939,Matteo Gabbia,it ITA,DF,Milan,it Serie A,25.53424658,1999,20,19,13,11,7,1,7,9,77.8,2,22,17,5,13,32,82,1
940,Tiago Gabriel,pt POR,DF,Lecce,it Serie A,20.35342466,2004,0.9,0,0,0,0,0,0,0,,0,3,2,1,0,0,5,0
941,Alessandro Gabrielloni,it ITA,"FW,MF",Como,it Serie A,30.81643836,1994,1.6,0,0,0,0,0,0,3,0,3,0,0,0,0,0,1,0
942,Gianluca Gaetano,it ITA,"MF,FW",Cagliari,it Serie A,24.99726027,2000,10.7,9,6,3,5,1,4,14,28.6,10,8,0,8,5,14,8,0
943,Roberto Gagliardini,it ITA,"MF,DF",Monza,it Serie A,31.0739726,1994,2,3,2,1,2,0,1,4,25,3,1,0,1,2,5,4,0
944,Cody Gakpo,nl NED,FW,Liverpool,eng Premier League,25.99178082,1999,18.1,26,14,5,12,9,11,23,47.8,12,19,2,17,11,37,16,1
945,Javi Galán,es ESP,DF,Atlético Madrid,es La Liga,30.45479452,1994,17.3,48,29,29,15,4,24,46,52.2,22,12,3,9,9,57,41,0
946,Iñigo Ruiz de Galarreta,es ESP,MF,Athletic Club,es La Liga,31.74246575,1993,13.2,33,20,11,16,6,18,28,64.3,10,8,3,5,11,44,9,2
947,Conor Gallagher,eng ENG,MF,Atlético Madrid,es La Liga,25.23835616,2000,17.2,42,30,16,16,10,20,46,43.5,26,23,5,18,19,61,23,0
948,Antonino Gallo,it ITA,DF,Lecce,it Serie A,25.3260274,2000,26,63,41,44,15,4,32,59,54.2,27,29,3,26,20,83,112,0
949,Gauthier Gallon,fr FRA,GK,Rennes,fr Ligue 1,32.03013699,1993,0.5,0,0,0,0,0,0,0,,0,0,0,0,0,0,0,0
950,Cristian Gamboa,cr CRC,DF,Bochum,de Bundesliga,35.5260274,1989,2.3,8,3,5,3,0,3,9,33.3,6,2,0,2,2,10,6,0
951,Idrissa Gana Gueye,sn SEN,MF,Everton,eng Premier League,35.60273973,1989,31,124,74,57,51,16,54,90,60,36,45,9,36,44,168,30,1
952,Ignatius Ganago,cm CMR,"FW,MF",Nantes,fr Ligue 1,26.2109589,1999,2.7,1,1,0,1,0,1,2,50,1,3,1,2,4,5,2,0
953,Silvère Ganvoula M'Boussy,cg CGO,FW,Monza,it Serie A,28.86575342,1996,3.6,0,0,0,0,0,0,1,0,1,1,0,1,1,1,5,0
954,Facundo Garcés,ar ARG,DF,Alavés,es La Liga,25.66027397,1999,3.5,2,0,2,0,0,1,2,50,1,6,5,1,2,4,28,0
955,Aleix García,es ESP,MF,Leverkusen,de Bundesliga,27.84931507,1997,14.4,10,6,3,5,2,5,12,41.7,7,10,1,9,8,18,22,1
956,Álvaro García,es ESP,"FW,MF",Rayo Vallecano,es La Liga,32.51780822,1992,25.2,31,22,19,8,4,12,28,42.9,16,30,0,30,30,61,39,1
957,Andrés García,es ESP,"DF,MF",Aston Villa,eng Premier League,22.23561644,2003,3.5,9,5,5,3,1,4,8,50,4,2,0,2,2,11,10,2
958,Eric García,es ESP,"MF,DF",Barcelona,es La Liga,24.31506849,2001,13.7,28,16,7,19,2,14,20,70,6,20,7,13,10,38,35,0
959,Fran Garcia,es ESP,DF,Real Madrid,es La Liga,25.72054795,1999,19.3,36,24,22,10,4,19,33,57.6,14,21,4,17,23,59,61,1
960,Joan García,es ESP,GK,Espanyol,es La Liga,24,2001,33,0,0,0,0,0,0,1,0,1,1,0,1,0,0,17,4
961,Pablo Garcia,es ESP,FW,Betis,es La Liga,18.71780822,2006,0.3,0,0,0,0,0,0,0,,0,1,0,1,0,0,0,0
962,Rubén García,es ESP,"FW,MF",Osasuna,es La Liga,31.80547945,1993,24.5,46,29,17,19,10,23,51,45.1,28,32,2,30,14,60,30,1
963,Ulisses Garcia,ch SUI,DF,Marseille,fr Ligue 1,29.30958904,1996,8.6,14,11,7,5,2,4,13,30.8,9,5,1,4,8,22,17,0
964,Unai García,es ESP,DF,Osasuna,es La Liga,33.24657534,1992,0.7,0,0,0,0,0,0,0,,0,1,0,1,0,0,1,0
965,Alejandro Garnacho,ar ARG,"MF,FW",Manchester Utd,eng Premier League,20.84109589,2004,22.8,28,18,10,6,12,11,34,32.4,23,19,0,19,13,41,10,2
966,James Garner,eng ENG,"MF,DF",Everton,eng Premier League,24.14246575,2001,14.7,41,27,24,15,2,19,35,54.3,16,15,3,12,17,58,36,0
967,Yarek Gasiorowski,es ESP,DF,Valencia,es La Liga,20.30684932,2005,10.5,19,16,16,3,0,9,13,69.2,4,17,6,11,26,45,60,0
968,Federico Gatti,it ITA,DF,Juventus,it Serie A,26.86027397,1998,24.3,28,23,18,8,2,14,24,58.3,10,27,18,9,18,46,73,2
969,Gavi,es ESP,"MF,FW",Barcelona,es La Liga,20.74520548,2004,9.9,19,15,4,11,4,10,18,55.6,8,13,1,12,10,29,5,0
970,Paulo Gazzaniga,ar ARG,GK,Girona,es La Liga,33.33424658,1992,32.5,1,1,1,0,0,1,1,100,0,1,0,1,0,1,12,3
971,Jean-Philippe Gbamin,ci CIV,MF,Nantes,fr Ligue 1,29.60547945,1995,2.4,2,1,0,2,0,1,4,25,3,5,2,3,3,5,2,0
972,Mory Gbane,ci CIV,"DF,MF",Reims,fr Ligue 1,24.35616438,2000,10.5,18,10,14,4,0,11,21,52.4,10,11,9,2,17,35,78,1
973,Yann Gboho,fr FRA,"MF,FW",Toulouse,fr Ligue 1,24.30136986,2001,23.9,28,15,6,14,8,12,30,40,18,20,0,20,5,33,4,1
974,David de Gea,es ESP,GK,Fiorentina,it Serie A,34.48767123,1990,31,1,0,1,0,0,1,1,100,0,0,0,0,0,1,10,0
975,Viggo Gebel,de GER,MF,RB Leipzig,de Bundesliga,17.44657534,2007,0.2,0,0,0,0,0,0,0,,0,0,0,0,0,0,0,0
976,Lutsharel Geertruida,nl NED,DF,RB Leipzig,de Bundesliga,24.79452055,2000,16.3,35,24,24,11,0,15,31,48.4,16,15,4,11,16,51,56,4
977,Dennis Geiger,de GER,"MF,FW",Hoffenheim,de Bundesliga,26.89863014,1998,7.3,22,10,8,12,2,11,17,64.7,6,13,2,11,5,27,6,1
978,Valentin Gendrey,fr FRA,DF,Lecce,it Serie A,24.86849315,2000,2,2,2,1,0,1,1,1,100,0,3,1,2,2,4,1,0
979,Valentin Gendrey,fr FRA,DF,Hoffenheim,de Bundesliga,24.86849315,2000,15.7,30,12,19,9,2,11,18,61.1,7,19,5,14,15,45,53,0
980,Denis Genreau,au AUS,MF,Toulouse,fr Ligue 1,25.95342466,1999,2.5,7,5,4,1,2,4,8,50,4,3,0,3,3,10,4,0
981,Tyrique George,eng ENG,FW,Chelsea,eng Premier League,19.24383562,2006,1.1,2,0,2,0,0,2,3,66.7,1,0,0,0,1,3,1,0
982,Yannick Gerhardt,de GER,"MF,DF",Wolfsburg,de Bundesliga,31.14246575,1994,14.9,23,12,12,10,1,8,26,30.8,18,28,8,20,16,39,41,0
983,Max Geschwill,de GER,DF,Holstein Kiel,de Bundesliga,23.82465753,2001,13.7,26,21,13,12,1,14,19,73.7,5,14,9,5,27,53,50,1
984,Daniele Ghilardi,it ITA,DF,Hellas Verona,it Serie A,22.32328767,2003,19.5,38,23,24,14,0,22,37,59.5,15,25,12,13,23,61,88,0
985,Lautaro Gianetti,ar ARG,DF,Udinese,it Serie A,31.47123288,1993,9.6,22,10,16,5,1,14,20,70,6,20,10,10,15,37,46,1
986,Dimitris Giannoulis,gr GRE,DF,Augsburg,de Bundesliga,29.54520548,1995,26.4,44,29,26,15,3,25,42,59.5,17,45,11,34,42,86,69,0
987,Morgan Gibbs-White,eng ENG,MF,Nott'ham Forest,eng Premier League,25.26575342,2000,27.2,39,18,14,19,6,15,30,50,15,14,4,10,18,57,27,1
988,Samuel Gigot,fr FRA,DF,Lazio,it Serie A,31.55890411,1993,6.6,3,2,1,2,0,0,1,0,1,6,4,2,13,16,29,0
989,Armin Gigovic,ba BIH,MF,Holstein Kiel,de Bundesliga,23.07671233,2002,19.4,22,10,12,7,3,4,19,21.1,15,17,1,16,19,41,30,0
990,Bryan Gil,es ESP,"FW,MF",Girona,es La Liga,24.22465753,2001,19.1,34,20,10,15,9,14,30,46.7,16,24,0,24,10,44,9,4
991,Mario Gila,es ESP,DF,Lazio,it Serie A,24.67945205,2000,27.2,51,36,32,17,2,34,49,69.4,15,19,13,6,25,76,106,3
992,Billy Gilmour,sct SCO,MF,Brighton,eng Premier League,23.89589041,2001,1.1,3,3,2,1,0,3,4,75,1,1,0,1,0,3,1,0
993,Billy Gilmour,sct SCO,MF,Napoli,it Serie A,23.89589041,2001,10.5,19,11,8,6,5,8,16,50,8,6,1,5,6,25,18,0
994,Benedikt Gimber,de GER,DF,Heidenheim,de Bundesliga,28.20273973,1997,28.2,70,45,47,22,1,37,62,59.7,25,52,19,33,31,101,129,1
995,Santiago Giménez,mx MEX,FW,Milan,it Serie A,24.04383562,2001,6.7,5,3,0,4,1,3,4,75,1,3,1,2,1,6,11,0
996,Gvidas Gineitis,lt LTU,MF,Torino,it Serie A,21.05205479,2004,14.2,24,14,8,10,6,13,25,52,12,16,6,10,14,38,29,0
997,Matthias Ginter,de GER,DF,Freiburg,de Bundesliga,31.28767123,1994,25.5,27,16,14,10,3,14,25,56,11,32,20,12,14,41,129,5
998,Jamie Gittens,eng ENG,"FW,MF",Dortmund,de Bundesliga,20.7369863,2004,19.6,30,19,12,11,7,14,18,77.8,4,16,0,16,10,40,4,0
999,Serge Gnabry,de GER,"FW,MF",Bayern Munich,de Bundesliga,29.80547945,1995,12.7,19,11,6,6,7,8,12,66.7,4,11,0,11,6,25,9,0
1000,Ben Godfrey,eng ENG,DF,Ipswich Town,eng Premier League,27.29863014,1998,1.8,1,0,1,0,0,1,1,100,0,1,1,0,2,3,3,0
1001,Ben Godfrey,eng ENG,DF,Atalanta,it Serie A,27.29863014,1998,0.3,0,0,0,0,0,0,1,0,1,1,1,0,0,0,0,0
1002,Martial Godo,eng ENG,FW,Fulham,eng Premier League,22.13972603,2003,0.2,0,0,0,0,0,0,0,,0,1,0,1,1,1,0,0
1003,Saba Goglichidze,ge GEO,DF,Empoli,it Serie A,20.85753425,2004,26.3,63,37,35,25,3,25,50,50,25,34,16,18,33,96,92,3
1004,Edoardo Goldaniga,it ITA,DF,Como,it Serie A,31.50136986,1993,26.1,31,19,18,8,5,11,16,68.8,5,18,9,9,27,58,91,3
1005,Michael Golding,eng ENG,MF,Leicester City,eng Premier League,18.94794521,2006,0,0,0,0,0,0,0,0,,0,0,0,0,0,0,0,0
1006,Pierluigi Gollini,it ITA,GK,Genoa,it Serie A,30.12876712,1995,7,0,0,0,0,0,0,0,,0,1,0,1,0,0,2,1
1007,Aleksandr Golovin,ru RUS,"MF,FW",Monaco,fr Ligue 1,28.92876712,1996,12.8,38,24,9,20,9,17,39,43.6,22,16,4,12,12,50,7,0
1008,André Gomes,pt POR,MF,Lille,fr Ligue 1,31.76164384,1993,14.2,27,13,9,11,7,11,31,35.5,20,7,1,6,6,33,11,2
1009,Angel Gomes,eng ENG,MF,Lille,fr Ligue 1,24.6739726,2000,8.2,10,6,4,4,2,2,12,16.7,10,0,0,0,0,10,2,0
1010,João Gomes,br BRA,MF,Wolves,eng Premier League,24.22191781,2001,30.9,105,62,53,48,4,42,102,41.2,60,42,4,38,25,130,32,0
1011,Rodrigo Gomes,pt POR,"DF,FW",Wolves,eng Premier League,21.82465753,2003,7.5,21,13,12,9,0,10,19,52.6,9,8,1,7,5,26,20,1
1012,Toti Gomes,pt POR,DF,Wolves,eng Premier League,26.29589041,1999,26,53,38,37,14,2,30,37,81.1,7,28,17,11,23,76,134,5
1013,Carlos Gómez,co COL,"MF,DF",Rennes,fr Ligue 1,22.64109589,2002,3.9,8,6,3,4,1,3,9,33.3,6,6,0,6,2,10,2,0
1014,Dani Gómez,es ESP,FW,Valencia,es La Liga,26.76164384,1998,5.9,3,2,0,0,3,0,0,,0,1,0,1,2,5,4,0
1015,Diego Gómez,py PAR,MF,Brighton,eng Premier League,22.10410959,2003,4.9,17,10,8,7,2,9,18,50,9,11,0,11,7,24,9,1
1016,Joe Gomez,eng ENG,DF,Liverpool,eng Premier League,27.94794521,1997,5.8,13,10,5,7,1,11,16,68.8,5,9,6,3,7,20,20,2
1017,Moi Gómez,es ESP,"MF,FW",Osasuna,es La Liga,30.8630137,1994,8.8,13,9,4,7,2,4,8,50,4,5,2,3,5,18,7,1
1018,Sergi Gómez,es ESP,DF,Espanyol,es La Liga,33.10136986,1992,7.2,8,5,7,1,0,2,3,66.7,1,12,8,4,7,15,36,0
1019,Sergio Gómez,es ESP,"MF,DF",Real Sociedad,es La Liga,24.6630137,2000,27.5,65,37,25,28,12,27,52,51.9,25,40,2,38,17,82,27,2
1020,Unai Gómez,es ESP,"MF,FW",Athletic Club,es La Liga,21.94246575,2003,11.4,9,5,3,5,1,4,6,66.7,2,9,1,8,2,11,9,0
1021,Tidiam Gomis,fr FRA,"MF,DF",RB Leipzig,de Bundesliga,18.7369863,2006,0.9,0,0,0,0,0,0,0,,0,2,0,2,1,1,0,0
1022,Fabio González,es ESP,MF,Las Palmas,es La Liga,28.22191781,1997,0.6,0,0,0,0,0,0,1,0,1,0,0,0,0,0,0,0
1023,Nicolás González,es ESP,MF,Manchester City,eng Premier League,23.33150685,2002,7.2,15,6,5,6,4,6,11,54.5,5,9,0,9,5,20,17,0
1024,Nicolás González,ar ARG,"FW,MF",Juventus,it Serie A,27.07671233,1998,16.2,22,12,10,8,4,9,22,40.9,13,15,4,11,7,29,25,2
1025,Peter González,do DOM,"MF,FW",Getafe,es La Liga,22.77534247,2002,4.4,9,5,1,4,4,4,7,57.1,3,6,0,6,1,10,5,0
1026,Urko González,es ESP,MF,Espanyol,es La Liga,24.12328767,2001,10.5,33,19,18,14,1,20,29,69,9,20,8,12,7,40,29,0
1027,Urko González,es ESP,MF,Real Sociedad,es La Liga,24.12328767,2001,0.5,0,0,0,0,0,0,0,,0,1,1,0,0,0,0,0
1028,Anthony Gordon,eng ENG,FW,Newcastle Utd,eng Premier League,24.1890411,2001,24.4,31,17,9,18,4,12,34,35.3,22,24,2,22,6,37,9,2
1029,Leon Goretzka,de GER,MF,Bayern Munich,de Bundesliga,30.23835616,1995,13.5,20,11,5,12,3,10,20,50,10,21,4,17,17,37,22,1
1030,Mathieu Gorgelin,fr FRA,GK,Le Havre,fr Ligue 1,34.74520548,1990,13,2,2,2,0,0,2,3,66.7,1,0,0,0,0,2,8,2
1031,Andoni Gorosabel,es ESP,DF,Athletic Club,es La Liga,28.74794521,1996,14.6,40,23,26,8,6,25,39,64.1,14,17,2,15,15,55,49,0
1032,Robin Gosens,de GER,DF,Fiorentina,it Serie A,30.83013699,1994,24.6,50,29,27,15,8,24,41,58.5,17,28,8,20,16,66,86,0
1033,Robin Gosens,de GER,DF,Union Berlin,de Bundesliga,30.83013699,1994,1,0,0,0,0,0,0,3,0,3,1,0,1,1,1,2,0
1034,Mario Götze,de GER,"MF,FW",Eint Frankfurt,de Bundesliga,32.91780822,1992,17.1,41,28,18,20,3,15,36,41.7,21,15,1,14,7,48,8,0
1035,Amine Gouiri,dz ALG,"FW,MF",Marseille,fr Ligue 1,25.2109589,2000,8.7,5,5,0,1,4,2,3,66.7,1,6,0,6,0,5,1,0
1036,Amine Gouiri,dz ALG,"MF,FW",Rennes,fr Ligue 1,25.2109589,2000,11.5,9,6,4,4,1,2,8,25,6,8,0,8,2,11,5,0
1037,Lucas Gourna-Douath,fr FRA,MF,Roma,it Serie A,21.74520548,2003,2.1,7,4,4,3,0,2,6,33.3,4,1,1,0,0,7,1,0
1038,Jeffrey Gouweleeuw,nl NED,DF,Augsburg,de Bundesliga,33.81643836,1991,29.7,45,24,24,17,4,24,35,68.6,11,30,13,17,31,76,167,0
1039,Kamil Grabara,pl POL,GK,Wolfsburg,de Bundesliga,26.31780822,1999,26.7,0,0,0,0,0,0,2,0,2,1,0,1,0,0,12,2
1040,Jonathan Gradit,fr FRA,DF,Lens,fr Ligue 1,32.44109589,1992,20.5,41,21,21,17,3,21,37,56.8,16,22,9,13,23,64,98,2
1041,José Gragera,es ESP,MF,Espanyol,es La Liga,24.42465753,2000,6.3,25,16,11,14,0,9,17,52.9,8,9,1,8,5,30,13,0
1042,Samuel Grandsir,fr FRA,"MF,FW",Le Havre,fr Ligue 1,28.72054795,1996,0.9,5,5,0,3,2,2,3,66.7,1,2,0,2,0,5,0,0
1043,Alberto Grassi,it ITA,MF,Empoli,it Serie A,30.15890411,1995,21.7,36,18,13,18,5,12,18,66.7,6,22,12,10,30,66,39,1
1044,Ryan Gravenberch,nl NED,MF,Liverpool,eng Premier League,22.96712329,2002,32.5,65,34,25,29,11,30,51,58.8,21,34,10,24,57,122,56,1
1045,Archie Gray,eng ENG,"DF,MF",Tottenham,eng Premier League,19.14520548,2006,15.5,12,6,3,6,3,6,16,37.5,10,19,10,9,12,24,39,2
1046,Jack Grealish,eng ENG,"FW,MF",Manchester City,eng Premier League,29.64657534,1995,8,9,5,4,2,3,2,5,40,3,12,2,10,2,11,5,1
1047,Jacob Greaves,eng ENG,DF,Ipswich Town,eng Premier League,24.64109589,2000,21.5,36,19,19,16,1,21,33,63.6,12,36,24,12,18,54,127,2
1048,Mason Greenwood,eng ENG,"FW,MF",Marseille,fr Ligue 1,23.5890411,2001,28.2,33,17,10,13,10,16,36,44.4,20,7,0,7,10,43,5,2
1049,Michael Gregoritsch,at AUT,FW,Freiburg,de Bundesliga,31.04383562,1994,6.9,3,2,1,0,2,0,4,0,4,2,1,1,0,3,10,0
1050,Dominik Greif,sk SVK,GK,Mallorca,es La Liga,28.07671233,1997,27,0,0,0,0,0,0,0,,0,0,0,0,0,0,7,1
1051,Antoine Griezmann,fr FRA,"FW,MF",Atlético Madrid,es La Liga,34.12054795,1991,26,30,17,13,13,4,7,29,24.1,22,16,1,15,6,36,23,1
1052,Vincenzo Grifo,it ITA,"FW,MF",Freiburg,de Bundesliga,32.0739726,1993,24.2,22,17,10,11,1,11,30,36.7,19,22,2,20,7,29,19,1
1053,Florian Grillitsch,at AUT,MF,Valladolid,es La Liga,29.73972603,1995,5.3,8,6,5,3,0,5,13,38.5,8,10,1,9,4,12,5,1
1054,Florian Grillitsch,at AUT,MF,Hoffenheim,de Bundesliga,29.73972603,1995,6.7,15,9,5,9,1,8,14,57.1,6,6,2,4,8,23,18,0
1055,Álex Grimaldo,es ESP,"DF,MF",Leverkusen,de Bundesliga,29.61917808,1995,27,21,12,12,5,4,15,37,40.5,22,22,3,19,15,36,42,3
1056,Pascal Groß,de GER,"MF,DF",Dortmund,de Bundesliga,33.88493151,1991,25,44,28,11,26,7,15,49,30.6,34,43,12,31,9,53,27,1
1057,Brajan Gruda,de GER,"FW,MF",Brighton,eng Premier League,20.9260274,2004,5.6,14,6,6,5,3,7,14,50,7,8,0,8,2,16,5,1
1058,Marco Grüll,at AUT,"FW,MF",Werder Bremen,de Bundesliga,26.82739726,1998,12.2,10,7,1,3,6,3,16,18.8,13,14,2,12,3,13,9,0
1059,Albert Grønbaek,dk DEN,"FW,MF",Southampton,eng Premier League,23.94794521,2001,1.6,4,1,1,1,2,3,10,30,7,1,1,0,0,4,1,0
1060,Albert Grønbaek,dk DEN,"MF,FW",Rennes,fr Ligue 1,23.94794521,2001,9,21,11,10,7,4,10,28,35.7,18,9,1,8,4,25,6,0
1061,Vicente Guaita,es ESP,GK,Celta Vigo,es La Liga,38.31232877,1987,29,0,0,0,0,0,0,0,,0,0,0,0,0,0,20,1
1062,Sergi Guardiola,es ESP,FW,Rayo Vallecano,es La Liga,33.93150685,1991,4,5,3,0,5,0,2,3,66.7,1,1,0,1,1,6,2,0
1063,Nemanja Gudelj,rs SRB,"MF,DF",Sevilla,es La Liga,33.4630137,1991,24,37,20,12,21,4,18,29,62.1,11,26,10,16,25,62,81,0
1064,Gabriel Gudmundsson,se SWE,DF,Lille,fr Ligue 1,26.01369863,1999,18.5,34,23,13,15,6,21,34,61.8,13,15,5,10,15,49,38,3
1065,Gonçalo Guedes,pt POR,"MF,FW",Wolves,eng Premier League,28.42739726,1996,8.7,14,4,2,5,7,3,15,20,12,9,0,9,5,19,3,0
1066,Axel Gueguin,fr FRA,FW,Montpellier,fr Ligue 1,20.11232877,2005,0.3,1,1,0,1,0,1,1,100,0,0,0,0,0,1,0,0
1067,Marc Guéhi,eng ENG,DF,Crystal Palace,eng Premier League,24.80821918,2000,32,56,31,32,22,2,30,45,66.7,15,53,22,31,25,81,148,2
1068,Mattéo Guendouzi,fr FRA,MF,Lazio,it Serie A,26.05479452,1999,32.3,32,17,10,17,5,17,41,41.5,24,31,9,22,29,61,45,2
1069,Javier Guerra,es ESP,MF,Valencia,es La Liga,22.3369863,2003,25.9,45,23,16,18,11,22,47,46.8,25,12,1,11,19,64,40,2
1070,Raphaël Guerreiro,pt POR,"DF,MF",Bayern Munich,de Bundesliga,31.36438356,1993,15.8,18,11,9,6,3,12,16,75,4,8,0,8,9,27,15,1
1071,Evann Guessand,ci CIV,"FW,MF",Nice,fr Ligue 1,23.84109589,2001,27,41,27,12,15,14,6,13,46.2,7,25,3,22,15,56,15,0
1072,Ander Guevara,es ESP,MF,Alavés,es La Liga,27.82465753,1997,18.6,43,26,18,24,1,18,42,42.9,24,19,5,14,11,54,40,1
1073,Pape Gueye,sn SEN,MF,Villarreal,es La Liga,26.2739726,1999,22,52,25,21,23,8,19,26,73.1,7,28,10,18,24,76,48,1
1074,Morgan Guilavogui,gn GUI,"FW,MF",St. Pauli,de Bundesliga,27.15068493,1998,18.3,32,17,11,16,5,14,29,48.3,15,27,0,27,13,45,30,0
1075,Frederic Guilbert,fr FRA,DF,Lecce,it Serie A,30.35890411,1994,24.6,64,35,29,29,6,35,54,64.8,19,25,8,17,43,107,101,3
1076,Luis Guilherme,br BRA,"MF,FW",West Ham,eng Premier League,19.23013699,2006,1.5,1,0,1,0,0,0,3,0,3,7,0,7,3,4,2,0
1077,Hugo Guillamón,es ESP,MF,Valencia,es La Liga,25.25479452,2000,4,11,8,1,9,1,9,10,90,1,4,1,3,5,16,9,1
1078,Bruno Guimarães,br BRA,MF,Newcastle Utd,eng Premier League,27.4630137,1997,32.4,71,41,34,26,11,29,61,47.5,32,33,9,24,27,98,41,4
1079,Carlos Guirao,es ESP,MF,Betis,es La Liga,22.01917808,2003,1.2,5,3,1,4,0,4,6,66.7,2,1,1,0,3,8,2,0
1080,Bahereba Guirassy,fr FRA,"FW,MF",Nantes,fr Ligue 1,18.67945205,2006,3.8,12,8,6,3,3,7,13,53.8,6,10,0,10,1,13,4,0
1081,Serhou Guirassy,gn GUI,FW,Dortmund,de Bundesliga,29.14520548,1996,26.9,6,5,2,1,3,2,5,40,3,8,3,5,4,10,33,0
1082,Marc Guiu,es ESP,FW,Chelsea,eng Premier League,19.32876712,2006,0.8,1,1,0,1,0,1,1,100,0,0,0,0,0,1,0,0
1083,Péter Gulácsi,hu HUN,GK,RB Leipzig,de Bundesliga,34.99452055,1990,27.2,0,0,0,0,0,0,1,0,1,0,0,0,0,0,12,4
1084,Arda Güler,tr TUR,"MF,FW",Real Madrid,es La Liga,20.18630137,2005,9.6,21,10,8,5,8,7,16,43.8,9,14,0,14,5,26,8,0
1085,Gerard Gumbau,es ESP,MF,Rayo Vallecano,es La Liga,30.37534247,1994,8.6,16,12,8,6,2,7,15,46.7,8,10,4,6,5,21,11,0
1086,Robert Gumny,pl POL,DF,Augsburg,de Bundesliga,26.91506849,1998,2,2,2,1,1,0,1,3,33.3,2,2,0,2,1,3,5,0
1087,İlkay Gündoğan,de GER,MF,Manchester City,eng Premier League,34.5260274,1990,22.8,24,13,4,15,5,10,23,43.5,13,14,0,14,13,37,22,0
1088,Christian Günter,de GER,DF,Freiburg,de Bundesliga,32.17808219,1993,25.4,23,21,12,8,3,16,29,55.2,13,24,10,14,8,31,46,1
1089,Jon Guridi,es ESP,"MF,FW",Alavés,es La Liga,30.17808219,1995,20,33,17,6,21,6,15,39,38.5,24,19,1,18,12,45,11,0
1090,Gorka Guruzeta,es ESP,FW,Athletic Club,es La Liga,28.64109589,1996,17.5,15,8,1,12,2,7,28,25,21,27,4,23,7,22,17,0
1091,Malo Gusto,fr FRA,DF,Chelsea,eng Premier League,21.95890411,2003,20.2,43,28,26,15,2,24,47,51.1,23,29,8,21,23,66,46,5
1092,Miguel Gutiérrez,es ESP,"DF,MF",Girona,es La Liga,23.76986301,2001,27.3,37,24,18,16,3,17,37,45.9,20,17,7,10,16,53,34,3
1093,Albert Guðmundsson,is ISL,"FW,MF",Fiorentina,it Serie A,27.88493151,1997,13.6,9,5,2,4,3,7,17,41.2,10,5,0,5,6,15,9,1
1094,Joško Gvardiol,hr CRO,DF,Manchester City,eng Premier League,23.27671233,2002,33.4,51,34,24,17,10,19,37,51.4,18,40,20,20,38,89,117,8
1095,Emmanuel Gyasi,gh GHA,"DF,FW",Empoli,it Serie A,31.30958904,1994,31.9,51,28,31,14,6,24,35,68.6,11,23,8,15,8,59,75,0
1096,Christian Gytkjær,dk DEN,FW,Venezia,it Serie A,34.99452055,1990,7.5,6,4,2,2,2,1,2,50,1,2,1,1,0,6,8,0
1097,Erling Haaland,no NOR,FW,Manchester City,eng Premier League,24.78630137,2000,27.6,9,5,3,3,3,2,6,33.3,4,11,1,10,5,14,23,0
1098,Nicolas Haas,ch SUI,MF,Empoli,it Serie A,29.27671233,1996,3.2,11,8,4,5,2,5,9,55.6,4,2,1,1,4,15,6,0
1099,Janik Haberer,de GER,"MF,DF",Union Berlin,de Bundesliga,31.08767123,1994,16.8,29,23,13,14,2,19,36,52.8,17,14,0,14,15,44,34,0
1100,Robin Hack,de GER,FW,Gladbach,de Bundesliga,26.68493151,1998,22.6,19,15,8,8,3,11,27,40.7,16,30,2,28,9,28,27,0
1101,Saad El Haddad,ma MAR,MF,Venezia,it Serie A,19.77808219,2005,0.3,0,0,0,0,0,0,0,,0,0,0,0,0,0,0,0
1102,Munir El Haddadi,ma MAR,"MF,FW",Leganés,es La Liga,29.67123288,1995,6.4,11,8,5,4,2,3,9,33.3,6,6,1,5,0,11,1,1
1103,Amadou Haidara,ml MLI,MF,RB Leipzig,de Bundesliga,27.25479452,1998,14.7,30,17,12,16,2,12,29,41.4,17,42,12,30,18,48,56,1
1104,Massadio Haïdara,ml MLI,DF,Brest,fr Ligue 1,32.41917808,1992,16.7,20,12,13,7,0,10,24,41.7,14,11,1,10,21,41,69,0
1105,Antoine Hainaut,fr FRA,"DF,MF",Parma,it Serie A,23.20547945,2002,11.6,25,14,14,8,3,9,13,69.2,4,13,3,10,12,37,52,0
1106,Mohamed Haj,tn TUN,MF,Parma,it Serie A,20.10684932,2005,5,3,1,2,1,0,1,2,50,1,3,1,2,4,7,5,0
1107,Achraf Hakimi,ma MAR,DF,Paris S-G,fr Ligue 1,26.49589041,1998,22,47,35,18,19,10,27,55,49.1,28,25,2,23,29,76,18,3
1108,Lewis Hall,eng ENG,DF,Newcastle Utd,eng Premier League,20.65205479,2004,24.3,58,41,28,22,8,40,74,54.1,34,33,18,15,18,76,75,3
1109,Sébastien Haller,ci CIV,FW,Leganés,es La Liga,30.86575342,1994,4.5,2,0,1,0,1,1,2,50,1,1,0,1,0,2,7,0
1110,Ali Al Hamadi,iq IRQ,FW,Ipswich Town,eng Premier League,23.17534247,2002,1.5,1,0,0,0,1,0,2,0,2,0,0,0,0,1,2,0
1111,Andreas Hanche-Olsen,no NOR,DF,Mainz 05,de Bundesliga,28.29315068,1997,11.3,17,9,9,7,1,7,10,70,3,21,16,5,7,24,68,2
1112,Florent Hanin,dz ALG,DF,Angers,fr Ligue 1,35.24383562,1990,26.8,57,42,36,14,7,30,58,51.7,28,28,10,18,44,101,90,2
1113,Ridgeciano Haps,sr SUR,DF,Venezia,it Serie A,31.89315068,1993,14.2,26,15,18,6,2,11,18,61.1,7,16,3,13,6,32,45,0
1114,Amine Harit,ma MAR,MF,Marseille,fr Ligue 1,27.87671233,1997,5.5,8,7,0,6,2,1,2,50,1,6,0,6,3,11,1,1
1115,Marcus Harness,eng ENG,MF,Ipswich Town,eng Premier League,29.1890411,1996,0.5,1,0,0,0,1,0,3,0,3,2,1,1,0,1,1,0
1116,Phil Harres,de GER,FW,Holstein Kiel,de Bundesliga,23.10958904,2002,16.1,10,10,3,4,3,4,7,57.1,3,15,3,12,5,15,17,0
1117,Jack Harrison,eng ENG,FW,Everton,eng Premier League,28.45205479,1996,21.1,30,21,12,11,7,14,40,35,26,18,2,16,9,39,32,2
1118,Abdou Harroui,nl NED,"MF,FW",Hellas Verona,it Serie A,27.30410959,1998,5.1,9,6,6,3,0,4,4,100,0,5,0,5,2,11,5,0
1119,Taylor Harwood-Bellis,eng ENG,DF,Southampton,eng Premier League,23.25753425,2002,29.5,27,19,13,11,3,19,34,55.9,15,60,38,22,30,57,133,6
1120,Hans Hateboer,nl NED,DF,Rennes,fr Ligue 1,31.31506849,1994,18.7,31,16,14,12,5,18,36,50,18,19,6,13,29,60,64,2
1121,Kjetil Haug,no NOR,GK,Toulouse,fr Ligue 1,26.89315068,1998,5.5,0,0,0,0,0,0,0,,0,0,0,0,0,0,3,0
1122,Kai Havertz,de GER,"FW,MF",Arsenal,eng Premier League,25.89589041,1999,20.4,16,9,3,6,7,4,15,26.7,11,22,4,18,6,22,31,1
1123,Ayden Heaven,eng ENG,DF,Manchester Utd,eng Premier League,18.61369863,2006,1.1,3,3,1,2,0,2,2,100,0,2,2,0,1,4,6,0
1124,Jan Paul van Hecke,nl NED,DF,Brighton,eng Premier League,24.90410959,2000,28.9,39,25,20,18,1,20,37,54.1,17,32,19,13,23,62,128,2
1125,Hwang Hee-chan,kr KOR,"MF,FW",Wolves,eng Premier League,29.26849315,1996,7.2,6,4,2,1,3,2,6,33.3,4,9,0,9,2,8,11,0
1126,Dean Henderson,eng ENG,GK,Crystal Palace,eng Premier League,28.14520548,1997,34,2,1,2,0,0,2,6,33.3,4,0,0,0,0,2,21,0
1127,Liam Henderson,sct SCO,MF,Empoli,it Serie A,29.02465753,1996,23.9,40,20,16,21,3,21,50,42,29,18,5,13,15,55,40,0
1128,Ramon Hendriks,nl NED,DF,Stuttgart,de Bundesliga,23.79452055,2001,11.8,18,7,10,7,1,9,13,69.2,4,15,7,8,17,35,59,0
1129,Paul Hennrich,de GER,MF,Hoffenheim,de Bundesliga,20.16164384,2005,0.1,0,0,0,0,0,0,0,,0,1,1,0,0,0,0,0
1130,Benjamin Henrichs,de GER,DF,RB Leipzig,de Bundesliga,28.19178082,1997,10.4,32,16,18,10,4,14,27,51.9,13,22,3,19,15,47,33,0
1131,Henrique,br BRA,DF,Valladolid,es La Liga,31.02465753,1994,2.2,3,2,2,1,0,0,3,0,3,5,0,5,2,5,5,0
1132,Luis Henrique,br BRA,"DF,FW",Marseille,fr Ligue 1,23.38630137,2001,27.7,16,9,7,6,3,9,10,90,1,14,2,12,8,24,30,0
1133,Rico Henry,eng ENG,DF,Brentford,eng Premier League,27.82191781,1997,0.7,0,0,0,0,0,0,3,0,3,2,1,1,1,1,0,0
1134,Mads Hermansen,dk DEN,GK,Leicester City,eng Premier League,24.81369863,2000,26.5,1,1,1,0,0,1,1,100,0,1,0,1,0,1,13,4
1135,Mario Hermoso,es ESP,DF,Roma,it Serie A,29.87671233,1995,2.8,2,1,2,0,0,0,1,0,1,1,1,0,4,6,13,0
1136,Mario Hermoso,es ESP,DF,Leverkusen,de Bundesliga,29.87671233,1995,3.3,0,0,0,0,0,0,0,,0,3,1,2,9,9,15,1
1137,Javi Hernández,es ESP,DF,Leganés,es La Liga,27.00547945,1998,22.5,25,15,16,6,3,16,40,40,24,21,3,18,22,47,83,0
1138,Aridane Hernández,es ESP,DF,Rayo Vallecano,es La Liga,36.11506849,1989,8.4,9,7,5,4,0,2,4,50,2,7,5,2,3,12,69,2
1139,Lucas Hernández,fr FRA,DF,Paris S-G,fr Ligue 1,29.21643836,1996,8.7,21,16,11,8,2,13,19,68.4,6,11,5,6,5,26,34,2
1140,Theo Hernández,fr FRA,DF,Milan,it Serie A,27.57534247,1997,28,31,24,22,6,3,19,36,52.8,17,25,10,15,15,46,71,3
1141,Hernani,br BRA,MF,Parma,it Serie A,31.10410959,1994,13.1,40,22,22,14,4,22,42,52.4,20,24,5,19,18,58,11,1
1142,Jorge Herrando,es ESP,DF,Osasuna,es La Liga,24.17808219,2001,15.2,17,11,9,5,3,9,15,60,6,20,14,6,12,29,65,2
1143,Ander Herrera,es ESP,MF,Athletic Club,es La Liga,35.72054795,1989,3,8,4,1,7,0,3,6,50,3,1,0,1,2,10,10,0
1144,Sergio Herrera,es ESP,GK,Osasuna,es La Liga,31.91232877,1993,33,2,1,2,0,0,2,5,40,3,1,0,1,0,2,27,1
1145,Yangel Herrera,ve VEN,MF,Girona,es La Liga,27.30136986,1998,21.3,54,34,25,24,5,25,50,50,25,18,3,15,27,81,41,1
1146,Juan Herzog,es ESP,DF,Las Palmas,es La Liga,21.97534247,2003,10.7,11,11,11,0,0,9,14,64.3,5,13,8,5,14,25,54,0
1147,Son Heung-min,kr KOR,FW,Tottenham,eng Premier League,32.82191781,1992,22.3,17,9,3,8,6,5,23,21.7,18,10,0,10,5,22,16,1
1148,Isak Hien,se SWE,DF,Atalanta,it Serie A,26.30410959,1999,23.9,48,28,27,21,0,27,42,64.3,15,28,17,11,27,75,74,2
1149,Omar El Hilali,ma MAR,DF,Espanyol,es La Liga,21.64109589,2003,31.4,106,76,77,24,5,60,90,66.7,30,47,12,35,43,149,139,2
1150,James Hill,eng ENG,DF,Bournemouth,eng Premier League,23.31232877,2002,5,15,8,6,6,3,3,11,27.3,8,5,0,5,9,24,31,0
1151,Piero Hincapié,ec ECU,DF,Leverkusen,de Bundesliga,23.31506849,2002,26.8,44,35,24,13,7,21,35,60,14,33,16,17,29,73,101,1
1152,Roger Hinojo,es ESP,DF,Espanyol,es La Liga,20.19726027,2005,0.1,0,0,0,0,0,0,0,,0,0,0,0,0,0,1,0
1153,Jack Hinshelwood,eng ENG,"DF,MF",Brighton,eng Premier League,20.0630137,2005,18.6,26,18,8,10,8,11,26,42.3,15,8,3,5,14,40,36,1
1154,George Hirst,sct SCO,FW,Ipswich Town,eng Premier League,26.21369863,1999,5.5,3,3,1,0,2,1,3,33.3,2,1,1,0,2,5,9,0
1155,Adam Hložek,cz CZE,"FW,MF",Hoffenheim,de Bundesliga,22.77534247,2002,18.8,20,9,7,7,6,11,20,55,9,13,1,12,4,24,20,0
1156,Ki-Jana Hoever,nl NED,DF,Auxerre,fr Ligue 1,23.29041096,2002,22.5,48,35,25,15,8,28,52,53.8,24,33,3,30,20,68,68,1
1157,Nicolas Höfler,de GER,MF,Freiburg,de Bundesliga,35.15342466,1990,8.8,33,23,13,18,2,20,31,64.5,11,7,1,6,14,47,28,1
1158,Jonas Hofmann,de GER,"MF,DF",Leverkusen,de Bundesliga,32.80547945,1992,3.1,2,0,0,2,0,1,3,33.3,2,2,0,2,0,2,2,0
1159,Philipp Hofmann,de GER,FW,Bochum,de Bundesliga,32.09589041,1993,25.3,17,12,4,6,7,8,15,53.3,7,14,1,13,4,21,33,0
1160,Lucas Höler,de GER,"FW,MF",Freiburg,de Bundesliga,30.81643836,1994,19.2,34,21,17,14,3,8,22,36.4,14,29,7,22,7,41,27,0
1161,Mason Holgate,eng ENG,"FW,DF",Everton,eng Premier League,28.53150685,1996,0.1,0,0,0,0,0,0,0,,0,0,0,0,0,0,0,0
1162,Benedict Hollerbach,de GER,"FW,MF",Union Berlin,de Bundesliga,23.96438356,2001,26.3,40,20,8,21,11,20,48,41.7,28,30,0,30,2,42,12,1
1163,Emil Holm,se SWE,DF,Bologna,it Serie A,24.97534247,2000,12,34,21,17,14,3,20,30,66.7,10,19,4,15,10,44,50,1
1164,Lewis Holtby,de GER,MF,Holstein Kiel,de Bundesliga,34.62465753,1990,13.1,32,20,17,10,5,10,26,38.5,16,14,2,12,21,53,26,3
1165,Gerrit Holtmann,ph PHI,"DF,FW",Bochum,de Bundesliga,30.10958904,1995,12.1,24,19,14,8,2,12,23,52.2,11,16,4,12,16,40,15,0
1166,Franck Honorat,fr FRA,FW,Gladbach,de Bundesliga,28.72876712,1996,14.2,15,6,8,4,3,1,6,16.7,5,9,1,8,4,19,27,1
1167,Mathias Honsak,at AUT,"FW,MF",Heidenheim,de Bundesliga,28.36986301,1996,12.1,15,8,10,5,0,10,22,45.5,12,17,4,13,9,24,28,0
1168,Dinko Horkaš,hr CRO,GK,Las Palmas,es La Liga,26.15068493,1999,8.1,0,0,0,0,0,0,0,,0,0,0,0,0,0,6,1
1169,Timo Horn,de GER,GK,Bochum,de Bundesliga,31.97808219,1993,11,0,0,0,0,0,0,0,,0,0,0,0,0,0,8,1
1170,Cédric Hountondji,bj BEN,DF,Angers,fr Ligue 1,31.28767123,1994,3,6,4,4,2,0,3,7,42.9,4,3,3,0,4,10,14,0
1171,Ilyes Housni,fr FRA,"FW,MF",Le Havre,fr Ligue 1,19.97260274,2005,2.6,7,5,2,3,2,2,4,50,2,2,0,2,1,8,2,0
1172,Lukáš Hrádecký,fi FIN,GK,Leverkusen,de Bundesliga,35.44109589,1989,27,0,0,0,0,0,0,1,0,1,0,0,0,0,0,7,2
1173,Robin Hranáč,cz CZE,DF,Hoffenheim,de Bundesliga,25.26027397,2000,2.4,0,0,0,0,0,0,1,0,1,3,2,1,5,5,9,1
1174,Callum Hudson-Odoi,eng ENG,"FW,MF",Nott'ham Forest,eng Premier League,24.48767123,2000,23.9,20,14,7,8,5,11,17,64.7,6,11,0,11,13,33,11,1
1175,Will Hughes,eng ENG,MF,Crystal Palace,eng Premier League,30.04657534,1995,20.8,61,33,17,31,13,27,59,45.8,32,29,14,15,19,80,23,3
1176,Dean Huijsen,es ESP,DF,Bournemouth,eng Premier League,20.05479452,2005,24.8,33,23,16,16,1,15,25,60,10,36,28,8,49,82,175,4
1177,Mats Hummels,de GER,DF,Roma,it Serie A,36.38082192,1988,10.2,30,15,16,14,0,11,18,61.1,7,12,4,8,26,56,43,0
1178,Omari Hutchinson,eng ENG,"MF,FW",Ipswich Town,eng Premier League,21.50958904,2003,25.7,31,12,14,10,7,13,45,28.9,32,25,1,24,10,41,13,1
1179,Elseid Hysaj,al ALB,DF,Lazio,it Serie A,31.2,1994,3.1,7,5,4,3,0,3,3,100,0,2,2,0,4,11,14,0
1180,Hong Hyunseok,kr KOR,MF,Mainz 05,de Bundesliga,25.88219178,1999,5.4,7,3,3,2,2,1,4,25,3,6,1,5,7,14,8,0
1181,Pierre Højbjerg,dk DEN,MF,Marseille,fr Ligue 1,29.74520548,1995,26.6,54,36,23,25,6,31,63,49.2,32,28,4,24,41,95,31,1
1182,Oscar Højlund,dk DEN,MF,Eint Frankfurt,de Bundesliga,20.32876712,2005,7.8,21,12,8,9,4,8,16,50,8,15,7,8,5,26,8,1
1183,Rasmus Højlund,dk DEN,FW,Manchester Utd,eng Premier League,22.24383562,2003,19.4,3,1,0,2,1,0,4,0,4,5,0,5,1,4,6,0
1184,Pablo Ibáñez,es ESP,MF,Osasuna,es La Liga,26.61917808,1998,11.4,18,9,6,11,1,9,37,24.3,28,18,6,12,14,32,19,0
1185,Hafiz Ibrahim,ng NGA,FW,Reims,fr Ligue 1,19.36986301,2005,3.9,1,1,0,1,0,0,5,0,5,4,2,2,2,3,6,0
1186,Arijon Ibrahimović,de GER,MF,Lazio,it Serie A,19.39452055,2005,0.1,0,0,0,0,0,0,0,,0,0,0,0,0,0,0,0
1187,Arijon Ibrahimović,de GER,FW,Bayern Munich,de Bundesliga,19.39452055,2005,0,0,0,0,0,0,0,0,,0,0,0,0,0,0,0,0
1188,Stanis Idumbo,be BEL,"FW,MF",Sevilla,es La Liga,19.84657534,2005,3.2,9,5,3,4,2,3,5,60,2,3,1,2,4,13,2,0
1189,Jay Idzes,id IDN,DF,Venezia,it Serie A,24.92054795,2000,32.7,45,29,24,17,4,17,32,53.1,15,49,29,20,30,75,153,0
1190,Iglesias,es ESP,DF,Getafe,es La Liga,26.83561644,1998,28.3,75,46,39,30,6,43,82,52.4,39,43,7,36,41,116,123,1
1191,Borja Iglesias,es ESP,FW,Celta Vigo,es La Liga,32.29315068,1993,19.2,8,7,1,4,3,2,11,18.2,9,8,2,6,6,14,6,0
1192,Igor,br BRA,DF,Brighton,eng Premier League,27.23561644,1998,10,4,4,2,1,1,4,10,40,6,23,14,9,4,8,39,1
1193,Kelechi Iheanacho,ng NGA,FW,Sevilla,es La Liga,28.58356164,1996,4.4,1,0,0,1,0,1,3,33.3,2,0,0,0,0,1,1,0
1194,Jonathan Ikone,fr FRA,FW,Como,it Serie A,27.00547945,1998,5.6,15,9,4,3,8,6,11,54.5,5,5,1,4,0,15,1,1
1195,Jonathan Ikone,fr FRA,"FW,MF",Fiorentina,it Serie A,27.00547945,1998,3.7,5,2,3,2,0,2,4,50,2,3,0,3,1,6,1,0
1196,George Ilenikhena,fr FRA,"FW,MF",Monaco,fr Ligue 1,18.71506849,2006,7.2,1,1,0,1,0,0,1,0,1,0,0,0,2,3,0,0
1197,Andrej Ilic,rs SRB,FW,Union Berlin,de Bundesliga,25.08493151,2000,9.6,2,2,0,2,0,0,5,0,5,7,3,4,4,6,5,1
1198,Ivan Ilić,rs SRB,MF,Torino,it Serie A,24.13150685,2001,9.9,5,2,0,4,1,2,6,33.3,4,0,0,0,5,10,9,0
1199,Rareş Ilie,ro ROU,MF,Nice,fr Ligue 1,22.04109589,2003,0.1,1,1,1,0,0,1,1,100,0,0,0,0,0,1,0,0
1200,Samuel Iling-Junior,eng ENG,"FW,MF",Bologna,it Serie A,21.58082192,2003,1.3,3,2,1,1,1,0,1,0,1,1,0,1,2,5,2,0
1201,Danny Ings,eng ENG,"FW,MF",West Ham,eng Premier League,32.78082192,1992,3.2,4,2,2,2,0,1,3,33.3,2,5,0,5,1,5,4,0
1202,Alessio Iovine,it ITA,"DF,FW",Como,it Serie A,34.25205479,1991,4.2,5,2,2,3,0,4,10,40,6,7,1,6,3,8,21,1
1203,Tim Iroegbunam,eng ENG,MF,Everton,eng Premier League,21.84383562,2003,6.3,28,13,13,10,5,14,23,60.9,9,17,4,13,15,43,11,1
1204,Jackson Irvine,au AUS,MF,St. Pauli,de Bundesliga,32.15890411,1993,29,56,28,24,26,6,25,45,55.6,20,27,5,22,36,92,63,2
1205,Andy Irving,sct SCO,MF,West Ham,eng Premier League,24.97534247,2000,1.8,7,4,3,3,1,1,5,20,4,5,1,4,1,8,5,0
1206,Alexander Isak,se SWE,FW,Newcastle Utd,eng Premier League,25.61643836,1999,27.6,12,5,2,3,7,5,12,41.7,7,18,2,16,3,15,17,1
1207,Gustav Isaksen,dk DEN,FW,Lazio,it Serie A,24.04109589,2001,22.4,14,8,6,7,1,5,26,19.2,21,19,2,17,8,22,15,1
1208,Isco,es ESP,MF,Betis,es La Liga,33.03561644,1992,14.3,16,9,1,11,4,7,26,26.9,19,9,0,9,8,24,6,0
1209,Ismaily,br BRA,DF,Lille,fr Ligue 1,35.30958904,1990,8.4,30,16,16,11,3,14,22,63.6,8,12,1,11,10,40,38,0
1210,Ardian Ismajli,al ALB,DF,Empoli,it Serie A,28.59178082,1996,23.9,24,19,17,7,0,12,15,80,3,30,22,8,47,71,213,3
1211,Yanis Issoufou,fr FRA,"MF,FW",Montpellier,fr Ligue 1,18.51506849,2006,0.9,6,4,4,1,1,3,5,60,2,1,0,1,0,6,1,0
1212,Ko Itakura,jp JPN,DF,Gladbach,de Bundesliga,28.26575342,1997,30,40,29,23,16,1,21,34,61.8,13,40,21,19,25,65,169,0
1213,Hiroki Ito,jp JPN,DF,Bayern Munich,de Bundesliga,25.97808219,1999,2.8,2,0,1,1,0,1,1,100,0,3,2,1,6,8,15,1
1214,Junya Ito,jp JPN,"FW,MF",Reims,fr Ligue 1,32.15342466,1993,28.6,43,28,17,16,10,16,59,27.1,43,32,3,29,13,56,15,1
1215,Diego Iturralde,es ESP,FW,Sevilla,es La Liga,22.04931507,2003,0.4,0,0,0,0,0,0,0,,0,0,0,0,1,1,1,0
1216,Marko Ivezić,rs SRB,DF,Holstein Kiel,de Bundesliga,23.41917808,2001,18.4,29,19,20,6,3,15,42,35.7,27,25,13,12,27,56,102,2
1217,Alex Iwobi,ng NGA,"FW,MF",Fulham,eng Premier League,29.00273973,1996,31.1,39,23,13,19,7,19,30,63.3,11,25,1,24,13,52,28,0
1218,Armando Izzo,it ITA,DF,Monza,it Serie A,33.17260274,1992,26.9,40,15,30,9,1,18,36,50,18,38,28,10,45,85,100,0
1219,Fellipe Jack,br BRA,DF,Como,it Serie A,19.30684932,2006,1.9,9,4,8,1,0,3,5,60,2,2,2,0,4,13,5,0
1220,Nicolas Jackson,sn SEN,FW,Chelsea,eng Premier League,23.87123288,2001,23.5,19,11,4,6,9,3,8,37.5,5,13,2,11,3,22,15,0
1221,Jérémy Jacquet,fr FRA,DF,Rennes,fr Ligue 1,19.80821918,2005,8.6,22,15,9,6,7,11,18,61.1,7,8,3,5,21,43,43,1
1222,Lee Jae-sung,kr KOR,MF,Mainz 05,de Bundesliga,32.73150685,1992,26.9,38,21,14,18,6,12,34,35.3,22,32,3,29,34,72,36,0
1223,Ivan Jaime Pajuelo,es ESP,MF,Valencia,es La Liga,24.60273973,2000,2.1,4,2,1,1,2,2,3,66.7,1,1,0,1,2,6,0,0
1224,Kristijan Jakić,hr CRO,MF,Augsburg,de Bundesliga,27.97260274,1997,22.6,41,19,19,17,5,20,38,52.6,18,39,7,32,28,69,47,1
1225,Karl Jakob Hein,ee EST,GK,Valladolid,es La Liga,23.05753425,2002,28,0,0,0,0,0,0,2,0,2,0,0,0,0,0,17,1
1226,Ismail Jakobs,sn SEN,DF,Monaco,fr Ligue 1,25.71232877,1999,2,5,5,3,0,2,3,5,60,2,0,0,0,2,7,6,0
1227,Jordan James,wls WAL,MF,Rennes,fr Ligue 1,20.83835616,2004,12.7,28,18,7,17,4,16,29,55.2,13,13,1,12,13,41,16,1
1228,Reece James,eng ENG,"DF,MF",Chelsea,eng Premier League,25.40273973,1999,9.3,9,9,5,3,1,3,9,33.3,6,12,4,8,12,21,18,4
1229,Vitaly Janelt,de GER,MF,Brentford,eng Premier League,26.98356164,1998,25,38,22,14,13,11,21,36,58.3,15,33,9,24,27,65,53,1
1230,Adnan Januzaj,be BEL,"MF,FW",Las Palmas,es La Liga,30.24109589,1995,4.5,9,5,1,5,3,5,7,71.4,2,5,0,5,0,9,2,0
1231,Luca Jaquez,ch SUI,DF,Stuttgart,de Bundesliga,21.92054795,2003,1.3,3,0,3,0,0,1,2,50,1,1,0,1,1,4,2,0
1232,Vitezslav Jaros,cz CZE,GK,Liverpool,eng Premier League,23.78082192,2001,0.1,0,0,0,0,0,0,0,,0,0,0,0,0,0,0,0
1233,Ali Jasim,iq IRQ,"FW,DF",Como,it Serie A,21.28493151,2004,0.1,1,0,1,0,0,1,1,100,0,0,0,0,0,1,0,0
1234,Mikel Jauregizar,es ESP,MF,Athletic Club,es La Liga,21.4739726,2003,21.5,74,43,22,40,12,37,72,51.4,35,21,3,18,26,100,26,2
1235,Dominik Javorček,sk SVK,"DF,MF",Holstein Kiel,de Bundesliga,22.50136986,2002,4.3,3,0,3,0,0,1,5,20,4,7,3,4,5,8,26,1
1236,Gaby Jean,fr FRA,DF,Lecce,it Serie A,25.20273973,2000,15.4,14,7,8,5,1,6,11,54.5,5,13,10,3,9,23,71,1
1237,Daniel Jebbison,eng ENG,FW,Bournemouth,eng Premier League,21.72328767,2003,0.9,3,2,2,1,0,3,5,60,2,2,1,1,1,4,1,0
1238,Finn Jeltsch,de GER,DF,Stuttgart,de Bundesliga,18.79726027,2006,8.2,18,13,6,11,1,12,15,80,3,12,6,6,11,29,27,2
1239,Malcolm Jeng,se SWE,DF,Reims,fr Ligue 1,20.15342466,2005,1.2,0,0,0,0,0,0,0,,0,1,0,1,3,3,10,0
1240,Fredrik Jensen,fi FIN,MF,Augsburg,de Bundesliga,27.64931507,1997,8.3,6,6,1,3,2,3,4,75,1,8,1,7,4,10,16,0
1241,Mathias Jensen,dk DEN,MF,Brentford,eng Premier League,29.3369863,1996,8.8,13,9,6,5,2,7,15,46.7,8,13,4,9,8,21,12,1
1242,Moritz Jenz,de GER,DF,Mainz 05,de Bundesliga,26.0109589,1999,17.8,36,20,18,18,0,16,21,76.2,5,23,14,9,30,66,128,2
1243,Gabriel Jesus,br BRA,FW,Arsenal,eng Premier League,28.08493151,1997,6.8,10,6,4,3,3,4,9,44.4,5,10,1,9,4,14,8,0
1244,Juan Jesus,br BRA,DF,Napoli,it Serie A,33.89863014,1991,11.9,25,14,16,9,0,12,20,60,8,15,3,12,9,34,42,0
1245,Alejandro Jiménez,es ESP,"DF,FW",Milan,it Serie A,19.9890411,2005,11.5,22,13,8,13,1,10,22,45.5,12,19,3,16,12,34,19,0
1246,Raúl Jiménez,mx MEX,FW,Fulham,eng Premier League,33.99726027,1991,24.7,33,23,8,17,8,7,20,35,13,19,5,14,10,43,19,3
1247,Kim Jisoo,kr KOR,DF,Brentford,eng Premier League,20.35890411,2004,0.3,0,0,0,0,0,0,0,,0,0,0,0,0,0,2,0
1248,João Pedro,br BRA,"FW,MF",Brighton,eng Premier League,23.60273973,2001,21.6,16,12,6,6,4,4,11,36.4,7,12,0,12,9,25,12,0
1249,John Joe,ie IRL,"MF,FW",Getafe,es La Liga,21.5260274,2003,0.5,0,0,0,0,0,0,0,,0,1,1,0,0,0,1,0
1250,John Joe,ie IRL,MF,Reims,fr Ligue 1,21.5260274,2003,5.5,19,12,10,7,2,4,16,25,12,9,2,7,6,25,9,0
1251,Joelinton,br BRA,"MF,FW",Newcastle Utd,eng Premier League,28.72054795,1996,26.6,57,35,23,23,11,25,44,56.8,19,37,7,30,23,80,47,2
1252,Jofre,es ESP,"MF,FW",Espanyol,es La Liga,23.87945205,2001,22.1,21,15,13,5,3,12,21,57.1,9,13,0,13,15,36,28,0
1253,Þórir Jóhann Helgason,is ISL,MF,Lecce,it Serie A,24.59726027,2000,11,10,7,3,6,1,7,11,63.6,4,7,2,5,5,15,10,2
1254,Carl Johansson,se SWE,DF,Holstein Kiel,de Bundesliga,30.94794521,1994,4.4,4,2,4,0,0,3,6,50,3,8,7,1,8,12,29,1
1255,Ben Johnson,eng ENG,"DF,FW",Ipswich Town,eng Premier League,25.2739726,2000,15,38,22,23,12,3,20,41,48.8,21,22,5,17,13,51,54,1
1256,Brennan Johnson,wls WAL,FW,Tottenham,eng Premier League,23.94794521,2001,23.1,39,26,9,20,10,16,31,51.6,15,25,3,22,4,43,11,0
1257,Karl-Johan Johnsson,se SWE,GK,Strasbourg,fr Ligue 1,35.2630137,1990,3,0,0,0,0,0,0,1,0,1,0,0,0,0,0,3,0
1258,Sam Johnstone,eng ENG,GK,Wolves,eng Premier League,32.10958904,1993,7,0,0,0,0,0,0,1,0,1,0,0,0,0,0,7,0
1259,Paul Joly,fr FRA,DF,Auxerre,fr Ligue 1,24.90684932,2000,9.3,43,28,27,14,2,23,39,59,16,14,1,13,23,66,30,5
1260,Curtis Jones,eng ENG,"MF,DF",Liverpool,eng Premier League,24.25753425,2001,16,34,18,6,21,7,15,23,65.2,8,15,7,8,5,39,8,2
1261,Frenkie de Jong,nl NED,MF,Barcelona,es La Liga,27.97808219,1997,10.1,15,9,4,5,6,7,14,50,7,6,0,6,5,20,6,1
1262,Joan Jordán,es ESP,MF,Alavés,es La Liga,30.82739726,1994,15.1,31,17,11,16,4,16,29,55.2,13,12,0,12,8,39,20,0
1263,Jorginho,it ITA,MF,Arsenal,eng Premier League,33.36986301,1991,7.8,12,4,1,7,4,8,20,40,12,3,0,3,7,19,2,2
1264,Jesse Joronen,fi FIN,GK,Venezia,it Serie A,32.12054795,1993,7.8,0,0,0,0,0,0,0,,0,0,0,0,0,0,4,1
1265,Jota,pt POR,"FW,MF",Rennes,fr Ligue 1,26.09589041,1999,3.7,5,2,2,3,0,4,7,57.1,3,1,0,1,3,8,2,0
1266,Diogo Jota,pt POR,FW,Liverpool,eng Premier League,28.41369863,1996,12.2,14,8,2,8,4,7,19,36.8,12,9,0,9,7,21,6,0
1267,Antoine Joujou,fr FRA,"MF,FW",Le Havre,fr Ligue 1,22.14520548,2003,10.4,16,11,10,4,2,9,15,60,6,15,3,12,9,25,19,0
1268,Luka Jović,rs SRB,"FW,MF",Milan,it Serie A,27.36164384,1997,3.9,0,0,0,0,0,0,0,,0,2,1,1,1,1,2,0
1269,Juanmi,es ESP,"FW,MF",Getafe,es La Liga,31.95616438,1993,7.4,14,11,4,7,3,6,16,37.5,10,6,0,6,2,16,3,0
1270,Juanmi,es ESP,"FW,MF",Betis,es La Liga,31.95616438,1993,2.7,7,4,3,3,1,4,6,66.7,2,4,0,4,1,8,4,0
1271,Juanpe,es ESP,DF,Girona,es La Liga,34.0109589,1991,6.8,8,5,5,3,0,6,8,75,2,14,9,5,8,16,46,1
1272,Jubal,br BRA,DF,Auxerre,fr Ligue 1,31.67945205,1993,27.3,58,38,46,11,1,27,39,69.2,12,58,33,25,23,81,187,1
1273,Anthony Jung,de GER,DF,Werder Bremen,de Bundesliga,33.49863014,1991,21,34,22,22,11,1,22,34,64.7,12,23,14,9,25,59,76,1
1274,Luiz Lúcio Reis Júnior,br BRA,GK,Villarreal,es La Liga,24.30136986,2001,13.2,0,0,0,0,0,0,0,,0,0,0,0,0,0,14,1
1275,Hamed Junior Traorè,ci CIV,MF,Auxerre,fr Ligue 1,25.2109589,2000,21.7,41,20,11,17,13,16,53,30.2,37,14,0,14,6,47,11,0
1276,Vinicius Júnior,br BRA,FW,Real Madrid,es La Liga,24.8109589,2000,22.7,19,9,7,3,9,4,17,23.5,13,5,0,5,3,22,1,2
1277,Josip Juranović,hr CRO,"DF,MF",Union Berlin,de Bundesliga,29.71506849,1995,11.9,19,11,11,5,3,9,22,40.9,13,12,6,6,7,26,35,2
1278,David Jurásek,cz CZE,DF,Hoffenheim,de Bundesliga,24.73972603,2000,6.9,6,3,3,2,1,2,5,40,3,5,0,5,6,12,17,0
1279,Stanko Jurić,hr CRO,MF,Valladolid,es La Liga,28.71506849,1996,19.2,48,24,26,19,3,19,48,39.6,29,35,11,24,24,72,52,0
1280,James Justin,eng ENG,DF,Leicester City,eng Premier League,27.19178082,1998,29.7,49,29,25,19,5,28,51,54.9,23,41,14,27,44,93,129,3
1281,Filip Jørgensen,dk DEN,GK,Chelsea,eng Premier League,23.04931507,2002,6,0,0,0,0,0,0,0,,0,0,0,0,0,0,0,3
1282,Mohamed Kaba,fr FRA,MF,Lecce,it Serie A,23.51780822,2001,4.3,12,7,6,5,1,7,8,87.5,1,10,3,7,4,16,9,1
1283,Yusuf Kabadayı,de GER,"FW,MF",Augsburg,de Bundesliga,21.24931507,2004,0.8,1,0,0,1,0,0,0,,0,1,0,1,0,1,0,0
1284,Almugera Kabar,de GER,DF,Dortmund,de Bundesliga,18.90958904,2006,1.5,5,3,2,2,1,3,3,100,0,1,0,1,1,6,4,0
1285,Christian Kabasele,be BEL,DF,Udinese,it Serie A,34.1890411,1991,11.1,13,8,6,7,0,7,9,77.8,2,10,4,6,11,24,53,1
1286,Issa Kaboré,bf BFA,"DF,FW",Werder Bremen,de Bundesliga,23.97808219,2001,3.4,8,4,2,5,1,4,6,66.7,2,8,2,6,2,10,7,0
1287,Yaya Kader Fofana,ml MLI,"MF,FW",Reims,fr Ligue 1,20.89315068,2004,7,17,11,8,5,4,4,12,33.3,8,11,2,9,3,20,2,0
1288,Pavel Kadeřábek,cz CZE,DF,Hoffenheim,de Bundesliga,33.02465753,1992,15.5,22,11,11,4,7,13,29,44.8,16,11,3,8,18,40,49,1
1289,Tino Kadewere,zw ZIM,"MF,FW",Nantes,fr Ligue 1,29.3260274,1996,5.6,14,8,5,3,6,6,13,46.2,7,3,0,3,5,19,8,0
1290,Ferdi Kadioglu,tr TUR,"DF,MF",Brighton,eng Premier League,25.57260274,1999,4.3,10,6,4,5,1,6,15,40,9,2,2,0,8,18,17,0
1291,Arnaud Kalimuendo,fr FRA,"FW,MF",Rennes,fr Ligue 1,23.28493151,2002,26.7,18,11,6,8,4,6,12,50,6,9,2,7,4,22,12,0
1292,Pierre Kalulu,fr FRA,DF,Juventus,it Serie A,24.91232877,2000,24.3,38,22,27,9,2,18,24,75,6,27,15,12,16,54,65,1
1293,Justin-Noël Kalumba,fr FRA,"FW,MF",Angers,fr Ligue 1,20.35616438,2004,0.3,0,0,0,0,0,0,0,,0,0,0,0,1,1,1,0
1294,Daichi Kamada,jp JPN,MF,Crystal Palace,eng Premier League,28.74520548,1996,14.9,43,25,17,22,4,12,37,32.4,25,19,4,15,16,59,13,0
1295,Waren Kamanzi,no NOR,"DF,MF",Toulouse,fr Ligue 1,24.47671233,2000,9.6,26,12,11,11,4,12,24,50,12,4,1,3,8,34,22,0
1296,Boubacar Kamara,fr FRA,MF,Aston Villa,eng Premier League,25.44383562,1999,16.3,49,20,28,17,4,28,54,51.9,26,17,7,10,17,66,48,3
1297,Glen Kamara,fi FIN,MF,Rennes,fr Ligue 1,29.51506849,1995,7.4,23,11,10,11,2,11,17,64.7,6,7,0,7,7,30,7,0
1298,Hassane Kamara,ci CIV,DF,Udinese,it Serie A,31.16438356,1994,20.9,33,24,19,11,3,14,26,53.8,12,22,5,17,26,59,45,1
1299,Noham Kamara,fr FRA,DF,Paris S-G,fr Ligue 1,18.27945205,2007,0.5,1,1,0,1,0,0,0,,0,1,1,0,0,1,1,0
1300,Willy Kambwala,fr FRA,DF,Villarreal,es La Liga,20.69041096,2004,10.4,13,8,10,2,1,6,7,85.7,1,7,5,2,8,21,44,1
1301,Jakub Kamiński,pl POL,"DF,MF",Wolfsburg,de Bundesliga,22.91232877,2002,11.1,16,7,7,3,6,8,21,38.1,13,17,7,10,11,27,21,1
1302,Kevin Kampl,si SVN,MF,RB Leipzig,de Bundesliga,34.56712329,1990,16.7,26,18,11,9,6,15,22,68.2,7,25,6,19,23,49,24,0
1303,Nordine Kandil,fr FRA,MF,Strasbourg,fr Ligue 1,23.50684932,2001,0.1,0,0,0,0,0,0,0,,0,0,0,0,0,0,1,0
1304,Harry Kane,eng ENG,FW,Bayern Munich,de Bundesliga,31.76712329,1993,25.1,12,10,3,7,2,2,6,33.3,4,13,2,11,2,14,14,0
1305,Lee Kang-in,kr KOR,"FW,MF",Paris S-G,fr Ligue 1,24.20273973,2001,17.5,25,17,7,11,7,19,35,54.3,16,11,1,10,2,27,3,1
1306,Yann Karamoh,fr FRA,"MF,FW",Torino,it Serie A,26.82191781,1998,11.6,5,2,2,1,2,4,9,44.4,5,10,2,8,3,8,5,0
1307,Atakan Karazor,,MF,Stuttgart,de Bundesliga,28.55616438,1996,27.1,56,27,17,27,12,27,55,49.1,28,36,6,30,27,83,49,1
1308,Jesper Karlsson,se SWE,FW,Bologna,it Serie A,26.77534247,1998,3.3,1,0,0,0,1,0,2,0,2,4,0,4,0,1,3,0
1309,Jesper Karlsson,se SWE,FW,Lecce,it Serie A,26.77534247,1998,4.9,3,2,3,0,0,2,8,25,6,1,0,1,0,3,3,0
1310,Jesper Karlström,se SWE,MF,Udinese,it Serie A,29.86849315,1995,32.4,57,31,30,19,8,25,50,50,25,27,11,16,34,91,78,4
1311,Lior Kasa,il ISR,"MF,FW",Genoa,it Serie A,19.6,2005,2.3,4,4,2,2,0,2,5,40,3,4,1,3,2,6,2,0
1312,Grigoris Kastanos,cy CYP,"MF,FW",Hellas Verona,it Serie A,27.25753425,1998,9.6,23,16,8,7,8,9,21,42.9,12,16,2,14,7,30,8,0
1313,Mikkel Kaufmann,dk DEN,FW,Heidenheim,de Bundesliga,24.33150685,2001,4.1,6,4,1,3,2,2,5,40,3,5,2,3,2,8,7,0
1314,Michael Kayode,it ITA,DF,Brentford,eng Premier League,20.81643836,2004,2.3,11,7,8,3,0,5,5,100,0,0,0,0,2,13,10,0
1315,Michael Kayode,it ITA,"DF,FW",Fiorentina,it Serie A,20.81643836,2004,1.4,1,1,1,0,0,0,0,,0,3,1,2,2,3,7,0
1316,Moise Kean,it ITA,FW,Fiorentina,it Serie A,25.17808219,2000,27,7,5,1,2,4,3,4,75,1,12,0,12,5,12,24,1
1317,Michael Keane,eng ENG,DF,Everton,eng Premier League,32.30958904,1993,9.5,10,7,7,2,1,7,13,53.8,6,11,7,4,10,20,55,2
1318,Yassine Kechta,ma MAR,"MF,FW",Le Havre,fr Ligue 1,23.18630137,2002,20.6,51,30,27,17,7,27,64,42.2,37,23,2,21,20,71,26,2
1319,Thilo Kehrer,de GER,DF,Monaco,fr Ligue 1,28.61643836,1996,25.5,36,22,25,11,0,21,37,56.8,16,17,9,8,33,69,109,1
1320,Abdoulaye Keita,es ESP,"FW,MF",Getafe,es La Liga,22.67123288,2002,1.1,2,2,0,1,1,2,4,50,2,1,0,1,0,2,3,0
1321,Mandela Keita,be BEL,MF,Parma,it Serie A,22.98356164,2002,18.2,39,21,10,23,6,17,31,54.8,14,14,5,9,19,58,24,2
1322,Yannik Keitel,de GER,MF,Stuttgart,de Bundesliga,25.21369863,2000,2.8,9,6,3,5,1,9,10,90,1,5,2,3,4,13,6,0
1323,Andu Kelati,de GER,"MF,DF",Holstein Kiel,de Bundesliga,22.72328767,2002,3.2,7,4,2,4,1,2,5,40,3,4,1,3,3,10,3,0
1324,Caoimhín Kelleher,ie IRL,GK,Liverpool,eng Premier League,26.44383562,1998,10,0,0,0,0,0,0,0,,0,0,0,0,0,0,1,2
1325,Thomas Keller,de GER,"DF,MF",Heidenheim,de Bundesliga,25.74520548,1999,1.6,6,5,5,1,0,4,6,66.7,2,3,1,2,4,10,11,0
1326,Lloyd Kelly,eng ENG,DF,Newcastle Utd,eng Premier League,26.57534247,1998,3.4,5,4,4,1,0,1,1,100,0,6,4,2,1,6,17,0
1327,Lloyd Kelly,eng ENG,DF,Juventus,it Serie A,26.57534247,1998,9.3,10,8,3,6,1,7,9,77.8,2,10,6,4,1,11,41,3
1328,Aljoscha Kemlein,de GER,MF,Union Berlin,de Bundesliga,20.75342466,2004,10.2,10,4,4,5,1,5,14,35.7,9,14,3,11,6,16,15,0
1329,Marc-Oliver Kempf,de GER,DF,Como,it Serie A,30.2630137,1995,27.1,30,20,15,14,1,13,24,54.2,11,30,22,8,31,61,126,3
1330,Kenedy,br BRA,"MF,FW",Valladolid,es La Liga,29.23287671,1996,0.1,0,0,0,0,0,0,0,,0,1,0,1,0,0,0,0
1331,Luca Kerber,de GER,"MF,DF",Heidenheim,de Bundesliga,23.15068493,2002,8.1,26,16,17,8,1,16,29,55.2,13,13,4,9,5,31,25,0
1332,Milos Kerkez,hu HUN,DF,Bournemouth,eng Premier League,21.48767123,2003,34.2,50,26,25,19,6,23,37,62.2,14,36,11,25,42,92,103,3
1333,Reda Khadra,de GER,"MF,FW",Reims,fr Ligue 1,23.83287671,2001,0.9,1,1,1,0,0,0,1,0,1,0,0,0,0,1,1,0
1334,Bilal El Khannouss,ma MAR,MF,Leicester City,eng Premier League,20.98356164,2004,22.3,46,26,15,26,5,15,28,53.6,13,21,4,17,6,52,9,3
1335,Wahbi Khazri,tn TUN,"FW,MF",Montpellier,fr Ligue 1,34.23287671,1991,11.6,24,17,5,15,4,7,20,35,13,11,1,10,5,29,7,0
1336,Rani Khedira,de GER,MF,Union Berlin,de Bundesliga,31.26575342,1994,28.3,64,37,26,35,3,23,37,62.2,14,31,11,20,43,107,55,0
1337,Abdukodir Khusanov,uz UZB,DF,Manchester City,eng Premier League,21.17534247,2004,5.6,5,4,4,1,0,2,3,66.7,1,5,4,1,3,8,29,1
1338,Abdukodir Khusanov,uz UZB,DF,Lens,fr Ligue 1,21.17534247,2004,10.8,15,11,9,5,1,7,11,63.6,4,17,11,6,26,41,57,0
1339,Kialonda,ao ANG,DF,Lecce,it Serie A,27.6,1997,21,33,12,24,9,0,11,15,73.3,4,41,26,15,26,59,102,1
1340,Kiké,es ESP,FW,Alavés,es La Liga,35.43835616,1989,25.6,17,12,1,11,5,5,11,45.5,6,9,2,7,1,18,22,0
1341,Max Kilman,eng ENG,DF,West Ham,eng Premier League,27.94794521,1997,33.2,30,17,13,14,3,19,23,82.6,4,55,37,18,37,67,191,4
1342,Joshua Kimmich,de GER,MF,Bayern Munich,de Bundesliga,30.23287671,1995,29.6,46,28,11,28,7,29,46,63,17,22,3,19,24,70,33,3
1343,Presnel Kimpembe,fr FRA,DF,Paris S-G,fr Ligue 1,29.72328767,1995,0.3,1,0,1,0,0,0,0,,0,2,2,0,0,1,1,0
1344,Joshua King,eng ENG,"MF,FW",Fulham,eng Premier League,18.33150685,2007,0.9,5,3,2,3,0,0,2,0,2,2,0,2,1,6,1,0
1345,Joshua King,no NOR,"FW,MF",Toulouse,fr Ligue 1,33.29863014,1992,16.9,9,9,4,3,2,4,11,36.4,7,10,3,7,5,14,18,0
1346,Antonín Kinský,cz CZE,GK,Tottenham,eng Premier League,22.14246575,2003,4,3,1,3,0,0,1,1,100,0,0,0,0,0,3,5,1
1347,Cédric Kipré,ci CIV,DF,Reims,fr Ligue 1,28.4,1996,22.3,36,25,26,9,1,26,35,74.3,9,40,27,13,31,67,149,2
1348,Jakub Kiwior,pl POL,DF,Arsenal,eng Premier League,25.21369863,2000,9.5,13,7,7,5,1,8,11,72.7,3,8,5,3,3,16,37,2
1349,Tim Kleindienst,de GER,FW,Gladbach,de Bundesliga,29.6739726,1995,29.4,27,14,5,13,9,8,33,24.2,25,45,9,36,11,38,65,1
1350,Lukas Klostermann,de GER,DF,RB Leipzig,de Bundesliga,28.91780822,1996,19.4,27,14,18,7,2,14,22,63.6,8,30,16,14,24,51,134,3
1351,Justin Kluivert,nl NED,"MF,FW",Bournemouth,eng Premier League,25.99726027,1999,24,21,9,4,10,7,4,21,19,17,24,0,24,13,34,23,1
1352,Ansgar Knauff,de GER,"MF,DF",Eint Frankfurt,de Bundesliga,23.31232877,2002,15.1,38,20,17,14,7,12,25,48,13,22,4,18,12,50,20,0
1353,Magnus Knudsen,no NOR,MF,Holstein Kiel,de Bundesliga,23.88493151,2001,18.7,44,25,20,19,5,23,41,56.1,18,17,4,13,12,56,41,0
1354,Gregor Kobel,ch SUI,GK,Dortmund,de Bundesliga,27.40821918,1997,30,0,0,0,0,0,0,0,,0,0,0,0,0,0,22,3
1355,Robin Koch,de GER,DF,Eint Frankfurt,de Bundesliga,28.79726027,1996,25.7,22,10,13,7,2,10,22,45.5,12,37,23,14,22,44,160,4
1356,Hervé Koffi,bf BFA,GK,Lens,fr Ligue 1,28.54794521,1996,5,1,1,1,0,0,1,1,100,0,0,0,0,0,1,5,0
1357,Magnus Kofod Andersen,dk DEN,MF,Venezia,it Serie A,25.98356164,1999,7.7,13,4,3,9,1,4,10,40,6,7,2,5,6,19,12,0
1358,Derrick Köhn,de GER,"DF,FW",Werder Bremen,de Bundesliga,26.24383562,1999,14.6,20,10,7,10,3,10,14,71.4,4,20,4,16,9,29,26,0
1359,Philipp Köhn,ch SUI,GK,Monaco,fr Ligue 1,27.08767123,1998,17,0,0,0,0,0,0,1,0,1,0,0,0,0,0,10,2
1360,Dominik Kohr,de GER,"DF,MF",Mainz 05,de Bundesliga,31.25479452,1994,25.4,62,46,34,21,7,35,55,63.6,20,43,24,19,42,104,126,0
1361,Koka,eg EGY,FW,Le Havre,fr Ligue 1,32.16438356,1993,8.7,4,1,1,3,0,0,4,0,4,2,0,2,3,7,6,1
1362,Koke,es ESP,MF,Atlético Madrid,es La Liga,33.31780822,1992,17.9,43,22,17,20,6,20,38,52.6,18,21,2,19,18,61,25,1
1363,Sead Kolašinac,ba BIH,DF,Atalanta,it Serie A,31.87123288,1993,21.1,41,26,21,20,0,16,30,53.3,14,16,7,9,25,66,53,1
1364,Randal Kolo Muani,fr FRA,FW,Juventus,it Serie A,26.4109589,1998,9.5,8,4,1,4,3,2,3,66.7,1,5,0,5,1,9,2,0
1365,Randal Kolo Muani,fr FRA,FW,Paris S-G,fr Ligue 1,26.4109589,1998,4,4,4,1,1,2,0,2,0,2,1,0,1,0,4,5,0
1366,Marco Komenda,hr CRO,DF,Holstein Kiel,de Bundesliga,28.43561644,1996,14.5,26,17,12,13,1,11,15,73.3,4,23,11,12,6,32,68,0
1367,Mert Kömür,de GER,MF,Augsburg,de Bundesliga,19.79726027,2005,5.2,3,2,2,0,1,0,2,0,2,7,3,4,3,6,4,1
1368,Ibrahima Konaté,fr FRA,DF,Liverpool,eng Premier League,25.94246575,1999,25.8,36,25,24,11,1,24,34,70.6,10,27,15,12,12,48,124,2
1369,Ismael Konate,ci CIV,"FW,MF",Empoli,it Serie A,19.09863014,2006,0.8,4,2,4,0,0,2,3,66.7,1,3,2,1,0,4,1,0
1370,Geoffrey Kondogbia,cf CTA,"DF,MF",Marseille,fr Ligue 1,32.21369863,1993,21.4,59,37,30,26,3,27,34,79.4,7,23,6,17,21,80,64,4
1371,Abdoul Koné,fr FRA,DF,Reims,fr Ligue 1,20.03287671,2005,1.5,5,3,4,1,0,3,5,60,2,2,1,1,1,6,5,0
1372,Amadou Koné,ml MLI,MF,Reims,fr Ligue 1,19.97260274,2005,12.9,45,31,30,15,0,20,32,62.5,12,14,2,12,17,62,37,2
1373,Ismaël Koné,ca CAN,"MF,FW",Marseille,fr Ligue 1,22.90958904,2002,4,8,4,3,3,2,3,4,75,1,4,1,3,4,12,2,1
1374,Ismaël Koné,ca CAN,MF,Rennes,fr Ligue 1,22.90958904,2002,3.7,7,4,2,4,1,4,5,80,1,6,1,5,3,10,4,0
1375,Manu Koné,fr FRA,MF,Roma,it Serie A,23.96438356,2001,24.6,35,22,14,15,6,16,36,44.4,20,23,3,20,18,53,19,0
1376,Ezri Konsa,eng ENG,DF,Aston Villa,eng Premier League,27.52876712,1997,29.6,32,17,19,9,4,18,22,81.8,4,18,10,8,21,53,101,4
1377,Teun Koopmeiners,nl NED,"MF,FW",Juventus,it Serie A,27.17808219,1998,22.2,32,16,6,19,7,10,30,33.3,20,36,14,22,8,40,26,2
1378,Odilon Kossounou,ci CIV,DF,Atalanta,it Serie A,24.32876712,2001,9,12,7,7,4,1,4,7,57.1,3,11,3,8,8,20,14,0
1379,Christian Kouamé,ci CIV,"FW,MF",Fiorentina,it Serie A,27.40821918,1997,6.9,13,8,4,4,5,0,3,0,3,3,1,2,2,15,10,0
1380,Christian Kouamé,ci CIV,"FW,MF",Empoli,it Serie A,27.40821918,1997,5.6,5,4,0,3,2,2,4,50,2,4,2,2,0,5,4,0
1381,Henri Koudossou,de GER,DF,Augsburg,de Bundesliga,25.66575342,1999,7.5,18,10,6,11,1,11,19,57.9,8,8,2,6,13,31,36,0
1382,Konstantinos Koulierakis,gr GRE,DF,Wolfsburg,de Bundesliga,21.43013699,2003,25.4,39,19,24,13,2,24,38,63.2,14,31,13,18,29,68,132,2
1383,Emmanuel Koum Mbondo,fr FRA,DF,Marseille,fr Ligue 1,19.24109589,2006,0.1,0,0,0,0,0,0,0,,0,0,0,0,0,0,0,0
1384,Jules Koundé,fr FRA,DF,Barcelona,es La Liga,26.4739726,1998,28.9,63,43,29,23,11,44,66,66.7,22,35,5,30,20,83,68,2
1385,Boubakar Kouyaté,ml MLI,DF,Montpellier,fr Ligue 1,28.05205479,1997,7.4,22,15,16,6,0,11,19,57.9,8,17,11,6,12,34,54,0
1386,Mateo Kovačić,hr CRO,MF,Manchester City,eng Premier League,30.99452055,1994,22.8,67,38,22,38,7,30,63,47.6,33,20,0,20,20,87,20,1
1387,Viktor Kovalenko,ua UKR,MF,Empoli,it Serie A,29.21643836,1996,0.9,2,1,0,2,0,0,1,0,1,0,0,0,0,2,0,0
1388,Matej Kovar,cz CZE,GK,Leverkusen,de Bundesliga,24.96438356,2000,4,0,0,0,0,0,0,0,,0,0,0,0,0,0,0,1
1389,Mateusz Kowalski,pl POL,MF,Parma,it Serie A,19.78630137,2005,0.6,0,0,0,0,0,0,0,,0,1,0,1,0,0,1,0
1390,Goduine Koyalipou,cf CTA,FW,Lens,fr Ligue 1,25.21369863,2000,7.3,1,1,0,1,0,0,0,,0,2,0,2,1,2,6,0
1391,Caleb Kporha,eng ENG,DF,Crystal Palace,eng Premier League,18.80273973,2006,0.1,2,1,2,0,0,2,2,100,0,0,0,0,0,2,1,0
1392,Emil Krafth,se SWE,DF,Newcastle Utd,eng Premier League,30.75342466,1994,3.2,4,2,2,1,1,2,3,66.7,1,5,4,1,2,6,11,0
1393,Alex Král,cz CZE,MF,Espanyol,es La Liga,26.95890411,1998,28.7,53,35,27,23,3,16,29,55.2,13,33,14,19,26,79,47,1
1394,Andrej Kramarić,hr CRO,"MF,FW",Hoffenheim,de Bundesliga,33.8739726,1991,28.9,15,8,5,8,2,6,11,54.5,5,16,3,13,7,22,11,1
1395,Frans Krätzig,de GER,"DF,MF",Heidenheim,de Bundesliga,22.30136986,2003,12.5,32,18,14,12,6,12,20,60,8,12,1,11,15,47,15,0
1396,Frans Krätzig,de GER,DF,Stuttgart,de Bundesliga,22.30136986,2003,0.6,2,1,1,0,1,1,3,33.3,2,2,1,1,0,2,1,0
1397,Tom Krauß,de GER,MF,Bochum,de Bundesliga,23.86575342,2001,11.5,33,17,19,12,2,18,36,50,18,25,2,23,9,42,16,1
1398,Ladislav Krejčí,cz CZE,DF,Girona,es La Liga,26.03835616,1999,23.1,21,15,17,4,0,12,24,50,12,24,19,5,31,52,81,4
1399,Rasmus Kristensen,dk DEN,DF,Eint Frankfurt,de Bundesliga,27.81369863,1997,24.9,55,30,35,15,5,38,64,59.4,26,45,13,32,19,74,80,1
1400,Thomas Kristensen,dk DEN,DF,Udinese,it Serie A,23.29315068,2002,17.5,29,19,14,11,4,19,26,73.1,7,17,13,4,18,47,68,2
1401,Nikola Krstović,me MNE,FW,Lecce,it Serie A,25.07945205,2000,31.4,17,8,4,6,7,6,14,42.9,8,10,6,4,7,24,22,0
1402,Lukas Kübler,de GER,DF,Freiburg,de Bundesliga,32.67671233,1992,19.8,39,20,17,19,3,27,48,56.3,21,31,12,19,50,89,56,3
1403,Takefusa Kubo,jp JPN,"MF,FW",Real Sociedad,es La Liga,23.91506849,2001,22,27,16,10,10,7,15,34,44.1,19,31,1,30,11,38,12,1
1404,Mohammed Kudus,gh GHA,"FW,MF",West Ham,eng Premier League,24.75342466,2000,25.9,33,19,7,16,10,10,27,37,17,23,1,22,4,37,8,2
1405,Dejan Kulusevski,se SWE,"MF,FW",Tottenham,eng Premier League,25.02465753,2000,25.3,43,23,16,12,15,19,49,38.8,30,27,4,23,13,56,9,1
1406,Sael Kumbedi,fr FRA,DF,Lyon,fr Ligue 1,20.10684932,2005,10.6,28,14,11,13,4,14,20,70,6,11,3,8,8,36,32,1
1407,Marash Kumbulla,al ALB,DF,Espanyol,es La Liga,25.23287671,2000,29,47,22,33,12,2,24,38,63.2,14,43,32,11,30,77,202,2
1408,Jonah Kusi-Asare,se SWE,FW,Bayern Munich,de Bundesliga,17.83287671,2007,0,1,0,0,0,1,0,0,,0,0,0,0,0,1,0,0
1409,Daler Kuzyaev,ru RUS,MF,Le Havre,fr Ligue 1,32.29863014,1993,6.3,13,8,7,4,2,2,9,22.2,7,7,4,3,9,22,8,0
1410,Khvicha Kvaratskhelia,ge GEO,"FW,MF",Napoli,it Serie A,24.22191781,2001,13.1,15,9,4,10,1,4,15,26.7,11,13,0,13,4,19,7,0
1411,Khvicha Kvaratskhelia,ge GEO,FW,Paris S-G,fr Ligue 1,24.22191781,2001,9.2,19,13,4,12,3,13,23,56.5,10,6,0,6,2,21,4,0
1412,Moritz-Broni Kwarteng,gh GHA,"MF,FW",Bochum,de Bundesliga,27.01643836,1998,1.9,4,3,1,1,2,1,2,50,1,0,0,0,0,4,1,0
1413,Giorgos Kyriakopoulos,gr GRE,DF,Monza,it Serie A,29.24109589,1996,27.9,39,25,18,17,4,27,57,47.4,30,27,9,18,20,59,70,0
1414,Luca de la Torre,us USA,MF,Celta Vigo,es La Liga,26.94794521,1998,0,0,0,0,0,0,0,0,,0,0,0,0,0,0,0,0
1415,Rémy Labeau Lascary,gp GLP,"FW,MF",Lens,fr Ligue 1,22.16986301,2003,7.1,16,10,7,6,3,5,11,45.5,6,5,0,5,1,17,7,0
1416,Gaëtan Laborde,fr FRA,FW,Nice,fr Ligue 1,31.00273973,1994,19,19,13,9,8,2,9,22,40.9,13,16,4,12,5,24,17,0
1417,Nediljko Labrović,hr CRO,GK,Augsburg,de Bundesliga,25.56438356,1999,15,0,0,0,0,0,0,0,,0,0,0,0,0,0,12,1
1418,Alexandre Lacazette,fr FRA,FW,Lyon,fr Ligue 1,33.93424658,1991,20.9,13,6,3,7,3,5,15,33.3,10,12,2,10,8,21,6,0
1419,Younes Lachaab,fr FRA,"MF,FW",Lille,fr Ligue 1,20.32328767,2005,0.1,1,1,0,0,1,1,1,100,0,0,0,0,1,2,0,0
1420,Maxence Lacroix,fr FRA,DF,Crystal Palace,eng Premier League,25.07671233,2000,30.6,67,40,51,15,1,32,47,68.1,15,41,16,25,50,117,181,2
1421,Alban Lafont,fr FRA,GK,Nantes,fr Ligue 1,26.27671233,1999,12,1,1,1,0,0,1,1,100,0,2,0,2,0,1,8,1
1422,Yoel Lago,es ESP,DF,Celta Vigo,es La Liga,21.10958904,2004,3.3,6,4,3,2,1,3,4,75,1,3,2,1,2,8,11,0
1423,Konrad Laimer,at AUT,DF,Bayern Munich,de Bundesliga,27.9369863,1997,17.1,44,24,16,20,8,21,46,45.7,25,23,1,22,8,52,23,1
1424,Stefan Lainer,at AUT,DF,Gladbach,de Bundesliga,32.68493151,1992,6.7,19,11,13,5,1,11,13,84.6,2,9,5,4,10,29,21,0
1425,Kenny Lala,mg MAD,DF,Brest,fr Ligue 1,33.58356164,1991,26.8,63,39,35,22,6,35,52,67.3,17,24,9,15,24,87,68,1
1426,Adam Lallana,eng ENG,MF,Southampton,eng Premier League,36.98356164,1988,4,8,5,4,4,0,2,12,16.7,10,4,1,3,5,13,5,0
1427,Mathis Lambourde,fr FRA,"FW,MF",Hellas Verona,it Serie A,19.31506849,2006,1,3,1,2,1,0,1,3,33.3,2,3,0,3,0,3,1,0
1428,Mohamed Lamine Bayo,gn GUI,FW,Lille,fr Ligue 1,26.91506849,1998,3.4,1,1,0,0,1,1,1,100,0,0,0,0,0,1,4,0
1429,Tariq Lamptey,gh GHA,DF,Brighton,eng Premier League,24.59178082,2000,8.5,14,10,8,6,0,7,22,31.8,15,12,5,7,6,20,21,1
1430,Will Lankshear,eng ENG,"FW,MF",Tottenham,eng Premier League,20.03835616,2005,0.1,0,0,0,0,0,0,0,,0,0,0,0,0,0,0,0
1431,Gianluca Lapadula,pe PER,"FW,MF",Cagliari,it Serie A,35.23561644,1990,3.4,2,0,1,0,1,0,1,0,1,0,0,0,0,2,1,0
1432,Cyle Larin,ca CAN,FW,Mallorca,es La Liga,30.04657534,1995,17.2,11,5,1,5,5,2,7,28.6,5,12,3,9,1,12,13,0
1433,Gautier Larsonneur,fr FRA,GK,Saint-Étienne,fr Ligue 1,28.19178082,1997,31,1,0,1,0,0,0,2,0,2,1,0,1,0,1,24,1
1434,Hugo Larsson,se SWE,MF,Eint Frankfurt,de Bundesliga,20.85205479,2004,23.6,42,25,16,21,5,18,37,48.6,19,38,10,28,25,67,28,1
1435,Juanmi Latasa,es ESP,FW,Valladolid,es La Liga,24.11506849,2001,12,3,1,1,1,1,2,5,40,3,3,1,2,0,3,10,1
1436,Toni Lato,es ESP,DF,Mallorca,es La Liga,27.44931507,1997,5.1,16,10,6,4,6,6,9,66.7,3,6,2,4,4,20,27,0
1437,Roméo Lavia,be BEL,MF,Chelsea,eng Premier League,21.32328767,2004,6.7,19,11,5,10,4,8,16,50,8,6,0,6,13,32,6,0
1438,Valentino Lazaro,at AUT,"DF,FW",Torino,it Serie A,29.11232877,1996,23,25,11,10,12,3,15,28,53.6,13,28,5,23,10,35,38,1
1439,Darko Lazović,rs SRB,"DF,FW",Hellas Verona,it Serie A,34.63287671,1990,15.9,20,10,5,13,2,11,28,39.3,17,19,3,16,11,31,39,0
1440,Manuel Lazzari,it ITA,DF,Lazio,it Serie A,31.42739726,1993,15.3,26,16,13,11,2,14,24,58.3,10,9,5,4,10,36,19,0
1441,Julien Le Cardinal,fr FRA,DF,Brest,fr Ligue 1,27.75068493,1997,15.3,27,15,16,8,3,11,16,68.8,5,18,14,4,33,60,75,0
1442,Jérémy Le Douaron,fr FRA,FW,Brest,fr Ligue 1,27.03561644,1998,1.1,1,0,0,0,1,0,1,0,1,1,0,1,0,1,0,0
1443,Enzo Le Fée,fr FRA,MF,Roma,it Serie A,25.24657534,2000,3.5,7,4,5,2,0,2,6,33.3,4,9,3,6,5,12,2,0
1444,Robin Le Normand,es ESP,DF,Atlético Madrid,es La Liga,28.47671233,1996,20.9,25,16,21,4,0,11,18,61.1,7,17,8,9,8,33,108,1
1445,Nicola Leali,it ITA,GK,Genoa,it Serie A,32.20821918,1993,27,0,0,0,0,0,0,0,,0,0,0,0,0,0,14,1
1446,Rafael Leão,pt POR,FW,Milan,it Serie A,25.89863014,1999,24.8,14,9,2,8,4,9,26,34.6,17,13,1,12,6,20,3,0
1447,Benjamin Lecomte,fr FRA,GK,Montpellier,fr Ligue 1,34.02191781,1991,27,0,0,0,0,0,0,0,,0,0,0,0,0,0,17,2
1448,Pierre Lees-Melou,fr FRA,MF,Brest,fr Ligue 1,31.94246575,1993,15.1,45,30,19,19,7,25,51,49,26,13,2,11,10,55,22,0
1449,Jordan Lefort,fr FRA,DF,Angers,fr Ligue 1,31.73424658,1993,31,52,30,42,9,1,30,44,68.2,14,50,31,19,30,82,191,3
1450,Diogo Leite,pt POR,DF,Union Berlin,de Bundesliga,26.27671233,1999,28.3,64,32,43,17,4,33,50,66,17,61,25,36,57,121,162,1
1451,Maxim Leitsch,de GER,DF,Mainz 05,de Bundesliga,26.96164384,1998,7.5,12,4,6,4,2,7,9,77.8,2,12,4,8,10,22,42,1
1452,Florian Lejeune,fr FRA,DF,Rayo Vallecano,es La Liga,33.95616438,1991,32.9,43,26,28,13,2,21,39,53.8,18,35,29,6,30,73,162,1
1453,Stefan Lekovic,rs SRB,DF,Monza,it Serie A,21.31506849,2004,3.6,8,4,5,2,1,4,10,40,6,4,4,0,6,14,3,0
1454,Iñigo Lekue,es ESP,DF,Athletic Club,es La Liga,32,1993,6.6,13,10,11,2,0,7,12,58.3,5,6,1,5,5,18,20,2
1455,Nunzio Lella,it ITA,MF,Venezia,it Serie A,24.76712329,2000,0.1,0,0,0,0,0,0,0,,0,0,0,0,0,0,0,0
1456,Thomas Lemar,fr FRA,MF,Atlético Madrid,es La Liga,29.4739726,1995,0.7,2,1,1,1,0,2,4,50,2,0,0,0,0,2,0,0
1457,Félix Lemaréchal,fr FRA,"MF,FW",Strasbourg,fr Ligue 1,21.73972603,2003,17.8,33,23,13,15,5,14,29,48.3,15,35,4,31,14,47,19,0
1458,Mario Lemina,ga GAB,"MF,DF",Wolves,eng Premier League,31.67123288,1993,15.2,51,31,27,19,5,20,29,69,9,12,7,5,27,78,50,3
1459,Clément Lenglet,fr FRA,DF,Atlético Madrid,es La Liga,29.87945205,1995,19.9,22,14,16,6,0,8,11,72.7,3,24,18,6,20,42,96,1
1460,Bernd Leno,de GER,GK,Fulham,eng Premier League,33.16712329,1992,35,2,2,2,0,0,2,2,100,0,1,0,1,0,2,9,4
1461,Donovan Léon,gf GUF,GK,Auxerre,fr Ligue 1,32.49863014,1992,29,0,0,0,0,0,0,2,0,2,2,0,2,0,0,22,1
1462,Giovanni Leoni,it ITA,DF,Parma,it Serie A,18.36712329,2006,11.6,12,5,8,4,0,3,4,75,1,17,8,9,15,27,50,1
1463,Esteban Lepaul,fr FRA,FW,Angers,fr Ligue 1,25.04383562,2000,15.2,9,5,2,4,3,4,15,26.7,11,13,2,11,3,12,9,0
1464,Johann Lepenant,fr FRA,MF,Nantes,fr Ligue 1,22.53150685,2002,21.8,66,31,29,26,11,31,70,44.3,39,33,3,30,18,84,24,0
1465,Jefferson Lerma,co COL,"MF,DF",Crystal Palace,eng Premier League,30.52328767,1994,22.6,30,15,12,14,4,17,33,51.5,16,32,15,17,36,66,63,1
1466,Louis Leroux,fr FRA,"MF,DF",Nantes,fr Ligue 1,19.27671233,2006,6.8,20,14,9,8,3,11,15,73.3,4,15,1,14,5,25,15,1
1467,Robert Lewandowski,pl POL,FW,Barcelona,es La Liga,36.70136986,1988,27.1,9,4,1,5,3,4,10,40,6,14,2,12,3,12,24,0
1468,Jamie Leweling,de GER,"MF,FW",Stuttgart,de Bundesliga,24.18356164,2001,17,16,6,6,3,7,11,24,45.8,13,22,1,21,10,26,17,1
1469,Rico Lewis,eng ENG,"DF,MF",Manchester City,eng Premier League,20.44931507,2004,20.2,29,19,13,12,4,13,21,61.9,8,28,7,21,13,42,43,1
1470,Keane Lewis-Potter,eng ENG,"DF,FW",Brentford,eng Premier League,24.19452055,2001,30.7,44,26,23,15,6,26,43,60.5,17,24,9,15,19,63,71,3
1471,Myles Lewis-Skelly,eng ENG,DF,Arsenal,eng Premier League,18.60273973,2006,13,22,14,10,9,3,10,10,100,0,2,1,1,6,28,20,0
1472,Ben Lhassine Kone,ci CIV,MF,Como,it Serie A,25.13972603,2000,0.6,2,2,1,0,1,2,3,66.7,1,0,0,0,1,3,1,0
1473,Mattia Liberali,it ITA,MF,Milan,it Serie A,18.07671233,2007,0.7,2,1,0,1,1,2,2,100,0,0,0,0,0,2,0,0
1474,Philipp Lienhart,at AUT,DF,Freiburg,de Bundesliga,28.81369863,1996,27.8,22,13,12,10,0,15,30,50,15,27,17,10,35,57,107,2
1475,Matthijs de Ligt,nl NED,DF,Manchester Utd,eng Premier League,25.7260274,1999,23.2,30,22,17,12,1,23,32,71.9,9,29,21,8,33,63,92,0
1476,Pedro Lima,br BRA,DF,Wolves,eng Premier League,18.84109589,2006,0.8,1,0,0,0,1,1,3,33.3,2,0,0,0,2,3,5,0
1477,Victor Lindelöf,se SWE,DF,Manchester Utd,eng Premier League,30.79726027,1994,5.2,5,1,5,0,0,2,3,66.7,1,4,2,2,7,12,32,1
1478,Jesper Lindstrøm,dk DEN,FW,Everton,eng Premier League,25.17534247,2000,13.8,45,25,24,19,2,19,55,34.5,36,15,3,12,12,57,17,0
1479,Karol Linetty,pl POL,MF,Torino,it Serie A,30.24931507,1995,16.9,39,23,17,19,3,20,41,48.8,21,14,5,9,12,51,31,1
1480,Samuel Lino,br BRA,"MF,DF",Atlético Madrid,es La Liga,25.36164384,1999,14.4,25,13,20,4,1,18,45,40,27,19,4,15,7,32,12,0
1481,Pol Lirola,es ESP,DF,Marseille,fr Ligue 1,27.72328767,1997,7.1,13,9,5,8,0,5,13,38.5,8,7,2,5,4,17,11,0
1482,Dailon Livramento,cv CPV,"FW,MF",Hellas Verona,it Serie A,24,2001,9.9,12,8,1,5,6,6,12,50,6,9,2,7,3,15,8,0
1483,Valentino Livramento,eng ENG,DF,Newcastle Utd,eng Premier League,22.4739726,2002,27.6,50,33,32,14,4,29,54,53.7,25,33,10,23,21,71,95,1
1484,Marin Ljubicic,hr CRO,"FW,MF",Union Berlin,de Bundesliga,23.17808219,2002,2.5,0,0,0,0,0,0,2,0,2,2,0,2,0,0,7,0
1485,Javier Llabrés,es ESP,FW,Mallorca,es La Liga,22.64383562,2002,0.6,0,0,0,0,0,0,0,,0,1,0,1,0,0,0,0
1486,Diego Llorente,es ESP,DF,Betis,es La Liga,31.71506849,1993,28,36,20,23,12,1,25,38,65.8,13,29,20,9,43,79,154,1
1487,Marcos Llorente,es ESP,"DF,MF",Atlético Madrid,es La Liga,30.25753425,1995,23.9,61,45,34,24,3,33,48,68.8,15,27,7,20,22,83,47,1
1488,Gautier Lloris,fr FRA,DF,Le Havre,fr Ligue 1,29.79452055,1995,29.8,67,43,51,16,0,38,53,71.7,15,33,21,12,31,98,186,0
1489,Giovani Lo Celso,ar ARG,"MF,FW",Betis,es La Liga,29.06849315,1996,13.5,32,21,7,16,9,16,24,66.7,8,14,2,12,5,37,3,1
1490,Stanislav Lobotka,sk SVK,MF,Napoli,it Serie A,30.43835616,1994,29.2,46,30,16,20,10,18,29,62.1,11,29,11,18,21,67,57,1
1491,Manuel Locatelli,it ITA,MF,Juventus,it Serie A,27.31780822,1998,27.5,64,43,25,33,6,28,47,59.6,19,48,16,32,22,86,63,0
1492,Ruben Loftus-Cheek,eng ENG,MF,Milan,it Serie A,29.27671233,1996,8,16,7,4,8,4,5,9,55.6,4,1,0,1,2,18,11,0
1493,Elysée Logbo,fr FRA,FW,Le Havre,fr Ligue 1,20.99452055,2004,0.3,0,0,0,0,0,0,0,,0,0,0,0,0,0,0,0
1494,Enzo Loiodice,fr FRA,MF,Las Palmas,es La Liga,24.43287671,2000,5.6,11,4,6,5,0,3,9,33.3,6,4,1,3,5,16,7,2
1495,Sean Longstaff,eng ENG,MF,Newcastle Utd,eng Premier League,27.50958904,1997,8.9,27,16,10,9,8,18,27,66.7,9,17,5,12,7,34,8,0
1496,Ademola Lookman,ng NGA,"FW,MF",Atalanta,it Serie A,27.5369863,1997,22.6,30,14,9,13,8,10,18,55.6,8,18,0,18,2,32,5,1
1497,Anthony Lopes,pt POR,GK,Nantes,fr Ligue 1,34.5890411,1990,14.4,1,0,1,0,0,1,1,100,0,0,0,0,0,1,7,1
1498,David López,es ESP,DF,Mallorca,es La Liga,22.24657534,2003,0.9,1,1,1,0,0,1,1,100,0,0,0,0,1,2,3,0
1499,David López,es ESP,DF,Girona,es La Liga,35.56712329,1989,24,28,20,19,6,3,17,30,56.7,13,21,11,10,12,40,95,1
1500,Diego López,es ESP,"MF,FW",Valencia,es La Liga,22.97534247,2002,27.7,28,17,9,15,4,16,45,35.6,29,24,0,24,13,41,13,0
1501,Fer López,,"FW,MF",Celta Vigo,es La Liga,0,,4.9,6,3,1,3,2,0,5,0,5,6,0,6,1,7,6,0
1502,Fermin López,es ESP,"MF,FW",Barcelona,es La Liga,21.98082192,2003,11.5,18,14,3,8,7,7,25,28,18,8,0,8,4,22,3,0
1503,Javi López,es ESP,DF,Real Sociedad,es La Liga,23.10958904,2002,19.5,38,23,22,12,4,21,35,60,14,20,7,13,8,46,55,1
1504,Pau López,es ESP,GK,Girona,es La Liga,30.3890411,1994,0.5,0,0,0,0,0,0,0,,0,0,0,0,0,0,1,0
1505,Roberto López,es ESP,MF,Leganés,es La Liga,25.02739726,2000,4.4,7,5,4,3,0,4,14,28.6,10,4,0,4,1,8,7,2
1506,Unai López,es ESP,MF,Rayo Vallecano,es La Liga,29.50958904,1995,16.8,24,16,11,8,5,12,28,42.9,16,14,3,11,20,44,19,0
1507,Iker Losada,es ESP,"FW,MF",Celta Vigo,es La Liga,23.75616438,2001,3.8,3,3,0,1,2,1,5,20,4,3,0,3,1,4,7,0
1508,Iker Losada,es ESP,"MF,FW",Betis,es La Liga,23.75616438,2001,3.7,10,7,2,4,4,5,10,50,5,2,0,2,3,13,2,0
1509,Anthony Losilla,fr FRA,MF,Bochum,de Bundesliga,39.15068493,1986,12,28,16,14,11,3,16,32,50,16,21,7,14,18,46,25,1
1510,Jordan Lotomba,ch SUI,"MF,DF",Nice,fr Ligue 1,26.59452055,1998,0.4,0,0,0,0,0,0,0,,0,0,0,0,0,0,1,0
1511,Tom Louchet,fr FRA,"DF,MF",Nice,fr Ligue 1,22,2003,8,26,16,17,4,5,17,22,77.3,5,12,4,8,17,43,18,0
1512,Sandi Lovrić,si SVN,MF,Udinese,it Serie A,27.10136986,1998,24.5,45,29,24,17,4,22,43,51.2,21,33,5,28,22,67,25,1
1513,Pol Lozano,es ESP,MF,Espanyol,es La Liga,25.57534247,1999,19.3,50,33,20,25,5,24,51,47.1,27,26,5,21,20,70,29,0
1514,Lorenzo Lucca,it ITA,FW,Udinese,it Serie A,24.64657534,2000,24.8,9,6,2,2,5,4,10,40,6,18,1,17,6,15,24,0
1515,Jhon Lucumí,co COL,DF,Bologna,it Serie A,26.85479452,1998,25.4,42,23,22,20,0,23,34,67.6,11,29,13,16,24,66,82,6
1516,Yannik Lührs,de GER,DF,Dortmund,de Bundesliga,21.64931507,2003,1.4,1,1,1,0,0,0,0,,0,0,0,0,2,3,4,0
1517,José Luis Gayà,es ESP,DF,Valencia,es La Liga,29.94246575,1995,17.3,50,36,34,13,3,39,55,70.9,16,14,2,12,20,70,52,0
1518,José Luis Palomino,ar ARG,DF,Cagliari,it Serie A,35.3260274,1990,10.6,23,13,14,7,2,14,19,73.7,5,15,7,8,19,42,44,0
1519,Douglas Luiz,br BRA,MF,Juventus,it Serie A,26.98630137,1998,5.5,12,8,7,4,1,6,9,66.7,3,4,1,3,2,14,4,0
1520,Romelu Lukaku,be BEL,FW,Napoli,it Serie A,31.97534247,1993,28.9,4,2,0,2,2,1,4,25,3,7,2,5,1,5,15,0
1521,Castello Lukeba,fr FRA,DF,RB Leipzig,de Bundesliga,22.37808219,2002,16.5,31,17,15,12,4,17,23,73.9,6,24,11,13,16,47,70,0
1522,Dodi Lukebakio,be BEL,FW,Sevilla,es La Liga,27.60821918,1997,30.4,20,13,8,8,4,13,25,52,12,16,0,16,5,25,16,2
1523,Saša Lukić,rs SRB,MF,Fulham,eng Premier League,28.72328767,1996,24.1,66,37,21,39,6,21,53,39.6,32,19,7,12,26,92,32,0
1524,Milos Lukovic,rs SRB,"FW,MF",Strasbourg,fr Ligue 1,19.45753425,2005,0.1,0,0,0,0,0,0,0,,0,0,0,0,0,0,0,0
1525,Joe Lumley,eng ENG,GK,Southampton,eng Premier League,30.21369863,1995,3,0,0,0,0,0,0,0,,0,0,0,0,0,0,3,3
1526,Daniel Luna,co COL,MF,Mallorca,es La Liga,21.99178082,2003,0.2,0,0,0,0,0,0,0,,0,1,0,1,0,0,0,0
1527,Andriy Lunin,ua UKR,GK,Real Madrid,es La Liga,26.22465753,1999,5,0,0,0,0,0,0,0,,0,0,0,0,0,0,2,0
1528,Massimo Luongo,au AUS,MF,Ipswich Town,eng Premier League,32.60547945,1992,2.2,8,5,6,1,1,4,7,57.1,3,4,2,2,2,10,2,0
1529,Sebastiano Luperto,it ITA,DF,Cagliari,it Serie A,28.65753425,1996,34,45,24,29,15,1,16,26,61.5,10,27,13,14,31,76,152,1
1530,Zito Luvumbo,ao ANG,"FW,MF",Cagliari,it Serie A,23.15342466,2002,16.4,9,5,3,3,3,5,17,29.4,12,5,0,5,3,12,4,0
1531,Charalambos Lykogiannis,gr GRE,DF,Bologna,it Serie A,31.53150685,1993,9.6,16,10,10,5,1,7,13,53.8,6,6,4,2,9,25,31,1
1532,Senne Lynen,be BEL,MF,Werder Bremen,de Bundesliga,26.20273973,1999,28.4,70,37,35,29,6,37,64,57.8,27,54,12,42,62,132,68,5
1533,Mathias Løvik,no NOR,"DF,FW",Parma,it Serie A,21.40821918,2003,1,1,0,0,1,0,1,2,50,1,1,1,0,2,3,3,0
1534,Othmane Maamma,ma MAR,"FW,MF",Montpellier,fr Ligue 1,19.57534247,2005,3,3,1,2,1,0,1,4,25,3,4,0,4,1,4,2,1
1535,Ian Maatsen,nl NED,DF,Aston Villa,eng Premier League,23.15068493,2002,10.6,27,15,16,8,3,16,22,72.7,6,11,0,11,15,42,33,2
1536,Alexis Mac Allister,ar ARG,MF,Liverpool,eng Premier League,26.35890411,1998,28.4,95,58,28,51,16,55,101,54.5,46,60,6,54,22,117,29,1
1537,Deiver Machado,co COL,"DF,MF",Lens,fr Ligue 1,31.66849315,1993,18.3,34,25,13,13,8,16,27,59.3,11,19,3,16,15,49,26,2
1538,Shuto Machino,jp JPN,"FW,MF",Holstein Kiel,de Bundesliga,25.59178082,1999,19.5,8,5,4,3,1,6,14,42.9,8,11,2,9,6,14,18,0
1539,Darwin Machís,ve VEN,"MF,FW",Valladolid,es La Liga,32.23561644,1993,6.9,5,4,3,2,0,3,9,33.3,6,3,0,3,5,10,13,0
1540,Yvann Macon,fr FRA,DF,Saint-Étienne,fr Ligue 1,26.5890411,1998,7.8,19,11,9,7,3,10,21,47.6,11,14,4,10,2,21,10,1
1541,James Maddison,eng ENG,MF,Tottenham,eng Premier League,28.44383562,1996,20.1,31,19,8,16,7,9,29,31,20,15,4,11,12,43,19,1
1542,Eros Maddy,nl NED,DF,Auxerre,fr Ligue 1,24.24109589,2001,0.2,0,0,0,0,0,0,0,,0,0,0,0,0,0,0,0
1543,Noni Madueke,eng ENG,FW,Chelsea,eng Premier League,23.15068493,2002,19.1,22,15,7,12,3,13,33,39.4,20,14,0,14,8,30,10,0
1544,Pablo Maffeo,es ESP,DF,Mallorca,es La Liga,27.8109589,1997,23.5,56,37,41,12,3,32,43,74.4,11,31,11,20,22,78,89,1
1545,Gabriel Magalhães,br BRA,DF,Arsenal,eng Premier League,27.37260274,1997,26.3,25,15,12,8,5,12,16,75,4,42,29,13,16,41,93,2
1546,Soungoutou Magassa,fr FRA,MF,Monaco,fr Ligue 1,21.56986301,2003,10.7,43,24,13,25,5,24,43,55.8,19,16,3,13,21,64,19,1
1547,Edmond-Paris Maghoma,eng ENG,"MF,FW",Brentford,eng Premier League,23.9890411,2001,1.3,2,1,0,2,0,1,3,33.3,2,2,2,0,1,3,2,0
1548,Giangiacomo Magnani,it ITA,DF,Hellas Verona,it Serie A,29.58082192,1995,11.8,20,15,14,6,0,7,7,100,0,16,9,7,17,37,73,1
1549,Hugo Magnetti,fr FRA,MF,Brest,fr Ligue 1,26.92876712,1998,23.6,42,26,17,22,3,20,44,45.5,24,18,3,15,15,57,34,0
1550,Frank Magri,cm CMR,"FW,MF",Toulouse,fr Ligue 1,25.6630137,1999,15.1,6,1,1,4,1,3,8,37.5,5,16,2,14,4,10,9,0
1551,Harry Maguire,eng ENG,DF,Manchester Utd,eng Premier League,32.16438356,1993,16.5,26,13,20,5,1,13,17,76.5,4,14,12,2,37,63,71,1
1552,Jon Magunazelaia,es ESP,MF,Real Sociedad,es La Liga,24.80821918,2000,0.1,1,1,1,0,0,0,0,,0,0,0,0,0,1,0,0
1553,Arne Maier,de GER,MF,Augsburg,de Bundesliga,26.31780822,1999,9.4,12,6,4,8,0,7,12,58.3,5,15,1,14,4,16,12,1
1554,Mike Maignan,fr FRA,GK,Milan,it Serie A,29.83561644,1995,32.6,0,0,0,0,0,0,1,0,1,1,0,1,0,0,17,3
1555,Patrick Mainka,de GER,DF,Heidenheim,de Bundesliga,30.49041096,1994,32,56,28,34,20,2,34,53,64.2,19,57,32,25,66,122,199,0
1556,Kobbie Mainoo,eng ENG,MF,Manchester Utd,eng Premier League,20.04109589,2005,15.7,39,24,16,11,12,21,34,61.8,13,16,2,14,19,58,7,1
1557,Ainsley Maitland-Niles,eng ENG,DF,Lyon,fr Ligue 1,27.67945205,1997,19.1,62,39,26,23,13,43,67,64.2,24,27,4,23,24,86,49,6
1558,Radosław Majecki,pl POL,GK,Monaco,fr Ligue 1,25.4630137,1999,15,0,0,0,0,0,0,2,0,2,0,0,0,0,0,8,1
1559,Lovro Majer,hr CRO,MF,Wolfsburg,de Bundesliga,27.29315068,1998,2.1,0,0,0,0,0,0,3,0,3,2,0,2,0,0,2,0
1560,Hamidou Makalou,ml MLI,"FW,MF",Brest,fr Ligue 1,18.80273973,2006,0.2,0,0,0,0,0,0,0,,0,0,0,0,0,0,0,0
1561,Jordy Makengo,fr FRA,DF,Freiburg,de Bundesliga,23.75068493,2001,5.5,12,7,8,3,1,8,13,61.5,5,7,3,4,5,17,18,0
1562,Antoine Makoumbou,cg CGO,MF,Cagliari,it Serie A,26.79452055,1998,21.6,39,23,27,9,3,18,23,78.3,5,25,4,21,14,53,24,0
1563,Nikola Maksimović,rs SRB,DF,Montpellier,fr Ligue 1,33.43835616,1991,6.5,9,5,6,3,0,6,7,85.7,1,5,4,1,6,15,30,1
1564,Tyrell Malacia,nl NED,DF,Manchester Utd,eng Premier League,25.71232877,1999,1.1,2,1,2,0,0,1,2,50,1,0,0,0,1,3,1,1
1565,Jarzinho Malanga,de GER,DF,Stuttgart,de Bundesliga,18.81643836,2006,0,0,0,0,0,0,0,0,,0,0,0,0,0,0,0,0
1566,Julián Malatini,ar ARG,DF,Werder Bremen,de Bundesliga,23.9260274,2001,5,11,9,5,5,1,5,11,45.5,6,8,3,5,7,18,17,0
1567,Daniel Maldini,it ITA,"MF,FW",Monza,it Serie A,23.56164384,2001,14.5,14,6,5,9,0,6,13,46.2,7,8,2,6,4,18,12,2
1568,Daniel Maldini,it ITA,"FW,MF",Atalanta,it Serie A,23.56164384,2001,1.4,1,1,0,0,1,1,1,100,0,1,0,1,0,1,0,0
1569,Youssef Maleh,ma MAR,MF,Empoli,it Serie A,26.69863014,1998,16.8,45,23,17,23,5,17,34,50,17,25,6,19,16,61,25,0
1570,Donyell Malen,nl NED,FW,Aston Villa,eng Premier League,26.31506849,1999,3.3,7,4,3,3,1,1,4,25,3,1,0,1,0,7,1,0
1571,Donyell Malen,nl NED,"FW,MF",Dortmund,de Bundesliga,26.31506849,1999,6.8,0,0,0,0,0,0,2,0,2,2,0,2,3,3,6,0
1572,Ruslan Malinovskyi,ua UKR,"MF,FW",Genoa,it Serie A,32,1993,4.3,12,8,4,7,1,3,6,50,3,2,0,2,1,13,4,0
1573,Lennard Maloney,us USA,MF,Heidenheim,de Bundesliga,25.56986301,1999,8.4,20,11,12,7,1,14,23,60.9,9,9,2,7,14,34,38,0
1574,Lennard Maloney,us USA,MF,Mainz 05,de Bundesliga,25.56986301,1999,0.3,1,0,0,0,1,1,1,100,0,1,0,1,0,1,3,0
1575,Aaron Malouda,fr FRA,FW,Lille,fr Ligue 1,19.42465753,2005,0,0,0,0,0,0,0,0,,0,0,0,0,0,0,0,0
1576,Giorgi Mamardashvili,ge GEO,GK,Valencia,es La Liga,24.59452055,2000,30,2,2,2,0,0,2,3,66.7,1,0,0,0,1,3,13,3
1577,Dennis Man,ro ROU,"FW,MF",Parma,it Serie A,26.68767123,1998,22.2,13,6,7,3,3,6,24,25,18,15,3,12,8,21,11,0
1578,Hianga Mananga Mbock,fr FRA,MF,Brest,fr Ligue 1,25.34794521,1999,0.2,0,0,0,0,0,0,0,,0,0,0,0,1,1,0,0
1579,Gianluca Mancini,it ITA,DF,Roma,it Serie A,29.04657534,1996,30.9,37,23,20,15,2,17,30,56.7,13,19,13,6,34,71,85,0
1580,Steve Mandanda,fr FRA,GK,Rennes,fr Ligue 1,40.10136986,1985,16.5,0,0,0,0,0,0,1,0,1,0,0,0,0,0,6,2
1581,Christos Mandas,gr GRE,GK,Lazio,it Serie A,23.62739726,2001,5,0,0,0,0,0,0,0,,0,0,0,0,0,0,3,0
1582,Reinildo Mandava,mz MOZ,DF,Atlético Madrid,es La Liga,31.28219178,1994,10.5,18,11,10,7,1,10,18,55.6,8,11,5,6,16,34,35,0
1583,Aïssa Mandi,dz ALG,DF,Lille,fr Ligue 1,33.53150685,1991,17.3,27,16,8,15,4,13,19,68.4,6,22,10,12,14,41,47,0
1584,Rolando Mandragora,it ITA,MF,Fiorentina,it Serie A,27.84657534,1997,17.5,19,11,8,9,2,12,28,42.9,16,22,7,15,13,32,52,1
1585,Orel Mangala,be BEL,MF,Everton,eng Premier League,27.12876712,1998,14,16,8,3,11,2,5,8,62.5,3,8,3,5,21,37,24,1
1586,Orel Mangala,be BEL,MF,Lyon,fr Ligue 1,27.12876712,1998,0.7,1,0,0,0,1,0,1,0,1,2,0,2,0,1,1,0
1587,Ryan Manning,ie IRL,"DF,MF",Southampton,eng Premier League,28.88767123,1996,16.2,28,17,16,10,2,14,26,53.8,12,20,11,9,17,45,45,0
1588,Javier Manquillo,es ESP,DF,Celta Vigo,es La Liga,30.99726027,1994,5.7,7,5,4,3,0,2,10,20,8,5,3,2,7,14,14,0
1589,Johan Manzambi,ch SUI,"FW,MF",Freiburg,de Bundesliga,19.55342466,2005,1.6,5,1,0,2,3,0,3,0,3,4,0,4,0,5,4,0
1590,Alberto Manzoni,it ITA,MF,Atalanta,it Serie A,19.85753425,2005,0.1,0,0,0,0,0,0,0,,0,0,0,0,0,0,0,0
1591,Sekou Mara,fr FRA,"FW,MF",Strasbourg,fr Ligue 1,22.76164384,2002,7.2,9,6,0,5,4,3,9,33.3,6,9,0,9,3,12,2,0
1592,Alessandro Marcandalli,it ITA,DF,Genoa,it Serie A,22.60547945,2002,0.5,1,0,1,0,0,0,0,,0,0,0,0,0,1,2,0
1593,Alessandro Marcandalli,it ITA,DF,Venezia,it Serie A,22.60547945,2002,3.8,7,5,5,2,0,2,5,40,3,6,3,3,2,9,26,0
1594,Marcão,br BRA,DF,Sevilla,es La Liga,28.91232877,1996,5.1,9,6,6,3,0,2,3,66.7,1,9,6,3,6,15,27,1
1595,Solly March,eng ENG,"FW,MF",Brighton,eng Premier League,30.7890411,1994,1.9,6,3,2,2,2,5,8,62.5,3,3,0,3,2,8,2,1
1596,Filip Marchwiński,pl POL,MF,Lecce,it Serie A,23.31232877,2002,0.2,0,0,0,0,0,0,0,,0,0,0,0,0,0,0,0
1597,Óscar de Marcos,es ESP,DF,Athletic Club,es La Liga,36.05479452,1989,15.3,28,13,13,11,4,19,34,55.9,15,15,1,14,14,42,30,0
1598,Alberto Marí,es ESP,FW,Valencia,es La Liga,23.81369863,2001,0.1,0,0,0,0,0,0,0,,0,0,0,0,0,0,0,0
1599,Pablo Marí,es ESP,DF,Monza,it Serie A,31.6739726,1993,18.1,26,15,14,12,0,11,21,52.4,10,24,21,3,37,63,85,2
1600,Pablo Marí,es ESP,DF,Fiorentina,it Serie A,31.6739726,1993,8.2,7,3,6,1,0,3,6,50,3,12,8,4,18,25,75,0
1601,José María Giménez,uy URU,DF,Atlético Madrid,es La Liga,30.28493151,1995,20.2,22,14,15,7,0,16,27,59.3,11,26,16,10,25,47,104,2
1602,Luca Marianucci,it ITA,DF,Empoli,it Serie A,20.78082192,2004,9.4,22,9,14,8,0,9,15,60,6,14,8,6,18,40,53,1
1603,Mirko Marić,hr CRO,"FW,MF",Monza,it Serie A,29.96712329,1995,1.2,1,0,1,0,0,1,2,50,1,1,1,0,1,2,1,0
1604,Mirko Marić,hr CRO,FW,Venezia,it Serie A,29.96712329,1995,3.5,2,2,2,0,0,0,3,0,3,2,0,2,1,3,10,0
1605,Arkaitz Mariezkurrena,es ESP,"MF,FW",Real Sociedad,es La Liga,20.07945205,2005,1.2,1,0,1,0,0,0,3,0,3,1,0,1,1,2,3,0
1606,Rafa Marín,es ESP,DF,Napoli,it Serie A,22.95890411,2002,1.6,1,0,1,0,0,1,2,50,1,1,1,0,1,2,4,0
1607,Pablo Marín,es ESP,MF,Real Sociedad,es La Liga,21.83561644,2003,9.6,20,13,5,10,5,7,14,50,7,10,3,7,3,23,13,0
1608,Răzvan Marin,ro ROU,MF,Cagliari,it Serie A,28.94794521,1996,14.9,21,12,8,11,2,13,25,52,12,6,0,6,2,23,20,2
1609,Guillermo Maripán,cl CHI,DF,Torino,it Serie A,30.99452055,1994,23,35,20,21,13,1,19,31,61.3,12,25,12,13,38,73,130,1
1610,Mika Mármol,es ESP,DF,Las Palmas,es La Liga,23.84109589,2001,23.7,53,23,31,20,2,29,43,67.4,14,41,13,28,36,89,105,2
1611,Omar Marmoush,eg EGY,"FW,MF",Manchester City,eng Premier League,26.23561644,1999,11.1,11,6,2,7,2,7,15,46.7,8,15,1,14,5,16,3,0
1612,Omar Marmoush,eg EGY,FW,Eint Frankfurt,de Bundesliga,26.23561644,1999,16.1,12,8,0,3,9,3,7,42.9,4,7,1,6,2,14,2,0
1613,Mario Maroto,es ESP,MF,Valladolid,es La Liga,21.43013699,2003,0.2,0,0,0,0,0,0,1,0,1,0,0,0,2,2,1,0
1614,Marquinhos,br BRA,DF,Paris S-G,fr Ligue 1,30.97260274,1994,18.4,30,19,8,16,6,25,33,75.8,8,25,13,12,10,40,62,0
1615,Unai Marrero,es ESP,GK,Real Sociedad,es La Liga,23.56712329,2001,1,0,0,0,0,0,0,0,,0,0,0,0,0,0,1,0
1616,Ange Martial Tia,ml MLI,MF,Reims,fr Ligue 1,18.45205479,2006,0.9,3,2,1,2,0,1,4,25,3,3,0,3,1,4,3,0
1617,Aarón Martín,es ESP,DF,Genoa,it Serie A,28.03287671,1997,30.9,68,45,40,24,4,31,47,66,16,31,10,21,18,86,65,1
1618,Carlos Martín,es ESP,"FW,MF",Alavés,es La Liga,23.03287671,2002,14.5,39,20,15,16,8,13,49,26.5,36,30,1,29,5,44,18,0
1619,Gerard Martín,es ESP,DF,Barcelona,es La Liga,23.3369863,2002,9.8,20,9,8,7,5,10,15,66.7,5,15,2,13,8,28,25,0
1620,Iván Martín,es ESP,MF,Girona,es La Liga,26.21643836,1999,19.5,28,16,13,12,3,13,31,41.9,18,17,4,13,10,38,15,1
1621,Jon Martin,es ESP,DF,Real Sociedad,es La Liga,19.3369863,2006,7,8,6,5,2,1,6,9,66.7,3,10,7,3,6,14,52,0
1622,Jonas Martin,fr FRA,MF,Brest,fr Ligue 1,35.06849315,1990,5.4,12,6,9,2,1,5,10,50,5,4,1,3,7,19,12,1
1623,Mario Martín,es ESP,MF,Valladolid,es La Liga,21.16438356,2004,17.9,59,30,29,27,3,20,45,44.4,25,28,6,22,19,78,39,7
1624,Gabriel Martinelli,br BRA,"FW,MF",Arsenal,eng Premier League,23.87671233,2001,22.7,20,15,8,5,7,7,23,30.4,16,10,0,10,4,24,15,0
1625,Arnau Martinez,es ESP,"DF,MF",Girona,es La Liga,22.02465753,2003,24.7,38,19,24,9,5,26,53,49.1,27,13,5,8,24,62,63,2
1626,Emiliano Martínez,ar ARG,GK,Aston Villa,eng Premier League,32.66849315,1992,33,3,3,3,0,0,2,2,100,0,1,0,1,0,3,17,6
1627,Iñigo Martínez,es ESP,DF,Barcelona,es La Liga,33.96438356,1991,25.7,23,13,18,5,0,15,21,71.4,6,18,7,11,18,41,104,1
1628,Javi Martínez,es ESP,MF,Osasuna,es La Liga,25.36438356,1999,0.1,0,0,0,0,0,0,0,,0,0,0,0,0,0,0,0
1629,Josep Martinez,es ESP,GK,Inter,it Serie A,26.9369863,1998,4,0,0,0,0,0,0,0,,0,0,0,0,0,0,0,0
1630,Lautaro Martínez,ar ARG,FW,Inter,it Serie A,27.69863014,1997,28.5,30,16,10,12,8,13,25,52,12,21,3,18,10,40,15,0
1631,Lisandro Martínez,ar ARG,DF,Manchester Utd,eng Premier League,27.29041096,1998,19.5,40,24,25,12,3,21,36,58.3,15,22,8,14,32,72,57,1
1632,Lucas Martínez Quarta,ar ARG,DF,Fiorentina,it Serie A,28.98356164,1996,3.9,12,7,9,3,0,8,13,61.5,5,5,2,3,3,15,25,1
1633,Ramón Martínez,es ESP,DF,Sevilla,es La Liga,22.53150685,2002,1.1,2,1,1,1,0,0,0,,0,0,0,0,2,4,14,0
1634,Toni Martínez,es ESP,"FW,MF",Alavés,es La Liga,27.84383562,1997,10.1,11,6,4,4,3,3,4,75,1,7,2,5,0,11,11,0
1635,Kevin Martins,it ITA,"MF,DF",Monza,it Serie A,20.25479452,2005,2,5,4,3,2,0,3,6,50,3,1,0,1,1,6,4,1
1636,Javi Martón,es ESP,"FW,MF",Athletic Club,es La Liga,25.99452055,1999,0.6,0,0,0,0,0,0,0,,0,0,0,0,0,0,0,0
1637,Adam Marušić,me MNE,DF,Lazio,it Serie A,32.54520548,1992,23.3,29,19,16,11,2,16,28,57.1,12,16,7,9,14,43,56,0
1638,Marvin,es ESP,"DF,FW",Las Palmas,es La Liga,24.83561644,2000,9.1,21,10,10,7,4,9,22,40.9,13,15,5,10,9,30,25,0
1639,Omar Mascarell,gq EQG,MF,Mallorca,es La Liga,32.24931507,1993,18.7,24,13,11,12,1,12,28,42.9,16,27,18,9,45,69,49,2
1640,Adam Masina,ma MAR,DF,Torino,it Serie A,31.33424658,1994,18.5,32,15,22,9,1,22,37,59.5,15,25,15,10,24,56,83,2
1641,Patrizio Masini,it ITA,MF,Genoa,it Serie A,24.26575342,2001,13.1,43,23,16,19,8,13,27,48.1,14,21,7,14,12,55,34,0
1642,Giorgos Masouras,gr GRE,"FW,MF",Bochum,de Bundesliga,31.3369863,1994,9.9,16,8,5,6,5,7,14,50,7,9,1,8,3,19,1,1
1643,Erhan Mašović,rs SRB,DF,Bochum,de Bundesliga,26.44657534,1998,10.1,14,10,10,4,0,13,28,46.4,15,17,11,6,12,26,55,0
1644,Han-Noah Massengo,fr FRA,MF,Auxerre,fr Ligue 1,23.82465753,2001,8.7,13,8,5,5,3,6,8,75,2,9,3,6,14,27,8,2
1645,Clinton Mata,ao ANG,DF,Lyon,fr Ligue 1,32.48767123,1992,25.1,41,29,23,14,4,28,36,77.8,8,26,17,9,45,86,71,3
1646,Jaime Mata,es ESP,FW,Las Palmas,es La Liga,36.5260274,1988,5.9,6,1,1,5,0,3,9,33.3,6,4,1,3,3,9,9,0
1647,Igor Matanovic,hr CRO,FW,Eint Frankfurt,de Bundesliga,22.09315068,2003,3.5,2,0,0,2,0,0,1,0,1,3,0,3,1,3,9,0
1648,Pape Matar Sarr,sn SEN,MF,Tottenham,eng Premier League,22.63561644,2002,18.2,42,30,16,21,5,11,23,47.8,12,23,9,14,24,66,18,1
1649,Eliot Matazo,be BEL,MF,Monaco,fr Ligue 1,23.21369863,2002,0.8,3,2,0,3,0,0,0,,0,0,0,0,1,4,2,0
1650,Jean-Philippe Mateta,fr FRA,FW,Crystal Palace,eng Premier League,27.84931507,1997,27.1,17,12,4,11,2,3,16,18.8,13,16,3,13,2,19,22,0
1651,Nemanja Matić,rs SRB,MF,Lyon,fr Ligue 1,36.75616438,1988,20.6,38,29,12,20,6,21,38,55.3,17,19,8,11,14,52,30,1
1652,Rudy Matondo,fr FRA,MF,Auxerre,fr Ligue 1,17.14246575,2008,0.5,0,0,0,0,0,0,1,0,1,0,0,0,0,0,1,0
1653,Chrislain Matsima,fr FRA,DF,Augsburg,de Bundesliga,22.96986301,2002,25.3,26,18,15,10,1,16,24,66.7,8,45,27,18,48,74,150,0
1654,Jean Mattéo Bahoya,fr FRA,"MF,FW",Eint Frankfurt,de Bundesliga,19.99178082,2005,8.9,27,16,10,12,5,15,25,60,10,8,1,7,4,31,9,1
1655,Alan Matturro,uy URU,DF,Genoa,it Serie A,20.56164384,2004,10,11,6,6,5,0,3,14,21.4,11,10,3,7,14,25,38,0
1656,Azor Matusiwa,nl NED,MF,Rennes,fr Ligue 1,27.01643836,1998,21.4,63,38,31,30,2,32,42,76.2,10,25,9,16,34,97,49,0
1657,Neal Maupay,fr FRA,FW,Marseille,fr Ligue 1,28.72054795,1996,11.5,9,4,1,6,2,3,6,50,3,5,0,5,2,11,0,0
1658,Maurides,br BRA,FW,St. Pauli,de Bundesliga,31.15068493,1994,0,0,0,0,0,0,0,0,,0,0,0,0,0,0,0,0
1659,Stephy Mavididi,eng ENG,FW,Leicester City,eng Premier League,26.9260274,1998,17.9,34,19,16,10,8,14,42,33.3,28,26,2,24,11,45,15,0
1660,Konstantinos Mavropanos,gr GRE,DF,West Ham,eng Premier League,27.39452055,1997,21.6,32,22,22,9,1,14,25,56,11,23,17,6,38,70,117,1
1661,Christian Mawissa,fr FRA,DF,Monaco,fr Ligue 1,20.04383562,2005,15.6,39,27,26,11,2,26,43,60.5,17,22,5,17,25,64,41,1
1662,Keke Maximilian Topp,de GER,"FW,MF",Werder Bremen,de Bundesliga,21.10958904,2004,2.7,3,1,0,2,1,1,2,50,1,0,0,0,1,4,4,0
1663,Borja Mayoral,es ESP,FW,Getafe,es La Liga,28.07945205,1997,9.3,2,2,1,1,0,1,5,20,4,3,0,3,0,2,6,0
1664,Senny Mayulu,fr FRA,MF,Paris S-G,fr Ligue 1,18.96438356,2006,7.6,23,14,8,12,3,7,12,58.3,5,8,3,5,5,28,9,0
1665,Noussair Mazraoui,ma MAR,DF,Manchester Utd,eng Premier League,27.46849315,1997,29.3,102,60,53,36,13,51,85,60,34,33,8,25,34,136,88,1
1666,Luca Mazzitelli,it ITA,MF,Como,it Serie A,29.46575342,1995,3.7,9,6,4,5,0,5,7,71.4,2,5,2,3,3,12,10,0
1667,Pasquale Mazzocchi,it ITA,"DF,FW",Napoli,it Serie A,29.76986301,1995,7.7,15,7,7,5,3,8,15,53.3,7,5,2,3,5,20,24,0
1668,Samuel Mbangula,be BEL,FW,Juventus,it Serie A,21.29589041,2004,7.8,15,10,7,6,2,7,13,53.8,6,7,0,7,3,18,3,0
1669,Ethan Mbappé,fr FRA,"MF,FW",Lille,fr Ligue 1,18.34520548,2006,2.5,6,2,3,2,1,0,4,0,4,6,0,6,1,7,0,0
1670,Kylian Mbappé,fr FRA,FW,Real Madrid,es La Liga,26.36986301,1998,27.3,8,5,1,3,4,1,5,20,4,3,0,3,0,8,1,0
1671,Ibrahim Mbaye,fr FRA,FW,Paris S-G,fr Ligue 1,17.2739726,2008,2.8,3,2,1,1,1,2,7,28.6,5,1,0,1,2,5,2,0
1672,Bryan Mbeumo,cm CMR,FW,Brentford,eng Premier League,25.73972603,1999,33.9,44,29,17,14,13,17,30,56.7,13,22,3,19,14,58,46,1
1673,James Mcatee,eng ENG,"MF,FW",Manchester City,eng Premier League,22.54246575,2002,3.4,4,2,0,4,0,1,7,14.3,6,8,0,8,2,6,1,0
1674,Kasey McAteer,ie IRL,"FW,MF",Leicester City,eng Premier League,23.44657534,2001,6.8,14,11,7,4,3,9,21,42.9,12,13,1,12,3,17,11,0
1675,Oliver McBurnie,sct SCO,FW,Las Palmas,es La Liga,28.91506849,1996,17.4,13,7,5,6,2,5,11,45.5,6,14,5,9,5,18,21,0
1676,Alex McCarthy,eng ENG,GK,Southampton,eng Premier League,35.41643836,1989,5,0,0,0,0,0,0,0,,0,0,0,0,0,0,1,4
1677,John McGinn,sct SCO,"MF,FW",Aston Villa,eng Premier League,30.54246575,1994,22.8,31,22,10,13,8,11,27,40.7,16,21,2,19,14,45,16,3
1678,Scott McKenna,sct SCO,DF,Las Palmas,es La Liga,28.4739726,1996,25.4,18,12,13,5,0,9,12,75,3,34,26,8,9,27,146,2
1679,Weston McKennie,us USA,"MF,DF",Juventus,it Serie A,26.68219178,1998,22.6,30,12,16,10,4,13,22,59.1,9,27,8,19,12,42,32,0
1680,Mark McKenzie,us USA,DF,Toulouse,fr Ligue 1,26.18630137,1999,25.7,48,28,29,18,1,30,42,71.4,12,26,15,11,21,69,121,1
1681,Dwight McNeil,eng ENG,"MF,FW",Everton,eng Premier League,25.44657534,1999,14,11,6,5,4,2,8,19,42.1,11,7,0,7,5,16,2,1
1682,Scott McTominay,sct SCO,MF,Manchester Utd,eng Premier League,28.40273973,1996,0.2,0,0,0,0,0,0,1,0,1,0,0,0,0,0,1,0
1683,Scott McTominay,sct SCO,MF,Napoli,it Serie A,28.40273973,1996,29.6,40,23,12,25,3,18,36,50,18,19,4,15,23,63,47,0
1684,Jakov Medić,hr CRO,DF,Bochum,de Bundesliga,26.65479452,1998,16.9,13,11,9,3,1,8,18,44.4,10,29,19,10,21,34,102,4
1685,Facundo Medina,ar ARG,DF,Lens,fr Ligue 1,25.93424658,1999,25.3,40,25,19,17,4,21,34,61.8,13,30,10,20,30,70,54,0
1686,Ben Mee,eng ENG,DF,Brentford,eng Premier League,35.61643836,1989,2,2,2,0,2,0,1,1,100,0,3,3,0,4,6,7,0
1687,Jayden Meghoma,eng ENG,DF,Brentford,eng Premier League,18.84931507,2006,0.1,0,0,0,0,0,0,0,,0,0,0,0,0,0,0,0
1688,Henrik Meister,dk DEN,FW,Rennes,fr Ligue 1,21.46027397,2003,0.7,2,0,0,2,0,0,0,,0,4,0,4,1,3,0,0
1689,Bamo Meïté,ci CIV,DF,Montpellier,fr Ligue 1,23.41643836,2001,4.5,4,2,1,1,2,1,2,50,1,3,3,0,3,7,13,2
1690,Bamo Meïté,ci CIV,DF,Marseille,fr Ligue 1,23.41643836,2001,0.3,0,0,0,0,0,0,0,,0,0,0,0,0,0,1,0
1691,Mohamed Meité,fr FRA,FW,Rennes,fr Ligue 1,17.56164384,2007,6,2,0,0,2,0,1,1,100,0,1,0,1,0,2,5,0
1692,Mateo Mejía,es ESP,FW,Sevilla,es La Liga,22.09315068,2003,0.1,0,0,0,0,0,0,0,,0,0,0,0,0,0,0,0
1693,Farid El Melali,dz ALG,FW,Angers,fr Ligue 1,27.99726027,1997,20.4,27,15,15,6,6,12,31,38.7,19,18,1,17,15,42,12,1
1694,Filippo Melegoni,it ITA,"MF,FW",Genoa,it Serie A,26.20547945,1999,1,1,1,1,0,0,0,4,0,4,0,0,0,0,1,2,0
1695,Arthur Melo,br BRA,MF,Girona,es La Liga,28.7260274,1996,6.3,20,8,7,12,1,12,21,57.1,9,3,1,2,5,25,6,1
1696,Nuno Mendes,pt POR,DF,Paris S-G,fr Ligue 1,22.8739726,2002,17.6,29,18,14,12,3,22,37,59.5,15,25,8,17,17,46,35,2
1697,Brais Méndez,es ESP,MF,Real Sociedad,es La Liga,28.32054795,1997,14.8,19,12,5,10,4,8,22,36.4,14,12,1,11,7,26,16,1
1698,Antoine Mendy,sn SEN,DF,Nice,fr Ligue 1,20.9369863,2004,7.7,28,20,14,14,0,18,25,72,7,7,3,4,5,33,27,0
1699,Ferland Mendy,fr FRA,DF,Real Madrid,es La Liga,29.90410959,1995,11.2,17,14,7,6,4,9,12,75,3,11,4,7,9,26,8,1
1700,Nampalys Mendy,sn SEN,MF,Lens,fr Ligue 1,32.8630137,1992,3.5,9,6,3,4,2,4,10,40,6,6,2,4,4,13,3,0
1701,Gideon Mensah,gh GHA,DF,Auxerre,fr Ligue 1,26.79452055,1998,23.2,60,39,29,21,10,28,57,49.1,29,25,4,21,45,105,77,0
1702,Alex Meret,it ITA,GK,Napoli,it Serie A,28.11780822,1997,30.4,0,0,0,0,0,0,0,,0,1,0,1,0,0,16,0
1703,Mikel Merino,es ESP,"MF,FW",Arsenal,eng Premier League,28.86575342,1996,15.8,38,22,6,21,11,15,29,51.7,14,18,5,13,14,52,24,1
1704,Quentin Merlin,fr FRA,DF,Marseille,fr Ligue 1,22.96712329,2002,16.7,19,14,10,4,5,7,13,53.8,6,18,4,14,13,32,16,1
1705,Víctor Meseguer,es ESP,MF,Valladolid,es La Liga,25.90136986,1999,4.6,10,6,4,4,2,2,10,20,8,3,0,3,2,12,4,1
1706,Rafik Messali,fr FRA,DF,Toulouse,fr Ligue 1,22.01643836,2003,4.9,15,8,6,6,3,7,8,87.5,1,9,1,8,9,24,11,0
1707,Junior Messias,br BRA,"MF,FW",Genoa,it Serie A,33.97534247,1991,7.1,10,7,6,4,0,3,8,37.5,5,4,2,2,6,16,13,0
1708,Connor Metcalfe,au AUS,"MF,FW",St. Pauli,de Bundesliga,25.49315068,1999,3.9,2,0,1,1,0,0,5,0,5,4,0,4,3,5,5,0
1709,Karol Mets,ee EST,DF,St. Pauli,de Bundesliga,31.96712329,1993,10,13,8,6,7,0,4,7,57.1,3,9,3,6,12,25,60,0
1710,Thomas Meunier,be BEL,DF,Lille,fr Ligue 1,33.64109589,1991,18.4,51,36,31,14,6,32,47,68.1,15,18,6,12,30,81,54,0
1711,Alexander Meyer,de GER,GK,Dortmund,de Bundesliga,34.05753425,1991,2,0,0,0,0,0,0,0,,0,0,0,0,0,0,0,0
1712,Shumaira Mheuka,eng ENG,MF,Chelsea,eng Premier League,17.5369863,2007,0,0,0,0,0,0,0,0,,0,0,0,0,0,0,0,0
1713,Lucas Michal,fr FRA,"FW,MF",Monaco,fr Ligue 1,19.86849315,2005,1.1,5,3,3,2,0,2,4,50,2,2,0,2,1,6,2,0
1714,Florian Micheler,at AUT,MF,Hoffenheim,de Bundesliga,19.96438356,2005,0.4,0,0,0,0,0,0,2,0,2,0,0,0,0,0,0,0
1715,Miguel,es ESP,FW,Leganés,es La Liga,25.66575342,1999,18.6,16,7,6,4,6,4,14,28.6,10,14,4,10,4,20,23,1
1716,Valentin Mihaila,ro ROU,"FW,MF",Parma,it Serie A,25.24931507,2000,14.3,29,15,8,13,8,9,22,40.9,13,18,0,18,8,37,6,0
1717,Georges Mikautadze,ge GEO,FW,Lyon,fr Ligue 1,24.50684932,2000,14.8,6,5,1,2,3,3,9,33.3,6,11,0,11,4,10,5,0
1718,Igor Miladinović,rs SRB,"FW,MF",Saint-Étienne,fr Ligue 1,21.90410959,2003,0.3,0,0,0,0,0,0,0,,0,0,0,0,1,1,1,0
1719,Nikola Milenković,rs SRB,DF,Nott'ham Forest,eng Premier League,27.55890411,1997,33,43,26,30,11,2,21,27,77.8,6,39,23,16,24,67,178,1
1720,Lewis Miley,eng ENG,MF,Newcastle Utd,eng Premier League,19.00821918,2006,2.8,11,9,4,6,1,6,11,54.5,5,5,1,4,2,13,5,2
1721,Vanja Milinković-Savić,rs SRB,GK,Torino,it Serie A,28.2,1997,34,1,0,1,0,0,1,3,33.3,2,0,0,0,0,1,17,4
1722,Éder Militão,br BRA,DF,Real Madrid,es La Liga,27.29041096,1998,10.4,19,17,14,5,0,7,12,58.3,5,13,8,5,12,31,35,0
1723,Luis Milla,es ESP,MF,Getafe,es La Liga,30.57260274,1994,28.9,52,34,27,20,5,29,62,46.8,33,23,0,23,21,73,27,2
1724,Pere Milla,es ESP,"MF,FW",Espanyol,es La Liga,32.6109589,1992,3.5,4,1,3,0,1,0,14,0,14,9,2,7,2,6,4,0
1725,Enzo Millot,fr FRA,"MF,FW",Stuttgart,de Bundesliga,22.79726027,2002,19.1,26,12,10,13,3,9,30,30,21,26,0,26,11,37,6,1
1726,James Milner,eng ENG,MF,Brighton,eng Premier League,39.32876712,1986,1.9,5,2,1,3,1,3,3,100,0,4,2,2,2,7,2,1
1727,Kim Min-jae,kr KOR,DF,Bayern Munich,de Bundesliga,28.46575342,1996,25.4,35,20,18,13,4,11,21,52.4,10,23,10,13,37,72,91,4
1728,Yerry Mina,co COL,DF,Cagliari,it Serie A,30.6109589,1994,26.5,59,27,38,19,2,36,47,76.6,11,54,31,23,33,92,155,3
1729,Takumi Minamino,jp JPN,"MF,FW",Monaco,fr Ligue 1,30.29589041,1995,22.9,31,18,7,14,10,15,41,36.6,26,23,1,22,9,40,18,0
1730,Lucas Mincarelli,fr FRA,DF,Montpellier,fr Ligue 1,21.3260274,2004,4.9,9,8,3,5,1,4,9,44.4,5,3,2,1,6,15,17,0
1731,Tyrone Mings,eng ENG,DF,Aston Villa,eng Premier League,32.14246575,1993,11.7,6,5,5,1,0,2,2,100,0,13,11,2,7,13,58,1
1732,Óscar Mingueza,es ESP,"MF,DF",Celta Vigo,es La Liga,25.97534247,1999,25.6,31,18,16,10,5,22,57,38.6,35,27,4,23,20,51,37,3
1733,Kim Minsu,kr KOR,"MF,FW",Girona,es La Liga,19.28767123,2006,0.2,1,0,0,1,0,0,0,,0,0,0,0,0,1,0,0
1734,Yankuba Minteh,gm GAM,"FW,MF",Brighton,eng Premier League,20.78356164,2004,16.6,43,31,23,12,8,17,45,37.8,28,17,0,17,10,53,28,0
1735,Bojan Miovski,mk MKD,FW,Girona,es La Liga,25.86027397,1999,9.4,7,5,2,2,3,2,7,28.6,5,4,0,4,2,9,7,0
1736,Rafa Mir,es ESP,"FW,MF",Valencia,es La Liga,27.87671233,1997,6.6,10,6,6,4,0,2,8,25,6,3,0,3,4,14,8,0
1737,Juan Miranda,es ESP,DF,Bologna,it Serie A,25.28767123,2000,23.6,32,18,11,14,7,14,30,46.7,16,20,3,17,21,53,46,1
1738,Fabio Miretti,it ITA,"MF,FW",Genoa,it Serie A,21.75068493,2003,18.6,28,15,6,14,8,18,33,54.5,15,20,1,19,7,35,13,2
1739,Tyrick Mitchell,eng ENG,DF,Crystal Palace,eng Premier League,25.67123288,1999,31.7,85,52,53,25,7,21,41,51.2,20,62,12,50,14,99,97,2
1740,Kaoru Mitoma,jp JPN,"FW,MF",Brighton,eng Premier League,27.95616438,1997,28,43,26,14,13,16,18,46,39.1,28,46,3,43,13,56,10,0
1741,Maximilian Mittelstädt,de GER,DF,Stuttgart,de Bundesliga,28.12876712,1997,25.7,76,53,41,28,7,51,71,71.8,20,43,11,32,43,119,96,2
1742,Koji Miyoshi,jp JPN,"FW,MF",Bochum,de Bundesliga,28.10684932,1997,5,8,5,2,1,5,4,9,44.4,5,10,1,9,2,10,2,0
1743,Henrikh Mkhitaryan,am ARM,MF,Inter,it Serie A,36.28219178,1989,25.6,40,23,16,16,8,19,44,43.2,25,29,5,24,17,57,41,0
1744,Jakub Moder,pl POL,MF,Brighton,eng Premier League,26.0739726,1999,0.1,1,0,1,0,0,0,2,0,2,0,0,0,0,1,3,0
1745,Rui Modesto,ao ANG,"DF,MF",Udinese,it Serie A,25.57260274,1999,5.4,15,11,4,8,3,7,8,87.5,1,9,0,9,8,23,11,0
1746,Luka Modrić,hr CRO,MF,Real Madrid,es La Liga,39.64931507,1985,16.7,28,18,16,11,1,14,30,46.7,16,13,5,8,23,51,14,0
1747,Max Moerstedt,de GER,FW,Hoffenheim,de Bundesliga,0,,5,5,5,1,3,1,1,2,50,1,4,0,4,0,5,5,0
1748,Terem Moffi,ng NGA,FW,Nice,fr Ligue 1,25.94246575,1999,0.5,0,0,0,0,0,0,0,,0,0,0,0,0,0,0,0
1749,Mostafa Mohamed,eg EGY,FW,Nantes,fr Ligue 1,27.43013699,1997,12.6,17,9,5,8,4,4,12,33.3,8,10,2,8,10,27,25,0
1750,Johan Mojica,co COL,DF,Mallorca,es La Liga,32.70136986,1992,27.3,33,22,25,5,3,18,36,50,18,10,4,6,25,58,74,2
1751,David Mokwa,fr FRA,"DF,FW",Hoffenheim,de Bundesliga,21.00273973,2004,0.2,1,0,1,0,0,0,0,,0,0,0,0,0,1,0,0
1752,Alberto Moleiro,es ESP,"FW,MF",Las Palmas,es La Liga,21.59178082,2003,27.4,25,11,10,14,1,18,48,37.5,30,23,0,23,16,41,8,0
1753,Nahuel Molina,ar ARG,DF,Atlético Madrid,es La Liga,27.07671233,1998,16,40,17,19,20,1,29,52,55.8,23,16,3,13,11,51,49,0
1754,Florent Mollet,fr FRA,"MF,FW",Nantes,fr Ligue 1,33.45479452,1991,2.7,2,2,1,1,0,1,1,100,0,2,0,2,1,3,4,0
1755,Jon Moncayola,es ESP,MF,Osasuna,es La Liga,26.97534247,1998,22.9,68,40,28,32,8,30,59,50.8,29,34,3,31,11,79,19,0
1756,Jeremy Monga,,"FW,MF",Leicester City,eng Premier League,0,,0.6,1,1,0,1,0,1,1,100,0,3,2,1,0,1,1,0
1757,Gonzalo Montiel,ar ARG,"DF,MF",Sevilla,es La Liga,28.3369863,1997,1.3,4,2,3,1,0,3,4,75,1,0,0,0,2,6,11,0
1758,Lorenzo Montipò,it ITA,GK,Hellas Verona,it Serie A,29.2,1996,34,1,0,1,0,0,1,4,25,3,0,0,0,0,1,20,4
1759,Mikey Moore,eng ENG,"FW,MF",Tottenham,eng Premier League,17.72876712,2007,2.1,0,0,0,0,0,0,1,0,1,1,0,1,1,1,1,0
1760,Álvaro Morata,es ESP,"FW,MF",Milan,it Serie A,32.52876712,1992,12.2,16,10,5,8,3,5,8,62.5,3,7,2,5,5,21,5,0
1761,Morato,br BRA,DF,Nott'ham Forest,eng Premier League,23.84383562,2001,8.9,21,13,18,2,1,13,20,65,7,11,4,7,10,31,71,2
1762,Diego Moreira,pt POR,"DF,MF",Strasbourg,fr Ligue 1,20.74246575,2004,27,41,26,17,17,7,23,46,50,23,23,4,19,34,75,63,0
1763,Alberto Moreno,es ESP,DF,Como,it Serie A,32.83013699,1992,18.2,24,11,16,8,0,12,24,50,12,12,3,9,14,38,35,2
1764,Álex Moreno,es ESP,"DF,MF",Nott'ham Forest,eng Premier League,31.90410959,1993,10.6,25,18,20,5,0,15,39,38.5,24,11,5,6,15,40,43,0
1765,Gerard Moreno,es ESP,FW,Villarreal,es La Liga,33.0739726,1992,7.2,7,4,3,2,2,3,11,27.3,8,0,0,0,2,9,6,0
1766,Matias Moreno,ar ARG,DF,Fiorentina,it Serie A,21.60821918,2003,1.6,8,8,5,3,0,4,4,100,0,5,1,4,1,9,9,0
1767,Tete Morente,es ESP,"FW,MF",Lecce,it Serie A,28.41369863,1996,20.9,26,16,10,10,6,10,35,28.6,25,16,1,15,12,38,30,1
1768,Mateu Morey,es ESP,DF,Mallorca,es La Liga,25.17260274,2000,5.4,14,13,8,4,2,10,17,58.8,7,8,0,8,9,23,15,1
1769,Ilaix Moriba,gn GUI,MF,Celta Vigo,es La Liga,22.28767123,2003,19.3,55,33,17,26,12,26,45,57.8,19,22,4,18,12,67,26,1
1770,Manu Morlanes,es ESP,MF,Mallorca,es La Liga,26.30684932,1999,14.4,43,27,18,20,5,18,30,60,12,18,7,11,24,67,16,0
1771,Nikola Moro,hr CRO,MF,Bologna,it Serie A,27.14520548,1998,12.4,34,26,6,21,7,21,32,65.6,11,18,7,11,13,47,17,0
1772,Raúl Moro,es ESP,"MF,FW",Valladolid,es La Liga,22.4109589,2002,22.2,18,11,13,2,3,10,26,38.5,16,6,0,6,10,28,14,0
1773,Sam Morsy,eg EGY,MF,Ipswich Town,eng Premier League,33.64657534,1991,27.6,62,36,35,23,4,26,57,45.6,31,32,13,19,28,90,43,4
1774,Gabriel Moscardo,br BRA,"MF,DF",Reims,fr Ligue 1,19.59726027,2005,0.9,3,1,2,1,0,1,3,33.3,2,3,1,2,0,3,1,0
1775,Cristhian Mosquera,es ESP,DF,Valencia,es La Liga,20.85205479,2004,32.9,43,29,33,9,1,24,33,72.7,9,32,22,10,33,76,113,4
1776,Daniel Mosquera,co COL,FW,Hellas Verona,it Serie A,25.5369863,1999,14.3,10,7,3,4,3,1,13,7.7,12,11,1,10,2,12,9,0
1777,Yerson Mosquera,co COL,DF,Wolves,eng Premier League,24.00547945,2001,4.9,11,7,9,2,0,9,14,64.3,5,13,10,3,10,21,14,0
1778,Dany Mota,pt POR,"FW,MF",Monza,it Serie A,27.00547945,1998,22,13,3,2,3,8,4,8,50,4,18,1,17,9,22,26,3
1779,Yael Mouanga,fr FRA,DF,Montpellier,fr Ligue 1,19.78082192,2005,8.2,8,5,4,2,2,3,5,60,2,10,7,3,7,15,40,0
1780,Aimen Moueffek,fr FRA,MF,Saint-Étienne,fr Ligue 1,24.06849315,2001,10.4,19,11,3,11,5,10,22,45.5,12,17,5,12,3,22,24,1
1781,Youssoufa Moukoko,de GER,"FW,MF",Nice,fr Ligue 1,20.45205479,2004,2.3,3,2,2,1,0,1,2,50,1,2,0,2,0,3,0,0
1782,Steve Mounié,bj BEN,"FW,MF",Augsburg,de Bundesliga,30.59452055,1994,3.3,3,3,0,1,2,0,1,0,1,1,1,0,1,4,4,1
1783,Mason Mount,eng ENG,"MF,FW",Manchester Utd,eng Premier League,26.31232877,1999,4.2,8,2,4,4,0,6,8,75,2,7,1,6,2,10,0,0
1784,Santiago Mouriño,uy URU,DF,Alavés,es La Liga,23.21917808,2002,17.5,34,24,26,8,0,18,32,56.3,14,25,11,14,25,59,102,0
1785,Louis Mouton,fr FRA,MF,Saint-Étienne,fr Ligue 1,22.91780822,2002,11.5,44,24,13,21,10,19,34,55.9,15,16,3,13,10,54,19,0
1786,Divin Mubama,eng ENG,FW,Manchester City,eng Premier League,20.52328767,2004,0.3,0,0,0,0,0,0,0,,0,0,0,0,0,0,0,0
1787,Mykhailo Mudryk,ua UKR,FW,Chelsea,eng Premier League,24.3260274,2001,1.7,2,2,2,0,0,0,0,,0,3,1,2,0,2,1,0
1788,Ngal'Ayel Mukau,cd COD,MF,Lille,fr Ligue 1,20.42465753,2004,12.2,31,17,9,20,2,16,26,61.5,10,11,0,11,14,45,19,0
1789,Nordi Mukiele,fr FRA,DF,Leverkusen,de Bundesliga,27.50410959,1997,10,20,16,8,8,4,12,18,66.7,6,10,0,10,16,36,37,2
1790,Florian Müller,de GER,GK,Freiburg,de Bundesliga,27.47123288,1997,7.4,0,0,0,0,0,0,0,,0,0,0,0,0,0,3,0
1791,Kevin Müller,de GER,GK,Heidenheim,de Bundesliga,34.1369863,1991,31.7,3,2,3,0,0,3,3,100,0,0,0,0,0,3,12,4
1792,Marius Müller,de GER,GK,Wolfsburg,de Bundesliga,31.8109589,1993,5.3,0,0,0,0,0,0,0,,0,0,0,0,0,0,0,0
1793,Thomas Müller,de GER,"MF,FW",Bayern Munich,de Bundesliga,35.63835616,1989,12,7,4,2,3,2,3,14,21.4,11,9,0,9,2,9,12,0
1794,Abdul Mumin,gh GHA,DF,Rayo Vallecano,es La Liga,26.90958904,1998,22.4,37,25,30,7,0,17,27,63,10,40,29,11,23,60,125,0
1795,Marshall Munetsi,zw ZIM,"MF,FW",Wolves,eng Premier League,28.86575342,1996,9.8,21,10,6,9,6,12,20,60,8,12,1,11,6,27,15,0
1796,Marshall Munetsi,zw ZIM,MF,Reims,fr Ligue 1,28.86575342,1996,18.8,36,18,22,9,5,22,38,57.9,16,27,3,24,17,53,35,0
1797,Rodrigo Muniz,br BRA,FW,Fulham,eng Premier League,24,2001,10.7,10,5,3,5,2,4,4,100,0,9,2,7,5,15,14,0
1798,Aihen Muñoz,es ESP,DF,Real Sociedad,es La Liga,27.71506849,1997,9.3,21,11,12,8,1,12,24,50,12,10,6,4,11,32,42,0
1799,Álex Muñoz,es ESP,DF,Las Palmas,es La Liga,30.76164384,1994,15.2,38,29,22,15,1,20,37,54.1,17,28,11,17,16,54,68,0
1800,Daniel Muñoz,co COL,DF,Crystal Palace,eng Premier League,28.93972603,1996,31.9,109,70,52,34,23,49,86,57,37,35,3,32,39,148,97,1
1801,Iker Muñoz,es ESP,MF,Osasuna,es La Liga,22.49315068,2002,5.6,5,2,3,2,0,3,8,37.5,5,7,1,6,4,9,10,1
1802,Javier Muñoz,es ESP,"MF,DF",Las Palmas,es La Liga,30.17808219,1995,27.8,43,34,18,15,10,15,43,34.9,28,24,4,20,29,72,36,3
1803,Arijanet Muric,xk KVX,GK,Ipswich Town,eng Premier League,26.48767123,1998,18,0,0,0,0,0,0,2,0,2,0,0,0,0,0,10,5
1804,Murillo,br BRA,DF,Nott'ham Forest,eng Premier League,22.83287671,2002,32.5,52,36,37,12,3,26,45,57.8,19,66,43,23,30,82,225,3
1805,Vedat Muriqi,xk KVX,FW,Mallorca,es La Liga,31.02739726,1994,19.4,6,4,3,2,1,3,6,50,3,5,1,4,7,13,33,0
1806,Jacob Murphy,eng ENG,FW,Newcastle Utd,eng Premier League,30.1890411,1995,23.2,22,15,7,9,6,16,30,53.3,14,31,0,31,11,33,25,1
1807,Bob Murphy Omoregbe,it ITA,MF,Milan,it Serie A,21.49315068,2003,0,0,0,0,0,0,0,0,,0,0,0,0,0,0,0,0
1808,Yunus Musah,us USA,"MF,FW",Milan,it Serie A,22.42739726,2002,15.7,24,17,10,9,5,9,14,64.3,5,8,1,7,7,31,8,3
1809,Jamal Musiala,de GER,MF,Bayern Munich,de Bundesliga,22.18356164,2003,20,36,21,7,16,13,12,29,41.4,17,30,0,30,8,44,5,1
1810,Florent Muslija,xk KVX,"FW,MF",Freiburg,de Bundesliga,26.82739726,1998,1.9,5,4,3,1,1,2,2,100,0,0,0,0,1,6,1,0
1811,Almoatasem Al Musrati,ly LBY,MF,Monaco,fr Ligue 1,29.07671233,1996,4.3,14,11,5,8,1,7,11,63.6,4,3,1,2,5,19,9,0
1812,Juan Musso,ar ARG,GK,Atalanta,it Serie A,30.99452055,1994,1,0,0,0,0,0,0,0,,0,0,0,0,0,0,0,0
1813,Juan Musso,ar ARG,GK,Atlético Madrid,es La Liga,30.99452055,1994,1,0,0,0,0,0,0,0,,0,0,0,0,0,0,0,0
1814,Kingstone Mutandwa,zm ZAM,"MF,FW",Cagliari,it Serie A,22.3260274,2003,1,0,0,0,0,0,0,0,,0,0,0,0,0,0,0,0
1815,Junior Mwanga,fr FRA,MF,Le Havre,fr Ligue 1,21.98082192,2003,8.6,24,14,9,12,3,11,17,64.7,6,8,2,6,7,31,16,1
1816,Junior Mwanga,fr FRA,MF,Strasbourg,fr Ligue 1,21.98082192,2003,3.3,17,9,9,7,1,5,9,55.6,4,2,0,2,2,19,2,0
1817,Phillipp Mwene,at AUT,DF,Mainz 05,de Bundesliga,31.26027397,1994,26.5,43,24,18,20,5,15,41,36.6,26,27,6,21,22,65,50,1
1818,Vitaliy Mykolenko,ua UKR,DF,Everton,eng Premier League,25.93150685,1999,31.2,55,33,33,14,8,26,51,51,25,24,9,15,37,92,135,1
1819,Joakim Mæhle,dk DEN,DF,Wolfsburg,de Bundesliga,27.95616438,1997,22.3,32,14,24,6,2,16,43,37.2,27,24,3,21,22,54,47,1
1820,Obite N'Dicka,ci CIV,DF,Roma,it Serie A,25.70410959,1999,34,29,23,14,15,0,11,17,64.7,6,41,27,14,32,61,138,1
1821,Konan N'dri,ci CIV,"FW,MF",Lecce,it Serie A,24.51780822,2000,2.3,2,2,0,0,2,2,3,66.7,1,2,0,2,1,3,0,0
1822,Loïc N'Gatta,fr FRA,DF,Auxerre,fr Ligue 1,21.39452055,2003,0.1,1,1,0,1,0,1,2,50,1,1,0,1,0,1,1,0
1823,Nathan N'Goumou,cm CMR,FW,Gladbach,de Bundesliga,25.13972603,2000,9.2,17,11,11,4,2,6,11,54.5,5,8,2,6,4,21,16,0
1824,Djylian N'Guessan,fr FRA,FW,Saint-Étienne,fr Ligue 1,16.67671233,2008,1.9,5,3,4,1,0,1,4,25,3,1,0,1,0,5,1,0
1825,Stanley N'Soki,fr FRA,DF,Hoffenheim,de Bundesliga,26.06849315,1999,14.5,22,16,13,7,2,12,23,52.2,11,22,7,15,26,48,58,3
1826,Mickael Nade,fr FRA,DF,Saint-Étienne,fr Ligue 1,26.16712329,1999,22.6,50,36,32,18,0,21,28,75,7,32,15,17,32,82,122,8
1827,Bilal Nadir,ma MAR,MF,Marseille,fr Ligue 1,21.43013699,2003,4,10,3,4,6,0,4,6,66.7,2,6,1,5,2,12,7,0
1828,Mahamadou Nagida,cm CMR,DF,Rennes,fr Ligue 1,19.84931507,2005,4.8,8,6,4,3,1,4,5,80,1,3,0,3,9,17,6,0
1829,Keito Nakamura,jp JPN,"FW,MF",Reims,fr Ligue 1,24.76712329,2000,28.4,23,16,7,9,7,11,31,35.5,20,21,1,20,13,36,19,0
1830,Sebastian Nanasi,se SWE,"MF,FW",Strasbourg,fr Ligue 1,22.96712329,2002,22.1,20,13,6,12,2,8,21,38.1,13,23,3,20,7,27,18,0
1831,Yael Nandjou,fr FRA,DF,Nice,fr Ligue 1,19.82739726,2005,1.7,4,1,2,1,1,4,8,50,4,4,1,3,4,8,7,0
1832,Matija Nastasić,rs SRB,DF,Leganés,es La Liga,32.10136986,1993,22.6,24,11,21,3,0,16,24,66.7,8,39,30,9,19,43,155,0
1833,Natan,br BRA,DF,Betis,es La Liga,24.23835616,2001,19.2,30,21,21,7,2,22,25,88,3,20,12,8,21,51,97,1
1834,Pau Navarro,es ESP,DF,Villarreal,es La Liga,20.02465753,2005,7.2,19,14,11,6,2,16,28,57.1,12,11,5,6,3,22,30,0
1835,Roberto Navarro,es ESP,"MF,FW",Mallorca,es La Liga,23.06027397,2002,14.2,29,22,14,11,4,9,19,47.4,10,18,0,18,19,48,12,0
1836,Jesús Navas,es ESP,"FW,MF",Sevilla,es La Liga,39.44931507,1985,4.7,5,2,3,0,2,0,3,0,3,1,0,1,4,9,6,0
1837,Michel Ndary Adopo,fr FRA,MF,Cagliari,it Serie A,24.79178082,2000,24,52,31,15,29,8,14,26,53.8,12,18,5,13,25,77,22,0
1838,Youssouf Ndayishimiye,bi BDI,DF,Nice,fr Ligue 1,26.51780822,1998,21.5,40,21,25,14,1,16,27,59.3,11,35,19,16,21,61,117,4
1839,Iliman Ndiaye,sn SEN,FW,Everton,eng Premier League,25.16164384,2000,25,48,25,18,15,15,19,45,42.2,26,27,5,22,17,65,24,1
1840,Junior Ndiaye,fr FRA,FW,Montpellier,fr Ligue 1,20.09863014,2005,2.9,1,0,1,0,0,0,1,0,1,1,1,0,0,1,2,0
1841,Rassoul Ndiaye,sn SEN,MF,Le Havre,fr Ligue 1,23.39452055,2001,11.8,35,25,19,12,4,11,25,44,14,15,4,11,12,47,24,0
1842,Wilfred Ndidi,ng NGA,MF,Leicester City,eng Premier League,28.38082192,1996,23.9,81,50,45,29,7,27,54,50,27,47,19,28,26,107,72,0
1843,Wilfried Ndollo,cm CMR,DF,Montpellier,fr Ligue 1,19.80821918,2005,3,4,3,2,1,1,3,4,75,1,5,1,4,3,7,9,0
1844,Tanguy Ndombele,fr FRA,MF,Nice,fr Ligue 1,28.34794521,1996,12.6,35,23,10,21,4,12,20,60,8,9,0,9,14,49,9,0
1845,Cher Ndour,it ITA,MF,Fiorentina,it Serie A,20.76986301,2004,2.8,3,0,2,1,0,1,6,16.7,5,4,1,3,2,5,4,1
1846,Dan Ndoye,ch SUI,FW,Bologna,it Serie A,24.52328767,2000,21.8,22,16,8,6,8,13,23,56.5,10,19,0,19,8,30,4,0
1847,Paul Nebel,de GER,MF,Mainz 05,de Bundesliga,22.56438356,2002,23.1,33,21,9,15,9,11,32,34.4,21,45,4,41,11,44,30,2
1848,Kosta Nedeljković,rs SRB,DF,Aston Villa,eng Premier League,19.38082192,2005,1.4,7,5,1,3,3,2,3,66.7,1,1,0,1,0,7,3,0
1849,Kosta Nedeljković,rs SRB,DF,RB Leipzig,de Bundesliga,19.38082192,2005,4.3,10,7,4,6,0,5,9,55.6,4,4,2,2,1,11,12,0
1850,Loïc Nego,hu HUN,"DF,FW",Le Havre,fr Ligue 1,34.29863014,1991,24.3,51,29,31,15,5,35,52,67.3,17,17,3,14,28,79,76,0
1851,Ivan Nekić,hr CRO,DF,Holstein Kiel,de Bundesliga,24.35890411,2000,0.8,1,1,1,0,0,1,2,50,1,1,0,1,3,4,2,0
1852,Reiss Nelson,eng ENG,FW,Arsenal,eng Premier League,25.39726027,1999,0,1,0,0,1,0,0,1,0,1,0,0,0,0,1,1,0
1853,Reiss Nelson,eng ENG,FW,Fulham,eng Premier League,25.39726027,1999,5.4,8,6,3,3,2,5,13,38.5,8,11,0,11,5,13,2,0
1854,Victor Nelsson,dk DEN,DF,Roma,it Serie A,26.55342466,1998,2.1,5,4,3,1,1,3,5,60,2,1,0,1,2,7,9,0
1855,David Nemeth,at AUT,DF,St. Pauli,de Bundesliga,24.12876712,2001,21.7,42,28,25,15,2,25,41,61,16,27,11,16,16,58,89,2
1856,David Neres,br BRA,FW,Napoli,it Serie A,28.16986301,1997,13.6,18,10,7,4,7,8,13,61.5,5,6,0,6,7,25,4,0
1857,Neto,br BRA,GK,Bournemouth,eng Premier League,35.79178082,1989,2,0,0,0,0,0,0,0,,0,0,0,0,0,0,1,1
1858,Pedro Neto,pt POR,FW,Chelsea,eng Premier League,25.15342466,2000,21.4,21,9,9,8,4,7,18,38.9,11,12,2,10,8,29,5,0
1859,Luca Netz,de GER,DF,Gladbach,de Bundesliga,21.96986301,2003,10.8,24,14,14,8,2,13,19,68.4,6,17,4,13,10,34,36,0
1860,Manuel Neuer,de GER,GK,Bayern Munich,de Bundesliga,39.10410959,1986,20,1,0,1,0,0,1,1,100,0,0,0,0,0,1,8,1
1861,Florian Neuhaus,de GER,MF,Gladbach,de Bundesliga,28.13424658,1997,4.1,10,3,7,3,0,7,17,41.2,10,9,2,7,6,16,5,1
1862,João Neves,pt POR,"MF,DF",Paris S-G,fr Ligue 1,20.6,2004,19.8,61,31,19,26,16,26,42,61.9,16,29,9,20,21,82,22,1
1863,Yvan Neyou,cm CMR,MF,Leganés,es La Liga,28.33150685,1997,24,53,33,21,26,6,22,44,50,22,33,5,28,25,78,37,1
1864,Cyril Ngonge,be BEL,FW,Napoli,it Serie A,24.93972603,2000,2.2,8,5,4,4,0,4,6,66.7,2,3,0,3,1,9,4,0
1865,Mikayil Ngor Faye,sn SEN,DF,Rennes,fr Ligue 1,20.80547945,2004,7.6,15,12,10,3,2,7,9,77.8,2,9,4,5,12,27,30,0
1866,Steve Ngoura,fr FRA,FW,Le Havre,fr Ligue 1,20.19452055,2005,3.2,4,2,1,1,2,3,3,100,0,2,1,1,0,4,2,0
1867,Bernard Nguene,cm CMR,FW,Nice,fr Ligue 1,18.74794521,2006,0.1,0,0,0,0,0,0,0,,0,0,0,0,0,0,0,0
1868,Moussa Niakhate,sn SEN,DF,Lyon,fr Ligue 1,29.15616438,1996,27.3,41,23,34,6,1,20,27,74.1,7,21,13,8,22,63,129,3
1869,Abdoulaye Niakhate Ndiaye,sn SEN,DF,Brest,fr Ligue 1,23.06575342,2002,16,38,26,27,11,0,19,29,65.5,10,24,14,10,8,46,122,1
1870,Ibrahima Niane,sn SEN,FW,Angers,fr Ligue 1,26.14794521,1999,10.5,7,3,3,2,2,3,3,100,0,6,1,5,2,9,6,2
1871,Tanguy Nianzou,fr FRA,DF,Sevilla,es La Liga,22.90684932,2002,5.8,7,5,6,0,1,5,6,83.3,1,1,0,1,8,15,27,0
1872,Rasmus Nicolaisen,dk DEN,DF,Toulouse,fr Ligue 1,28.13424658,1997,6.9,6,3,4,2,0,3,5,60,2,10,5,5,10,16,25,0
1873,Moritz Nicolas,de GER,GK,Gladbach,de Bundesliga,27.53424658,1997,18.2,0,0,0,0,0,0,0,,0,1,0,1,1,1,8,1
1874,Hans Nicolussi Caviglia,it ITA,MF,Venezia,it Serie A,24.87671233,2000,28.8,43,26,14,21,8,28,62,45.2,34,37,11,26,27,70,53,2
1875,Julian Niehues,de GER,MF,Heidenheim,de Bundesliga,24.04657534,2001,1.2,1,0,1,0,0,1,5,20,4,1,0,1,0,1,6,0
1876,Oliver Nielsen,dk DEN,DF,Lazio,it Serie A,21.91506849,2003,0.3,0,0,0,0,0,0,0,,0,1,0,1,0,0,1,0
1877,Saúl Ñíguez,es ESP,MF,Sevilla,es La Liga,30.44931507,1994,15.6,41,28,14,20,7,11,28,39.3,17,24,2,22,19,60,29,0
1878,Eybi Nije,se SWE,"FW,MF",Torino,it Serie A,19.97260274,2005,4.4,5,1,3,1,1,0,3,0,3,5,1,4,0,5,1,0
1879,Tamás Nikitscher,hu HUN,MF,Valladolid,es La Liga,25.49863014,1999,6.3,14,6,8,6,0,7,10,70,3,10,2,8,9,23,9,0
1880,Adrian Niño,es ESP,FW,Atlético Madrid,es La Liga,20.8739726,2004,0.1,0,0,0,0,0,0,0,,0,0,0,0,0,0,0,0
1881,Justin Njinmah,de GER,"FW,MF",Werder Bremen,de Bundesliga,24.46575342,2000,10.3,5,2,1,3,1,3,5,60,2,5,0,5,3,8,1,0
1882,Eddie Nketiah,eng ENG,"FW,MF",Crystal Palace,eng Premier League,25.92876712,1999,9.8,12,5,6,2,4,5,11,45.5,6,10,1,9,2,14,11,0
1883,Niels Nkounkou,fr FRA,"DF,MF",Eint Frankfurt,de Bundesliga,24.50410959,2000,4.2,13,10,7,3,3,4,7,57.1,3,5,2,3,7,20,14,0
1884,Christopher Nkunku,fr FRA,FW,Chelsea,eng Premier League,27.46849315,1997,10.2,12,8,3,4,5,6,8,75,2,9,2,7,7,19,10,0
1885,Felix Nmecha,de GER,MF,Dortmund,de Bundesliga,24.56438356,2000,15.4,34,22,6,19,9,12,22,54.5,10,20,5,15,22,56,28,1
1886,Lukas Nmecha,de GER,"FW,MF",Wolfsburg,de Bundesliga,26.38630137,1998,4.2,2,0,1,1,0,0,1,0,1,1,0,1,2,4,3,0
1887,Arnaud Nordin,fr FRA,FW,Montpellier,fr Ligue 1,26.87945205,1998,13,24,15,6,16,2,11,21,52.4,10,12,0,12,5,29,7,0
1888,Arnaud Nordin,fr FRA,"DF,MF",Mainz 05,de Bundesliga,26.87945205,1998,0.9,2,0,0,2,0,1,1,100,0,2,1,1,0,2,2,0
1889,Brooke Norton-Cuffy,eng ENG,"DF,MF",Genoa,it Serie A,21.30684932,2004,4.1,9,6,6,3,0,6,7,85.7,1,4,0,4,3,12,9,0
1890,Tijjani Noslin,nl NED,"FW,MF",Lazio,it Serie A,25.82465753,1999,9.4,6,5,2,1,3,1,8,12.5,7,15,1,14,1,7,7,0
1891,Hugo Novoa,es ESP,"DF,MF",Alavés,es La Liga,22.3369863,2003,2.6,8,5,4,3,1,5,5,100,0,2,1,1,0,8,6,0
1892,Plamedi Nsingi,,MF,Nantes,fr Ligue 1,24.37808219,2000,0.2,1,0,1,0,0,0,1,0,1,0,0,0,0,1,0,0
1893,Randy Nteka,ao ANG,FW,Rayo Vallecano,es La Liga,27.40821918,1997,12.5,16,5,3,9,4,5,12,41.7,7,13,2,11,4,20,20,0
1894,Ernest Nuamah,gh GHA,"FW,MF",Lyon,fr Ligue 1,21.50410959,2003,11.7,21,11,15,4,2,12,27,44.4,15,9,1,8,8,29,8,1
1895,Alexander Nübel,de GER,GK,Stuttgart,de Bundesliga,28.59178082,1996,32,0,0,0,0,0,0,1,0,1,0,0,0,0,0,17,3
1896,Gustavo Nunes,br BRA,"MF,FW",Brentford,eng Premier League,19.45205479,2005,0,0,0,0,0,0,0,0,,0,0,0,0,0,0,1,0
1897,Matheus Nunes,pt POR,"DF,MF",Manchester City,eng Premier League,26.68493151,1998,16.6,32,21,13,13,6,15,34,44.1,19,14,3,11,13,45,35,1
1898,Darwin Núñez,uy URU,FW,Liverpool,eng Premier League,25.86027397,1999,11.3,18,15,10,3,5,5,15,33.3,10,6,0,6,3,21,12,0
1899,Unai Núñez,es ESP,DF,Athletic Club,es La Liga,28.25753425,1997,6.5,9,4,6,3,0,3,6,50,3,4,4,0,17,26,42,1
1900,Antonio Nusa,no NOR,"MF,DF",RB Leipzig,de Bundesliga,20.04657534,2005,16.2,30,17,16,9,5,18,36,50,18,21,2,19,8,38,11,0
1901,Ethan Nwaneri,eng ENG,"FW,MF",Arsenal,eng Premier League,18.12054795,2007,9.1,11,7,4,4,3,7,18,38.9,11,8,2,6,2,13,4,1
1902,Ørjan Nyland,no NOR,GK,Sevilla,es La Liga,34.64657534,1990,25.7,3,2,3,0,0,3,4,75,1,0,0,0,0,3,11,3
1903,Allan Nyom,cm CMR,"DF,MF",Getafe,es La Liga,36.98356164,1988,7.7,13,7,5,7,1,10,12,83.3,2,4,2,2,2,15,18,0
1904,Rabby Nzingoula,cg CGO,MF,Montpellier,fr Ligue 1,19.43835616,2005,16.3,57,35,20,30,7,24,52,46.2,28,22,4,18,25,82,22,0
1905,M'Bala Nzola,ao ANG,FW,Lens,fr Ligue 1,28.70958904,1996,16.2,5,4,0,1,4,3,9,33.3,6,9,1,8,5,10,7,0
1906,Marwann Nzuzi,fr FRA,DF,Saint-Étienne,fr Ligue 1,20.96712329,2004,1.4,2,2,1,0,1,1,2,50,1,0,0,0,2,4,6,0
1907,Christian Nørgaard,dk DEN,MF,Brentford,eng Premier League,31.15068493,1994,27.3,73,45,32,34,7,42,68,61.8,26,48,18,30,43,116,63,1
1908,Jake O'Brien,ie IRL,DF,Everton,eng Premier League,23.96986301,2001,15.5,24,16,19,5,0,16,24,66.7,8,16,4,12,4,28,80,0
1909,Matt O'Riley,dk DEN,MF,Brighton,eng Premier League,24.44931507,2000,8.4,15,9,4,8,3,4,12,33.3,8,6,3,3,12,27,7,1
1910,Dara O'Shea,ie IRL,DF,Ipswich Town,eng Premier League,26.16712329,1999,31.7,47,30,33,11,3,20,31,64.5,11,59,47,12,31,78,204,4
1911,Adam Obert,sk SVK,DF,Cagliari,it Serie A,22.69589041,2002,10.8,30,17,12,17,1,15,26,57.7,11,18,7,11,19,49,46,2
1912,Chidozie Obi-Martin,dk DEN,FW,Manchester Utd,eng Premier League,17.42739726,2007,0.7,2,1,0,0,2,2,2,100,0,0,0,0,0,2,1,0
1913,Jan Oblak,si SVN,GK,Atlético Madrid,es La Liga,32.32054795,1993,33,0,0,0,0,0,0,0,,0,0,0,0,0,0,15,2
1914,Lucas Ocampos,ar ARG,FW,Sevilla,es La Liga,30.81369863,1994,1.9,3,2,2,0,1,1,2,50,1,2,0,2,0,3,2,0
1915,Jens Odgaard,dk DEN,"MF,FW",Bologna,it Serie A,26.09315068,1999,20.8,20,14,3,12,5,6,21,28.6,15,18,2,16,9,29,11,1
1916,Wilson Odobert,fr FRA,FW,Tottenham,eng Premier League,20.43013699,2004,6,8,2,3,3,2,5,10,50,5,4,0,4,3,11,2,1
1917,David Odogu,de GER,DF,Wolfsburg,de Bundesliga,18.91780822,2006,2.2,6,4,4,2,0,3,5,60,2,2,2,0,2,8,25,1
1918,Álvaro Odriozola,es ESP,DF,Real Sociedad,es La Liga,29.38630137,1995,0.5,1,1,1,0,0,0,0,,0,0,0,0,0,1,1,0
1919,Tim Oermann,de GER,DF,Bochum,de Bundesliga,21.57534247,2003,22.8,44,26,21,19,4,23,40,57.5,17,30,14,16,20,64,61,0
1920,Chiedozie Ogbene,ie IRL,FW,Ipswich Town,eng Premier League,28.00821918,1997,2.6,7,3,1,2,4,2,4,50,2,1,0,1,1,8,3,0
1921,Ifechukwu Ogbus,ch SUI,DF,Freiburg,de Bundesliga,19.37808219,2005,0.2,1,1,0,0,1,0,1,0,1,0,0,0,1,2,2,0
1922,Thiago Ojeda,ar ARG,MF,Villarreal,es La Liga,22.30684932,2003,0.1,0,0,0,0,0,0,0,,0,0,0,0,0,0,1,0
1923,Hamzat Ojediran,ng NGA,"MF,FW",Lens,fr Ligue 1,21.46849315,2003,4.4,27,15,11,13,3,6,18,33.3,12,10,2,8,10,37,7,0
1924,Noah Okafor,ch SUI,"FW,MF",Napoli,it Serie A,24.94520548,2000,0.4,3,2,3,0,0,2,2,100,0,0,0,0,0,3,1,0
1925,Noah Okafor,ch SUI,FW,Milan,it Serie A,24.94520548,2000,4.6,2,1,0,0,2,0,1,0,1,1,0,1,2,4,1,0
1926,Caleb Okoli,it ITA,DF,Leicester City,eng Premier League,23.80821918,2001,12.5,25,14,8,15,2,11,18,61.1,7,24,14,10,15,40,79,3
1927,Yllan Okou,fr FRA,DF,Hellas Verona,it Serie A,22.36164384,2002,0,0,0,0,0,0,0,0,,0,1,0,1,0,0,0,0
1928,Maduka Okoye,ng NGA,GK,Udinese,it Serie A,25.68219178,1999,22,0,0,0,0,0,0,0,,0,0,0,0,0,0,11,1
1929,Joseph Okumu,ke KEN,DF,Reims,fr Ligue 1,27.93972603,1997,17.3,28,14,19,9,0,14,23,60.9,9,27,17,10,22,50,116,2
1930,Kazeem Olaigbe,be BEL,"MF,FW",Rennes,fr Ligue 1,22.33424658,2003,3.1,6,4,3,3,0,3,6,50,3,2,0,2,0,6,0,0
1931,Olasagasti,es ESP,MF,Real Sociedad,es La Liga,24.71506849,2000,8.8,19,9,5,9,5,7,17,41.2,10,8,2,6,13,32,10,0
1932,Ben Old,nz NZL,"FW,MF",Saint-Étienne,fr Ligue 1,22.72328767,2002,5.4,6,5,3,2,1,3,11,27.3,8,8,1,7,2,8,2,0
1933,Finn Ole Becker,de GER,MF,Hoffenheim,de Bundesliga,24.90410959,2000,7.3,11,5,4,6,1,1,4,25,3,7,3,4,10,21,18,0
1934,Michael Olise,fr FRA,"FW,MF",Bayern Munich,de Bundesliga,23.39178082,2001,23.9,34,21,10,21,3,16,34,47.1,18,23,1,22,8,42,13,3
1935,Brian Oliván,es ESP,DF,Espanyol,es La Liga,31.09041096,1994,11.3,13,10,7,6,0,4,13,30.8,9,6,2,4,10,23,23,0
1936,Lucas Oliveira Rosa,br BRA,DF,Valladolid,es La Liga,25.08493151,2000,21,53,33,40,11,2,35,51,68.6,16,24,9,15,28,81,69,2
1937,Mathías Olivera,uy URU,DF,Napoli,it Serie A,27.50684932,1997,23.3,60,33,31,23,6,30,48,62.5,18,32,9,23,28,88,63,0
1938,Dani Olmo,es ESP,"MF,FW",Barcelona,es La Liga,26.99178082,1998,11.4,14,9,8,4,2,3,11,27.3,8,6,3,3,3,17,10,1
1939,Robin Olsen,se SWE,GK,Aston Villa,eng Premier League,35.31780822,1990,2,1,0,1,0,0,1,1,100,0,0,0,0,0,1,2,1
1940,Warmed Omari,km COM,DF,Lyon,fr Ligue 1,25.03013699,2000,0.1,0,0,0,0,0,0,0,,0,0,0,0,0,0,1,0
1941,Becir Omeragic,ch SUI,"DF,MF",Montpellier,fr Ligue 1,23.28493151,2002,17,29,15,18,10,1,15,20,75,5,28,19,9,11,40,65,0
1942,Jonas Omlin,ch SUI,GK,Gladbach,de Bundesliga,31.31232877,1994,8.9,0,0,0,0,0,0,1,0,1,0,0,0,0,0,3,1
1943,Andrew Omobamidele,ie IRL,DF,Strasbourg,fr Ligue 1,22.8630137,2002,6,7,4,4,3,0,2,5,40,3,12,8,4,8,15,38,0
1944,Ado Onaiwu,jp JPN,"MF,FW",Auxerre,fr Ligue 1,29.48493151,1995,9.6,10,7,2,5,3,4,10,40,6,9,0,9,2,12,12,0
1945,Amadou Onana,be BEL,MF,Aston Villa,eng Premier League,23.71506849,2001,15.3,47,24,21,22,4,14,26,53.8,12,14,6,8,24,71,37,3
1946,André Onana,cm CMR,GK,Manchester Utd,eng Premier League,29.08767123,1996,33,1,1,1,0,0,1,3,33.3,2,0,0,0,0,1,11,4
1947,Jean Onana,cm CMR,MF,Genoa,it Serie A,25.31780822,2000,2.1,9,6,2,7,0,4,7,57.1,3,3,0,3,2,11,8,1
1948,Jacob Ondrejka,se SWE,"MF,FW",Parma,it Serie A,22.66849315,2002,3.5,7,3,3,4,0,6,8,75,2,2,0,2,7,14,2,0
1949,Karim Onisiwo,at AUT,"MF,FW",Mainz 05,de Bundesliga,33.13150685,1992,1.2,1,1,0,0,1,0,0,,0,0,0,0,0,1,0,0
1950,Paul Onuachu,ng NGA,FW,Southampton,eng Premier League,30.93424658,1994,11.4,7,2,1,5,1,3,7,42.9,4,7,2,5,1,8,16,1
1951,Frank Onyeka,ng NGA,MF,Brentford,eng Premier League,27.3369863,1998,0.3,0,0,0,0,0,0,0,,0,0,0,0,0,0,0,0
1952,Frank Onyeka,ng NGA,MF,Augsburg,de Bundesliga,27.3369863,1998,26.1,55,43,21,27,7,21,38,55.3,17,34,9,25,35,90,34,2
1953,Loïs Openda,be BEL,"FW,MF",RB Leipzig,de Bundesliga,25.2109589,2000,26.3,9,4,3,4,2,3,11,27.3,8,19,1,18,5,14,12,0
1954,Christopher Operi,ci CIV,"DF,FW",Le Havre,fr Ligue 1,28.01369863,1997,13,13,9,6,2,5,7,12,58.3,5,20,6,14,14,27,30,0
1955,Fredrik Oppegard,no NOR,DF,Auxerre,fr Ligue 1,22.73972603,2002,1.9,4,3,2,1,1,3,7,42.9,4,2,1,1,1,5,7,0
1956,Victor Orakpo,ng NGA,FW,Nice,fr Ligue 1,18.88767123,2006,0.4,0,0,0,0,0,0,0,,0,0,0,0,0,0,0,0
1957,Ike Orazi,ie IRL,MF,Reims,fr Ligue 1,17.89589041,2007,0,0,0,0,0,0,0,0,,0,0,0,0,0,0,0,0
1958,Gift Orban,ng NGA,"FW,DF",Lyon,fr Ligue 1,22.79726027,2002,2.1,0,0,0,0,0,0,1,0,1,0,0,0,0,0,0,0
1959,Gift Orban,ng NGA,FW,Hoffenheim,de Bundesliga,22.79726027,2002,7.6,3,1,2,1,0,1,6,16.7,5,7,0,7,0,3,3,0
1960,Willi Orban,hu HUN,DF,RB Leipzig,de Bundesliga,32.49863014,1992,24.7,38,21,23,14,1,23,32,71.9,9,45,31,14,21,59,169,4
1961,Ivan Ordets,ua UKR,DF,Bochum,de Bundesliga,32.82191781,1992,19.7,18,8,13,5,0,10,12,83.3,2,27,14,13,37,55,128,3
1962,Lewis Orford,eng ENG,MF,West Ham,eng Premier League,19.20547945,2006,0.5,0,0,0,0,0,0,0,,0,1,0,1,1,1,0,0
1963,Gaetano Oristanio,it ITA,"FW,MF",Venezia,it Serie A,22.59726027,2002,24.3,17,13,5,8,4,7,15,46.7,8,16,0,16,6,23,6,1
1964,Aimar Oroz,es ESP,"MF,FW",Osasuna,es La Liga,23.43287671,2001,29,32,18,15,11,6,14,44,31.8,30,27,2,25,18,50,7,0
1965,Riccardo Orsolini,it ITA,FW,Bologna,it Serie A,28.2739726,1997,17.8,13,11,5,5,3,3,9,33.3,6,24,0,24,7,20,10,1
1966,Stefan Ortega,de GER,GK,Manchester City,eng Premier League,32.49041096,1992,12.2,0,0,0,0,0,0,1,0,1,0,0,0,0,0,11,1
1967,Ángel Ortíz,es ESP,DF,Betis,es La Liga,20.77534247,2004,3.8,10,7,7,3,0,6,15,40,9,6,0,6,5,15,7,0
1968,Gabriel Osei Misehouy,nl NED,"FW,MF",Girona,es La Liga,19.79452055,2005,2.9,1,1,0,1,0,0,1,0,1,0,0,0,0,1,0,0
1969,Gabriel Osho,ng NGA,DF,Auxerre,fr Ligue 1,26.72054795,1998,17.4,22,14,16,3,3,12,19,63.2,7,30,17,13,12,34,79,0
1970,Yordan Osorio,ve VEN,DF,Parma,it Serie A,30.98356164,1994,1.9,5,3,4,1,0,2,2,100,0,3,1,2,4,9,6,1
1971,Patrick Osterhage,de GER,MF,Freiburg,de Bundesliga,25.25205479,2000,23.2,43,28,16,25,2,13,27,48.1,14,24,3,21,18,61,35,0
1972,William Osula,dk DEN,FW,Newcastle Utd,eng Premier League,21.74794521,2003,1.2,1,0,0,0,1,0,2,0,2,0,0,0,4,5,2,0
1973,Jibril Othman,tn TUN,FW,Saint-Étienne,fr Ligue 1,21.02191781,2004,0.1,0,0,0,0,0,0,0,,0,0,0,0,0,0,0,0
1974,Sebastian Otoa,dk DEN,DF,Genoa,it Serie A,20.97534247,2004,0.2,0,0,0,0,0,0,1,0,1,0,0,0,0,0,0,0
1975,David Otorbi,es ESP,MF,Valencia,es La Liga,17.54794521,2007,0.2,0,0,0,0,0,0,0,,0,1,0,1,0,0,0,0
1976,Dango Ouattara,bf BFA,FW,Bournemouth,eng Premier League,23.22465753,2002,22.3,35,26,14,11,10,17,41,41.5,24,36,10,26,11,46,51,0
1977,Guimissongui Ouattara,fr FRA,"DF,FW",Strasbourg,fr Ligue 1,19.53150685,2005,5.1,6,4,3,1,2,3,5,60,2,9,0,9,8,14,12,2
1978,Kassoum Ouattara,fr FRA,"DF,FW",Monaco,fr Ligue 1,20.55342466,2004,4.3,9,7,5,4,0,4,14,28.6,10,6,0,6,5,14,2,1
1979,Remi Oudin,fr FRA,"MF,FW",Lecce,it Serie A,28.45753425,1996,3.3,3,1,1,1,1,2,4,50,2,6,2,4,2,5,1,0
1980,Assan Ouedraogo,de GER,MF,RB Leipzig,de Bundesliga,18.98630137,2006,0.6,0,0,0,0,0,0,0,,0,1,0,1,0,0,0,0
1981,Zinédine Ould Khaled,fr FRA,MF,Angers,fr Ligue 1,25.30136986,2000,2.8,7,5,4,2,1,1,10,10,9,4,0,4,2,9,6,0
1982,Cheick Oumar Conde,gn GUI,MF,Venezia,it Serie A,24.77260274,2000,1.6,6,5,3,2,1,2,5,40,3,7,2,5,4,10,3,0
1983,Jesús Owono,gq EQG,GK,Alavés,es La Liga,24.17534247,2001,5.4,1,1,1,0,0,1,1,100,0,0,0,0,0,1,2,0
1984,Beres Owusu,fr FRA,DF,Saint-Étienne,fr Ligue 1,21.62191781,2003,1,2,2,1,1,0,2,2,100,0,2,2,0,0,2,5,0
1985,Elisha Owusu,gh GHA,MF,Auxerre,fr Ligue 1,27.48767123,1997,24.3,71,39,27,39,5,31,46,67.4,15,33,9,24,41,112,34,1
1986,Mikel Oyarzabal,es ESP,"FW,MF",Real Sociedad,es La Liga,28.03561644,1997,21.3,18,11,7,7,4,8,16,50,8,15,1,14,4,22,14,0
1987,Daniel Oyegoke,eng ENG,DF,Hellas Verona,it Serie A,22.33150685,2003,1.1,2,2,1,0,1,1,1,100,0,1,0,1,1,3,7,0
1988,Salih Özcan,tr TUR,MF,Wolfsburg,de Bundesliga,27.30958904,1998,3.9,2,2,1,0,1,1,5,20,4,5,1,4,7,9,5,0
1989,Salih Özcan,tr TUR,MF,Dortmund,de Bundesliga,27.30958904,1998,4.2,11,7,6,4,1,7,12,58.3,5,7,0,7,11,22,10,0
1990,Cenk Özkacar,tr TUR,DF,Valladolid,es La Liga,24.57534247,2000,4.9,5,4,4,1,0,2,6,33.3,4,6,4,2,11,16,39,1
1991,Nico O’Reilly,eng ENG,DF,Manchester City,eng Premier League,20.12054795,2005,5.7,9,4,3,3,3,4,8,50,4,5,1,4,4,13,12,0
1992,Jon Pacheco,es ESP,DF,Real Sociedad,es La Liga,24.31780822,2001,8.5,13,9,10,3,0,8,10,80,2,8,6,2,8,21,45,2
1993,Willian Pacho,ec ECU,DF,Paris S-G,fr Ligue 1,23.54794521,2001,22.7,55,32,34,21,0,23,32,71.9,9,35,22,13,40,95,87,1
1994,Daniele Padelli,it ITA,GK,Udinese,it Serie A,39.52328767,1985,1,0,0,0,0,0,0,1,0,1,0,0,0,0,0,0,0
1995,Alex Padilla,es ESP,GK,Athletic Club,es La Liga,21.67123288,2003,3.6,0,0,0,0,0,0,0,,0,0,0,0,0,0,2,1
1996,Simone Pafundi,it ITA,"MF,DF",Udinese,it Serie A,19.21643836,2006,1.1,3,3,2,0,1,1,4,25,3,0,0,0,0,3,1,0
1997,Exequiel Palacios,ar ARG,MF,Leverkusen,de Bundesliga,26.57808219,1998,11.2,19,13,7,8,4,7,14,50,7,14,1,13,11,30,9,0
1998,Tomás Palacios,ar ARG,DF,Monza,it Serie A,22.01643836,2003,3.4,7,3,6,1,0,5,9,55.6,4,4,2,2,5,12,9,1
1999,Tomás Palacios,ar ARG,DF,Inter,it Serie A,22.01643836,2003,0.1,0,0,0,0,0,0,0,,0,0,0,0,1,1,0,0
2000,Isaac Palazón Camacho,es ESP,"MF,FW",Rayo Vallecano,es La Liga,30.35068493,1994,20,22,17,10,6,6,8,31,25.8,23,18,1,17,8,30,12,1
2001,Alberto Paleari,it ITA,GK,Torino,it Serie A,32.67945205,1992,1,0,0,0,0,0,0,0,,0,0,0,0,0,0,2,0
2002,Marco Palestra,it ITA,DF,Atalanta,it Serie A,20.16986301,2005,1.2,5,4,3,2,0,3,3,100,0,2,0,2,0,5,3,0
2003,João Palhinha,pt POR,MF,Bayern Munich,de Bundesliga,29.81917808,1995,7.4,20,14,6,11,3,11,15,73.3,4,12,1,11,4,24,9,1
2004,Nicolas Pallois,fr FRA,DF,Nantes,fr Ligue 1,37.62191781,1987,20.7,60,26,43,13,4,37,60,61.7,23,45,16,29,28,88,159,3
2005,Alex Palmer,eng ENG,GK,Ipswich Town,eng Premier League,28.73150685,1996,11,0,0,0,0,0,0,0,,0,0,0,0,0,0,12,0
2006,Cole Palmer,eng ENG,MF,Chelsea,eng Premier League,22.99452055,2002,31.5,25,16,11,7,7,8,21,38.1,13,14,1,13,8,33,17,1
2007,Emerson Palmieri,it ITA,DF,West Ham,eng Premier League,30.75068493,1994,22.4,57,29,35,18,4,25,44,56.8,19,32,8,24,20,77,58,0
2008,Mats Pannewig,de GER,MF,Bochum,de Bundesliga,20.51506849,2004,1.6,5,3,4,1,0,1,9,11.1,8,7,1,6,1,6,5,0
2009,Lucas Paquetá,br BRA,"MF,FW",West Ham,eng Premier League,27.68493151,1997,25.1,63,35,23,29,11,24,49,49,25,27,4,23,17,80,34,6
2010,Aitor Paredes,es ESP,DF,Athletic Club,es La Liga,25.01369863,2000,17.1,11,9,8,3,0,5,12,41.7,7,20,10,10,21,32,106,4
2011,Kevin Paredes,us USA,DF,Wolfsburg,de Bundesliga,21.99178082,2003,1.4,3,1,3,0,0,2,3,66.7,1,2,2,0,1,4,0,0
2012,Leandro Paredes,ar ARG,MF,Roma,it Serie A,30.84657534,1994,13.4,25,14,9,11,5,15,29,51.7,14,13,4,9,19,44,29,1
2013,Daniel Parejo,es ESP,MF,Villarreal,es La Liga,36.04931507,1989,23.2,48,37,24,19,5,26,48,54.2,22,21,6,15,22,70,33,1
2014,Fabiano Parisi,it ITA,"DF,MF",Fiorentina,it Serie A,24.48219178,2000,10.4,21,13,9,8,4,10,17,58.8,7,13,2,11,14,35,15,0
2015,Thomas Partey,gh GHA,"MF,DF",Arsenal,eng Premier League,31.89041096,1993,28.1,80,49,23,37,20,44,72,61.1,28,25,7,18,33,113,46,4
2016,Mario Pašalić,hr CRO,MF,Atalanta,it Serie A,30.23013699,1995,20.3,24,15,10,12,2,11,25,44,14,19,4,15,12,36,26,1
2017,Álvaro Pascual,es ESP,FW,Sevilla,es La Liga,23.3369863,2002,1.3,1,0,0,0,1,1,2,50,1,0,0,0,2,3,0,0
2018,Felix Passlack,de GER,"DF,MF",Bochum,de Bundesliga,26.93150685,1998,24.4,51,23,31,13,7,30,55,54.5,25,39,10,29,17,68,58,1
2019,Patric,es ESP,DF,Lazio,it Serie A,32.04657534,1993,6.7,9,6,6,3,0,6,10,60,4,3,2,1,3,12,22,1
2020,Rui Patrício,pt POR,GK,Atalanta,it Serie A,37.21369863,1988,2,0,0,0,0,0,0,0,,0,0,0,0,0,0,3,0
2021,Nathan Patterson,sct SCO,DF,Everton,eng Premier League,23.54794521,2001,3.9,11,6,7,4,0,7,14,50,7,2,0,2,2,13,7,0
2022,Benjamin Pavard,fr FRA,DF,Inter,it Serie A,29.10136986,1996,17.6,29,16,12,12,5,18,25,72,7,16,12,4,16,45,52,0
2023,Aleksandar Pavlovic,de GER,MF,Bayern Munich,de Bundesliga,21.00273973,2004,14.8,35,20,11,15,9,19,28,67.9,9,17,3,14,4,39,12,0
2024,Strahinja Pavlović,rs SRB,DF,Milan,it Serie A,23.94520548,2001,17,45,28,26,19,0,24,43,55.8,19,11,5,6,14,59,66,0
2025,Leonardo Pavoletti,it ITA,"FW,MF",Cagliari,it Serie A,36.43561644,1988,4.7,1,0,0,1,0,0,0,,0,4,1,3,0,1,3,0
2026,Martín Payero,ar ARG,MF,Udinese,it Serie A,26.64383562,1998,14.7,23,15,4,13,6,8,16,50,8,13,2,11,11,34,13,0
2027,Nicolas Pays,fr FRA,"FW,MF",Montpellier,fr Ligue 1,21.73972603,2003,5,13,6,3,4,6,4,8,50,4,1,0,1,4,17,2,0
2028,Nicolás Paz,ar ARG,"MF,FW",Como,it Serie A,20.65205479,2004,27,48,31,16,25,7,23,45,51.1,22,45,3,42,19,67,15,0
2029,Mads Pedersen,dk DEN,DF,Augsburg,de Bundesliga,28.67123288,1996,2.6,8,7,5,2,1,4,5,80,1,4,0,4,2,10,6,0
2030,Marcus Pedersen,no NOR,DF,Torino,it Serie A,24.8,2000,15.1,12,8,6,5,1,9,15,60,6,11,2,9,13,25,34,1
2031,Alfonso Pedraza,es ESP,"DF,MF",Villarreal,es La Liga,29.06849315,1996,3.1,3,2,2,0,1,2,4,50,2,2,1,1,4,7,9,0
2032,Pedri,es ESP,MF,Barcelona,es La Liga,22.43835616,2002,28.6,55,30,13,33,9,22,62,35.5,40,40,3,37,26,81,21,1
2033,Pedro,es ESP,"FW,MF",Lazio,it Serie A,37.76712329,1987,10.7,17,12,4,8,5,9,19,47.4,10,7,0,7,3,20,3,1
2034,Kévin Pedro,fr FRA,DF,Saint-Étienne,fr Ligue 1,19.19726027,2006,0.1,3,0,2,1,0,3,3,100,0,1,0,1,2,5,1,0
2035,Adrià Pedrosa,es ESP,DF,Sevilla,es La Liga,26.97534247,1998,22.5,55,32,33,16,6,30,52,57.7,22,39,9,30,19,74,79,0
2036,Jordan Pefok,us USA,FW,Reims,fr Ligue 1,29.02191781,1996,2.6,1,1,0,1,0,0,1,0,1,1,1,0,1,2,3,0
2037,Jordan Pefok,us USA,FW,Union Berlin,de Bundesliga,29.02191781,1996,10.1,11,6,6,0,5,3,7,42.9,4,9,2,7,4,15,18,0
2038,Pejiño,es ESP,FW,Las Palmas,es La Liga,28.76438356,1996,0.2,1,1,0,1,0,1,1,100,0,0,0,0,0,1,0,0
2039,Pietro Pellegri,it ITA,FW,Empoli,it Serie A,24.13150685,2001,4.6,7,2,0,6,1,2,4,50,2,2,0,2,0,7,3,0
2040,Lorenzo Pellegrini,it ITA,MF,Roma,it Serie A,28.8739726,1996,17.6,23,15,4,13,6,7,17,41.2,10,8,1,7,5,28,22,0
2041,Luca Pellegrini,it ITA,DF,Lazio,it Serie A,26.15890411,1999,9.9,20,11,9,10,1,15,27,55.6,12,9,2,7,16,36,29,0
2042,Mateo Pellegrino,ar ARG,FW,Parma,it Serie A,24.17534247,2001,5.5,2,1,1,1,0,1,3,33.3,2,4,1,3,0,2,6,0
2043,Théo Pellenard,fr FRA,DF,Auxerre,fr Ligue 1,31.16712329,1994,0.5,3,2,2,1,0,1,3,33.3,2,1,0,1,0,3,3,0
2044,Andy Pelmard,fr FRA,DF,Lecce,it Serie A,25.14520548,2000,1.4,6,6,5,1,0,4,4,100,0,1,0,1,0,6,5,0
2045,Andy Pelmard,fr FRA,DF,Las Palmas,es La Liga,25.14520548,2000,2.3,5,0,3,2,0,4,5,80,1,3,1,2,2,7,20,0
2046,Timothee Pembele,fr FRA,DF,Le Havre,fr Ligue 1,22.64931507,2002,11.5,30,22,17,9,4,14,23,60.9,9,15,5,10,11,41,40,0
2047,Faris Pemi Moumbagna,cm CMR,FW,Marseille,fr Ligue 1,24.84109589,2000,0.1,0,0,0,0,0,0,0,,0,0,0,0,0,0,0,0
2048,Iñaki Peña,es ESP,GK,Barcelona,es La Liga,26.17260274,1999,14.5,0,0,0,0,0,0,2,0,2,0,0,0,0,0,20,1
2049,Rubén Peña,es ESP,"FW,DF",Osasuna,es La Liga,33.79452055,1991,7.6,9,3,3,2,4,3,18,16.7,15,10,0,10,5,14,11,0
2050,Nicolas Pépé,ci CIV,"FW,MF",Villarreal,es La Liga,29.93150685,1995,13.6,18,8,8,6,4,5,12,41.7,7,10,1,9,5,23,10,0
2051,Peque,es ESP,"MF,FW",Sevilla,es La Liga,22.58082192,2002,10.8,13,4,4,7,2,5,13,38.5,8,14,0,14,7,20,5,0
2052,Sergiu Perciun,md MDA,"FW,MF",Torino,it Serie A,19.03013699,2006,0.7,0,0,0,0,0,0,0,,0,2,0,2,0,0,1,0
2053,Óscar Perea,co COL,MF,Strasbourg,fr Ligue 1,19.6,2005,0.1,0,0,0,0,0,0,0,,0,0,0,0,0,0,0,0
2054,Andreas Pereira,br BRA,MF,Fulham,eng Premier League,29.3369863,1996,20.9,22,12,7,11,4,10,40,25,30,16,2,14,8,30,15,2
2055,Mathias Pereira Lage,pt POR,"FW,MF",Brest,fr Ligue 1,28.42465753,1996,14.8,35,23,16,12,7,17,35,48.6,18,16,2,14,18,53,17,2
2056,Pedro Pereira,pt POR,DF,Monza,it Serie A,27.27945205,1998,27.1,48,30,26,17,5,31,50,62,19,22,9,13,17,65,71,3
2057,Ricardo Pereira,pt POR,DF,Leicester City,eng Premier League,31.57534247,1993,3.8,11,6,4,4,3,6,12,50,6,6,2,4,2,13,10,0
2058,Gastón Pereiro,uy URU,MF,Genoa,it Serie A,29.89589041,1995,0.3,1,0,0,1,0,1,1,100,0,0,0,0,0,1,1,0
2059,Daniel Peretz,il ISR,GK,Bayern Munich,de Bundesliga,24.81643836,2000,3,0,0,0,0,0,0,1,0,1,0,0,0,0,0,2,0
2060,Ayoze Pérez,es ESP,FW,Villarreal,es La Liga,31.76438356,1993,19.6,23,12,5,15,3,6,22,27.3,16,16,0,16,7,30,13,0
2061,Carles Pérez,es ESP,"MF,FW",Getafe,es La Liga,27.2109589,1998,15.9,33,23,11,14,8,21,48,43.8,27,19,2,17,6,39,22,0
2062,Francisco Perez,es ESP,"MF,FW",Valencia,es La Liga,22.64931507,2002,5.1,12,11,5,6,1,9,15,60,6,8,1,7,3,15,6,0
2063,Kike Pérez,es ESP,MF,Venezia,it Serie A,28.21643836,1997,10.4,36,21,16,10,10,17,41,41.5,24,12,1,11,8,44,12,0
2064,Kike Pérez,es ESP,MF,Valladolid,es La Liga,28.21643836,1997,13.2,37,26,15,19,3,15,26,57.7,11,16,4,12,7,44,18,0
2065,Luis Pérez,es ESP,DF,Valladolid,es La Liga,30.24383562,1995,26.9,38,27,23,10,5,24,40,60,16,26,9,17,28,66,76,0
2066,Nehuén Pérez,ar ARG,DF,Udinese,it Serie A,24.86027397,2000,2,1,1,0,0,1,0,1,0,1,2,2,0,1,2,7,0
2067,Simone Perilli,it ITA,GK,Hellas Verona,it Serie A,30.32054795,1995,1,0,0,0,0,0,0,0,,0,0,0,0,0,0,1,0
2068,Mattia Perin,it ITA,GK,Juventus,it Serie A,32.47945205,1992,5,0,0,0,0,0,0,0,,0,0,0,0,0,0,2,0
2069,Romain Perraud,fr FRA,DF,Betis,es La Liga,27.61369863,1997,20.1,35,21,15,15,5,20,45,44.4,25,15,3,12,21,56,66,1
2070,Lucas Perri,br BRA,GK,Lyon,fr Ligue 1,27.39726027,1997,30,1,1,1,0,0,0,4,0,4,1,0,1,0,1,20,1
2071,Gaëtan Perrin,fr FRA,"MF,FW",Auxerre,fr Ligue 1,28.90684932,1996,27,49,26,22,12,15,21,46,45.7,25,10,0,10,12,61,4,1
2072,Máximo Perrone,ar ARG,MF,Como,it Serie A,22.32054795,2003,18.1,34,24,16,13,5,11,36,30.6,25,13,1,12,17,51,36,0
2073,Noah Pesch,hr CRO,FW,Gladbach,de Bundesliga,19.96164384,2005,0.1,1,0,0,0,1,0,0,,0,0,0,0,0,1,0,0
2074,Matteo Pessina,it ITA,MF,Monza,it Serie A,28.03561644,1997,9.5,15,4,3,11,1,9,14,64.3,5,6,0,6,12,27,7,0
2075,Andrea Petagna,it ITA,FW,Monza,it Serie A,29.84383562,1995,3.3,1,0,0,1,0,1,2,50,1,0,0,0,1,2,2,0
2076,Prosper Peter,ng NGA,MF,Angers,fr Ligue 1,17.73424658,2007,0.2,2,1,0,2,0,0,0,,0,0,0,0,0,2,0,0
2077,Léo Pétrot,fr FRA,DF,Saint-Étienne,fr Ligue 1,28.05205479,1997,26.3,56,35,34,17,5,31,47,66,16,47,25,22,37,93,91,1
2078,Đorđe Petrović,rs SRB,GK,Strasbourg,fr Ligue 1,25.56986301,1999,29,1,1,1,0,0,0,0,,0,0,0,0,0,1,24,1
2079,Giuseppe Pezzella,it ITA,"DF,FW",Empoli,it Serie A,27.42739726,1997,28,52,29,27,17,8,28,55,50.9,27,28,7,21,14,66,94,1
2080,Valentín Pezzolesi,es ESP,DF,Las Palmas,es La Liga,18.04931507,2007,0.1,0,0,0,0,0,0,0,,0,0,0,0,0,0,1,1
2081,Luca Philipp,de GER,GK,Hoffenheim,de Bundesliga,24.43013699,2000,6,1,0,1,0,0,1,1,100,0,0,0,0,0,1,1,0
2082,Maximilian Philipp,de GER,"MF,FW",Freiburg,de Bundesliga,31.17534247,1994,0.2,0,0,0,0,0,0,0,,0,0,0,0,0,0,0,0
2083,Kalvin Phillips,eng ENG,MF,Ipswich Town,eng Premier League,29.41917808,1995,13.7,35,19,8,20,7,15,39,38.5,24,35,6,29,19,54,37,2
2084,Jaden Philogene Bidace,eng ENG,"FW,MF",Aston Villa,eng Premier League,23.23287671,2002,3.7,11,5,4,7,0,4,6,66.7,2,5,0,5,3,14,2,1
2085,Jaden Philogene Bidace,eng ENG,"FW,DF",Ipswich Town,eng Premier League,23.23287671,2002,5.3,14,7,6,6,2,8,15,53.3,7,11,1,10,10,24,9,1
2086,Pica,es ESP,DF,Alavés,es La Liga,23.3369863,2002,5.4,9,7,7,2,0,4,9,44.4,5,7,6,1,8,17,23,0
2087,Roberto Piccoli,it ITA,FW,Cagliari,it Serie A,24.26575342,2001,31.7,13,9,2,6,5,3,9,33.3,6,12,4,8,3,16,29,0
2088,Benedikt Pichler,at AUT,FW,Holstein Kiel,de Bundesliga,27.7890411,1997,8.6,5,2,1,0,4,2,4,50,2,4,2,2,2,7,11,0
2089,Jordan Pickford,eng ENG,GK,Everton,eng Premier League,31.15890411,1994,35,1,0,1,0,0,1,2,50,1,0,0,0,1,2,29,2
2090,Amos Pieper,de GER,DF,Werder Bremen,de Bundesliga,27.29315068,1998,14.7,29,16,16,9,4,18,28,64.3,10,25,16,9,22,51,89,1
2091,Marvin Pieringer,de GER,"FW,MF",Heidenheim,de Bundesliga,25.58082192,1999,22.6,22,13,5,12,5,5,8,62.5,3,21,2,19,8,30,31,0
2092,Nicholas Pierini,it ITA,MF,Venezia,it Serie A,26.74246575,1998,0.9,0,0,0,0,0,0,1,0,1,2,0,2,0,0,0,0
2093,Santiago Pierotti,ar ARG,FW,Lecce,it Serie A,24.08493151,2001,20.1,45,24,21,18,6,22,46,47.8,24,24,5,19,13,58,28,0
2094,Balthazar Pierret,fr FRA,MF,Lecce,it Serie A,24.96986301,2000,17.9,47,29,23,21,3,12,28,42.9,16,18,4,14,18,65,31,1
2095,Andrea Pinamonti,it ITA,FW,Genoa,it Serie A,25.95890411,1999,28.8,9,5,0,7,2,1,6,16.7,5,14,4,10,1,10,26,2
2096,Ethan Pinnock,jm JAM,DF,Brentford,eng Premier League,31.93150685,1993,21.3,35,19,15,16,4,13,24,54.2,11,29,18,11,24,59,142,4
2097,Yeremi Pino,es ESP,MF,Villarreal,es La Liga,22.5369863,2002,18.5,52,27,16,28,8,27,54,50,27,35,3,32,8,60,16,0
2098,Niccolò Pisilli,it ITA,MF,Roma,it Serie A,20.6109589,2004,13,23,10,10,8,5,12,21,57.1,9,14,3,11,10,33,16,0
2099,Damián Pizarro,cl CHI,"FW,MF",Udinese,it Serie A,20.10136986,2005,0.2,0,0,0,0,0,0,0,,0,0,0,0,0,0,0,0
2100,Semuel Pizzignacco,it ITA,GK,Monza,it Serie A,23.67123288,2001,4.3,0,0,0,0,0,0,1,0,1,0,0,0,0,0,3,0
2101,Alassane Pléa,fr FRA,"MF,FW",Gladbach,de Bundesliga,32.15068493,1993,20,7,3,0,2,5,4,12,33.3,8,10,0,10,2,9,7,1
2102,Tommaso Pobega,it ITA,MF,Bologna,it Serie A,25.80273973,1999,11.8,31,18,12,13,6,21,28,75,7,14,4,10,13,44,15,0
2103,Daniel Podence,pt POR,"MF,FW",Wolves,eng Premier League,29.53424658,1995,0.5,0,0,0,0,0,0,1,0,1,0,0,0,0,0,0,0
2104,Joel Pohjanpalo,fi FIN,FW,Venezia,it Serie A,30.63835616,1994,17.8,3,3,1,2,0,0,4,0,4,7,4,3,4,7,24,0
2105,Matteo Politano,it ITA,"FW,MF",Napoli,it Serie A,31.75068493,1993,28.6,28,15,17,10,1,14,42,33.3,28,19,1,18,12,40,48,1
2106,Alfie Pond,eng ENG,DF,Wolves,eng Premier League,21.17534247,2004,0,0,0,0,0,0,0,0,,0,0,0,0,0,0,0,0
2107,Marin Pongračić,hr CRO,DF,Fiorentina,it Serie A,27.64383562,1997,12.9,15,11,11,3,1,7,9,77.8,2,13,6,7,11,26,63,2
2108,Nick Pope,eng ENG,GK,Newcastle Utd,eng Premier League,33.04109589,1992,24,0,0,0,0,0,0,0,,0,1,0,1,1,1,29,5
2109,Finn Porath,de GER,"DF,MF",Holstein Kiel,de Bundesliga,28.19178082,1997,21.4,44,25,23,14,7,25,52,48.1,27,27,9,18,20,64,67,0
2110,Pedro Porro,es ESP,DF,Tottenham,eng Premier League,25.63835616,1999,27.4,63,46,31,22,10,42,73,57.5,31,44,17,27,34,97,80,1
2111,Portu,es ESP,"FW,MF",Girona,es La Liga,32.95342466,1992,5.3,11,5,5,3,3,6,8,75,2,6,0,6,0,11,1,0
2112,Stefan Posch,at AUT,DF,Bologna,it Serie A,27.97260274,1997,7.9,26,15,12,9,5,15,25,60,10,19,4,15,5,31,22,0
2113,Stefan Posch,at AUT,DF,Atalanta,it Serie A,27.97260274,1997,3.8,14,10,5,6,3,7,8,87.5,1,5,1,4,4,18,13,0
2114,Tom Pouilly,fr FRA,"DF,MF",Lens,fr Ligue 1,21.87671233,2003,1.3,4,3,1,1,2,2,3,66.7,1,3,1,2,1,5,4,0
2115,Yussuf Poulsen,dk DEN,"FW,MF",RB Leipzig,de Bundesliga,30.88493151,1994,3.7,10,5,2,6,2,4,8,50,4,6,2,4,0,10,11,0
2116,Beñat Prados,es ESP,MF,Athletic Club,es La Liga,24.23287671,2001,17.1,47,30,18,21,8,20,47,42.6,27,20,2,18,28,75,25,0
2117,Alexander Prass,at AUT,DF,Hoffenheim,de Bundesliga,23.93972603,2001,16.9,41,23,23,15,3,24,57,42.1,33,32,6,26,9,50,48,4
2118,Matteo Prati,it ITA,MF,Cagliari,it Serie A,21.34794521,2003,6.1,10,4,2,7,1,3,11,27.3,8,5,2,3,7,17,10,1
2119,Abdón Prats,es ESP,"FW,MF",Mallorca,es La Liga,32.40547945,1992,5.1,2,1,1,1,0,1,2,50,1,2,1,1,1,3,5,0
2120,David Preu,de GER,"MF,DF",Union Berlin,de Bundesliga,20.52054795,2004,0.4,0,0,0,0,0,0,1,0,1,2,1,1,0,0,2,0
2121,Grischa Prömel,de GER,MF,Hoffenheim,de Bundesliga,30.31506849,1995,1.9,0,0,0,0,0,0,1,0,1,1,1,0,2,2,4,0
2122,Ivan Provedel,it ITA,GK,Lazio,it Serie A,31.13150685,1994,29,0,0,0,0,0,0,0,,0,1,0,1,1,1,12,3
2123,Ivan Prtajin,hr CRO,FW,Union Berlin,de Bundesliga,28.97260274,1996,1.8,3,2,0,1,2,0,0,,0,2,0,2,0,3,3,0
2124,Javi Puado,es ESP,"FW,MF",Espanyol,es La Liga,26.94246575,1998,28.5,18,14,10,4,4,7,14,50,7,12,2,10,4,22,16,0
2125,Tymoteusz Puchacz,pl POL,DF,Holstein Kiel,de Bundesliga,26.27671233,1999,4.4,9,4,6,3,0,5,7,71.4,2,4,1,3,3,12,11,0
2126,Diego Pugno,it ITA,FW,Juventus,it Serie A,18.82465753,2006,0.1,0,0,0,0,0,0,0,,0,0,0,0,0,0,0,0
2127,Christian Pulisic,us USA,"FW,MF",Milan,it Serie A,26.62465753,1998,23.7,38,24,14,12,12,13,34,38.2,21,21,2,19,3,41,12,2
2128,Jarell Quansah,eng ENG,DF,Liverpool,eng Premier League,22.26027397,2003,3.5,10,7,8,2,0,5,7,71.4,2,5,5,0,5,15,15,0
2129,Leopold Querfeld,at AUT,DF,Union Berlin,de Bundesliga,21.36986301,2003,17.4,22,10,18,4,0,11,16,68.8,5,23,10,13,15,37,130,2
2130,Dani Raba,es ESP,"FW,MF",Leganés,es La Liga,29.51232877,1995,17.2,34,21,16,14,4,15,35,42.9,20,24,2,22,14,48,14,1
2131,Adrien Rabiot,fr FRA,MF,Marseille,fr Ligue 1,30.08493151,1995,24.6,45,27,16,19,10,19,30,63.3,11,18,1,17,20,65,29,0
2132,Ionuț Radu,ro ROU,GK,Venezia,it Serie A,27.93424658,1997,12,0,0,0,0,0,0,0,,0,0,0,0,0,0,7,0
2133,Hamza Rafia,tn TUN,MF,Lecce,it Serie A,26.08767123,1999,11.8,44,27,14,25,5,15,32,46.9,17,7,2,5,4,48,18,1
2134,Hákon Rafn Valdimarsson,is ISL,GK,Brentford,eng Premier League,23.55616438,2001,1.6,0,0,0,0,0,0,0,,0,0,0,0,0,0,2,0
2135,Arnau Rafús,es ESP,GK,Valladolid,es La Liga,22.01917808,2003,1,0,0,0,0,0,0,0,,0,0,0,0,0,0,0,1
2136,Antonio Raillo,es ESP,DF,Mallorca,es La Liga,33.56986301,1991,30.6,28,16,15,10,3,14,18,77.8,4,38,30,8,27,55,187,1
2137,Antonio Raimondo,it ITA,"FW,DF",Venezia,it Serie A,21.12876712,2004,1,2,1,1,1,0,0,0,,0,0,0,0,0,2,0,1
2138,Ylber Ramadani,al ALB,MF,Lecce,it Serie A,29.06027397,1996,18.8,51,28,24,27,0,33,50,66,17,26,9,17,24,75,23,3
2139,Benito Ramírez,es ESP,"DF,MF",Las Palmas,es La Liga,29.81369863,1995,4.3,10,5,4,6,0,9,16,56.3,7,6,3,3,1,11,14,1
2140,Sandro Ramírez,es ESP,"FW,MF",Las Palmas,es La Liga,29.81917808,1995,21.4,26,15,9,13,4,13,29,44.8,16,18,0,18,16,42,21,2
2141,Gonçalo Ramos,pt POR,FW,Paris S-G,fr Ligue 1,23.87123288,2001,10.7,11,6,5,5,1,3,6,50,3,5,1,4,0,11,5,0
2142,Aaron Ramsdale,eng ENG,GK,Southampton,eng Premier League,26.97260274,1998,27,0,0,0,0,0,0,2,0,2,0,0,0,2,2,8,2
2143,Jacob Ramsey,eng ENG,"FW,MF",Aston Villa,eng Premier League,23.93424658,2001,16.8,30,15,14,10,6,10,20,50,10,21,3,18,7,37,8,1
2144,Luca Ranieri,it ITA,DF,Fiorentina,it Serie A,26.03013699,1999,31.1,37,21,26,9,2,18,22,81.8,4,43,31,12,25,62,142,1
2145,Grant Ranos,am ARM,FW,Gladbach,de Bundesliga,21.7890411,2003,0.2,1,0,0,1,0,0,1,0,1,2,0,2,0,1,0,0
2146,Lilian Raolisoa,fr FRA,"DF,FW",Angers,fr Ligue 1,24.88219178,2000,12,37,22,22,13,2,16,35,45.7,19,10,2,8,14,51,42,0
2147,Raphinha,br BRA,"FW,MF",Barcelona,es La Liga,28.38630137,1996,27.8,34,21,6,17,11,18,34,52.9,16,26,2,24,8,42,24,0
2148,Marcus Rashford,eng ENG,"FW,MF",Manchester Utd,eng Premier League,27.50684932,1997,10.9,7,4,2,2,3,3,9,33.3,6,8,0,8,4,11,7,0
2149,Marcus Rashford,eng ENG,FW,Aston Villa,eng Premier League,27.50684932,1997,4.9,10,7,2,3,5,4,6,66.7,2,2,0,2,1,11,3,0
2150,Giacomo Raspadori,it ITA,"FW,MF",Napoli,it Serie A,25.20547945,2000,9.7,15,7,6,9,0,8,12,66.7,4,10,2,8,2,17,10,0
2151,Andrei Ratiu,ro ROU,DF,Rayo Vallecano,es La Liga,26.87123288,1998,30.2,65,37,40,17,8,39,64,60.9,25,36,3,33,26,91,68,2
2152,Raúl,es ESP,"FW,MF",Osasuna,es La Liga,24.49863014,2000,7.7,11,6,3,5,3,4,9,44.4,5,4,0,4,0,11,5,0
2153,David Raum,de GER,DF,RB Leipzig,de Bundesliga,27.03287671,1998,18.8,36,27,15,13,8,19,34,55.9,15,25,8,17,9,45,43,4
2154,Federico Ravaglia,it ITA,GK,Bologna,it Serie A,25.47671233,1999,10.7,0,0,0,0,0,0,0,,0,0,0,0,0,0,7,0
2155,Rayan Raveloson,mg MAD,"MF,DF",Auxerre,fr Ligue 1,28.29589041,1997,8,6,5,2,4,0,5,15,33.3,10,8,7,1,5,11,22,0
2156,David Raya,es ESP,GK,Arsenal,eng Premier League,29.63287671,1995,35,0,0,0,0,0,0,2,0,2,0,0,0,2,2,18,6
2157,Abderrahman Rebbach,dz ALG,"FW,MF",Alavés,es La Liga,26.72876712,1998,4.3,3,2,3,0,0,0,6,0,6,4,0,4,0,3,6,0
2158,Ante Rebić,hr CRO,"FW,MF",Lecce,it Serie A,31.61643836,1993,8.3,10,8,5,3,2,2,8,25,6,6,1,5,2,12,4,1
2159,Harrison Reed,eng ENG,MF,Fulham,eng Premier League,30.26575342,1995,1.2,6,3,3,2,1,1,3,33.3,2,1,0,1,1,7,3,0
2160,Remy Rees-Dottin,eng ENG,FW,Bournemouth,eng Premier League,19.16164384,2006,0,0,0,0,0,0,0,0,,0,0,0,0,0,0,0,0
2161,Sergio Reguilón,es ESP,DF,Tottenham,eng Premier League,28.38082192,1996,1.4,4,3,1,3,0,2,3,66.7,1,4,0,4,2,6,3,0
2162,Tijjani Reijnders,nl NED,MF,Milan,it Serie A,26.76438356,1998,30.8,23,13,6,12,5,9,24,37.5,15,19,4,15,33,56,25,2
2163,Pepe Reina,es ESP,GK,Como,it Serie A,42.6739726,1982,10,0,0,0,0,0,0,1,0,1,0,0,0,0,0,3,1
2164,Vitor Reis,br BRA,DF,Manchester City,eng Premier League,19.30684932,2006,0,0,0,0,0,0,0,0,,0,0,0,0,0,0,1,0
2165,Rocco Reitz,de GER,MF,Gladbach,de Bundesliga,22.93150685,2002,18.5,47,21,20,23,4,20,38,52.6,18,32,13,19,45,92,52,1
2166,Nicolai Remberg,de GER,MF,Holstein Kiel,de Bundesliga,24.8739726,2000,24.9,42,24,22,16,4,18,36,50,18,45,19,26,27,69,90,0
2167,Álex Remiro,es ESP,GK,Real Sociedad,es La Liga,30.11232877,1995,32,1,0,1,0,0,1,2,50,1,0,0,0,0,1,15,4
2168,Devyne Rensch,nl NED,DF,Roma,it Serie A,22.29041096,2003,4.1,15,11,7,7,1,9,10,90,1,4,2,2,5,20,8,1
2169,Guillaume Restes,fr FRA,GK,Toulouse,fr Ligue 1,20.14794521,2005,26.3,2,1,2,0,0,2,3,66.7,1,0,0,0,1,3,13,1
2170,Mateo Retegui,it ITA,FW,Atalanta,it Serie A,26.01369863,1999,22.7,14,9,0,9,5,3,15,20,12,6,0,6,2,16,15,0
2171,Elvis Rexhbeçaj,xk KVX,MF,Augsburg,de Bundesliga,27.50410959,1997,19.5,27,19,9,14,4,15,35,42.9,20,38,9,29,16,43,22,1
2172,Gio Reyna,us USA,MF,Dortmund,de Bundesliga,22.47123288,2002,3.8,6,0,3,0,3,3,4,75,1,3,1,2,0,6,9,0
2173,Chadi Riad,ma MAR,DF,Crystal Palace,eng Premier League,21.87945205,2003,1,5,2,2,2,1,2,3,66.7,1,0,0,0,2,7,0,0
2174,Alexsandro Ribeiro,br BRA,DF,Lille,fr Ligue 1,25.73424658,1999,27,31,18,18,12,1,20,30,66.7,10,20,12,8,25,56,128,2
2175,Samuele Ricci,it ITA,MF,Torino,it Serie A,23.70136986,2001,29,32,18,15,12,5,18,26,69.2,8,21,9,12,25,57,49,2
2176,Declan Rice,eng ENG,MF,Arsenal,eng Premier League,26.30136986,1999,29.4,52,24,21,25,6,16,37,43.2,21,24,11,13,25,77,44,0
2177,Chris Richards,us USA,DF,Crystal Palace,eng Premier League,25.10136986,2000,17.4,42,27,20,17,5,23,38,60.5,15,35,13,22,10,52,96,0
2178,Amir Richardson,ma MAR,MF,Fiorentina,it Serie A,23.2739726,2002,9,24,11,12,10,2,9,19,47.4,10,10,1,9,4,28,27,1
2179,Richarlison,br BRA,FW,Tottenham,eng Premier League,27.98356164,1997,4.5,4,3,0,3,1,0,1,0,1,1,1,0,0,4,8,0
2180,Diego Rico,es ESP,DF,Getafe,es La Liga,32.19178082,1993,27.3,74,45,44,27,3,42,77,54.5,35,37,3,34,31,105,90,2
2181,Fabian Rieder,ch SUI,"MF,FW",Stuttgart,de Bundesliga,23.2109589,2002,9.6,17,14,4,9,4,7,23,30.4,16,10,1,9,10,27,7,1
2182,Luis Rioja,es ESP,FW,Alavés,es La Liga,31.54794521,1993,0.3,2,1,0,1,1,1,2,50,1,2,0,2,0,2,0,0
2183,Luis Rioja,es ESP,"MF,FW",Valencia,es La Liga,31.54794521,1993,28.6,31,20,13,12,6,13,39,33.3,26,29,1,28,22,53,41,0
2184,Rodrigo Riquelme,es ESP,"MF,DF",Atlético Madrid,es La Liga,25.08767123,2000,5.7,11,5,4,6,1,6,11,54.5,5,3,0,3,2,13,3,0
2185,Alberto Risco,es ESP,"MF,FW",Getafe,es La Liga,19.67671233,2005,0.8,4,4,2,0,2,1,6,16.7,5,2,0,2,0,4,0,0
2186,Mihailo Ristić,rs SRB,"MF,DF",Celta Vigo,es La Liga,29.50684932,1995,2.7,3,3,2,1,0,1,3,33.3,2,0,0,0,1,4,6,0
2187,Lars Ritzka,de GER,"DF,MF",St. Pauli,de Bundesliga,26.99178082,1998,8.7,46,29,26,15,5,22,37,59.5,15,14,2,12,9,55,35,0
2188,Gorka Rivera Alonso,es ESP,"DF,MF",Getafe,es La Liga,20.75616438,2004,0.2,2,0,0,2,0,2,2,100,0,0,0,0,0,2,0,0
2189,Sergi Roberto,es ESP,MF,Como,it Serie A,33.23561644,1992,7.7,14,8,5,5,4,5,7,71.4,2,7,1,6,9,23,14,0
2190,Andrew Robertson,sct SCO,DF,Liverpool,eng Premier League,31.14794521,1994,25.6,38,22,24,10,4,30,47,63.8,17,9,4,5,20,58,51,2
2191,Antonee Robinson,us USA,DF,Fulham,eng Premier League,27.7369863,1997,33.2,90,57,53,30,7,44,89,49.4,45,37,7,30,57,147,124,2
2192,Jay Robinson,eng ENG,"MF,FW",Southampton,eng Premier League,18.1369863,2007,0.4,2,1,2,0,0,0,0,,0,0,0,0,0,2,0,0
2193,Marc Roca,es ESP,MF,Betis,es La Liga,28.43561644,1996,10.1,20,14,10,9,1,9,17,52.9,8,17,5,12,14,34,14,2
2194,Rodri,es ESP,MF,Manchester City,eng Premier League,28.86575342,1996,0.7,2,1,1,1,0,0,0,,0,1,0,1,1,3,0,0
2195,Rodri,es ESP,FW,Betis,es La Liga,24.96712329,2000,1.3,2,1,1,1,0,1,2,50,1,2,1,1,1,3,1,1
2196,Adrian Rodriguez,es ESP,GK,Alavés,es La Liga,24.39178082,2000,1.4,0,0,0,0,0,0,1,0,1,0,0,0,0,0,3,1
2197,Álvaro Rodríguez,uy URU,FW,Getafe,es La Liga,20.80547945,2004,7.9,9,6,0,6,3,4,8,50,4,21,0,21,3,12,12,0
2198,Óscar Rodríguez Arnaiz,es ESP,"MF,FW",Leganés,es La Liga,26.84931507,1998,13.6,30,15,10,14,6,13,28,46.4,15,9,1,8,18,48,18,0
2199,Damián Rodríguez,es ESP,MF,Celta Vigo,es La Liga,22.13150685,2003,9.8,14,9,3,10,1,6,16,37.5,10,6,1,5,6,20,11,0
2200,Dani Rodríguez,es ESP,"MF,FW",Mallorca,es La Liga,36.90958904,1988,21.1,42,25,13,19,10,13,26,50,13,19,2,17,12,54,22,0
2201,Daniel Rodriguez,es ESP,FW,Barcelona,es La Liga,19.73424658,2005,0.4,0,0,0,0,0,0,0,,0,1,0,1,0,0,0,0
2202,Guido Rodríguez,ar ARG,MF,West Ham,eng Premier League,31.06027397,1994,11.3,30,16,19,11,0,14,30,46.7,16,21,9,12,12,42,28,1
2203,James Rodríguez,co COL,"MF,FW",Rayo Vallecano,es La Liga,33.8109589,1991,1.6,3,2,1,2,0,0,2,0,2,2,0,2,1,4,0,0
2204,Javi Rodríguez,es ESP,DF,Celta Vigo,es La Liga,21.85479452,2003,23.4,45,33,30,15,0,28,40,70,12,27,8,19,31,76,85,1
2205,Jesus Rodríguez,es ESP,FW,Betis,es La Liga,19.44931507,2005,10.2,15,13,6,5,4,5,11,45.5,6,13,0,13,6,21,2,0
2206,Kirian Rodríguez,es ESP,MF,Las Palmas,es La Liga,29.16438356,1996,19.5,33,17,12,18,3,22,43,51.2,21,22,4,18,10,43,21,0
2207,Ricardo Rodríguez,ch SUI,DF,Betis,es La Liga,32.69041096,1992,11.3,24,12,13,4,7,16,24,66.7,8,8,1,7,6,30,38,0
2208,Rodrygo,br BRA,"FW,MF",Real Madrid,es La Liga,24.31506849,2001,21.4,21,14,14,5,2,7,23,30.4,16,18,1,17,11,32,9,0
2209,Mads Roerslev,dk DEN,DF,Brentford,eng Premier League,25.86027397,1999,12.2,18,8,14,3,1,11,28,39.3,17,12,5,7,4,22,35,0
2210,Mads Roerslev,dk DEN,DF,Wolfsburg,de Bundesliga,25.86027397,1999,3,10,9,8,1,1,6,9,66.7,3,2,2,0,5,15,14,0
2211,Morgan Rogers,eng ENG,"FW,MF",Aston Villa,eng Premier League,22.77260274,2002,31.7,36,18,13,13,10,19,39,48.7,20,25,7,18,5,41,19,2
2212,Merlin Röhl,de GER,"MF,FW",Freiburg,de Bundesliga,22.83013699,2002,10.4,16,10,4,10,2,9,11,81.8,2,7,1,6,5,21,2,0
2213,Alessio Romagnoli,it ITA,DF,Lazio,it Serie A,30.30684932,1995,25.7,43,27,17,24,2,21,26,80.8,5,27,12,15,23,66,104,1
2214,Leo Román,es ESP,GK,Mallorca,es La Liga,24.82739726,2000,6,0,0,0,0,0,0,0,,0,0,0,0,0,0,4,0
2215,Carlos Romero,es ESP,DF,Espanyol,es La Liga,23.51232877,2001,23.4,58,36,42,13,3,36,67,53.7,31,39,12,27,22,80,87,1
2216,Cristian Romero,ar ARG,DF,Tottenham,eng Premier League,27.01917808,1998,15.7,35,29,26,8,1,21,30,70,9,18,3,15,21,56,57,2
2217,Isaac Romero,es ESP,FW,Sevilla,es La Liga,24.96164384,2000,23,12,6,3,4,5,2,15,13.3,13,16,1,15,7,19,26,0
2218,Luka Romero,ar ARG,"FW,MF",Alavés,es La Liga,20.45753425,2004,2.2,4,4,1,1,2,2,3,66.7,1,2,0,2,1,5,0,0
2219,Oriol Romeu,es ESP,MF,Girona,es La Liga,33.60821918,1991,13.7,32,22,13,16,3,12,22,54.5,10,19,6,13,11,43,17,3
2220,Valentin Rongier,fr FRA,"MF,DF",Marseille,fr Ligue 1,30.40547945,1994,15.9,43,23,12,27,4,22,38,57.9,16,29,8,21,30,73,27,5
2221,Marten de Roon,nl NED,"MF,DF",Atalanta,it Serie A,34.09863014,1991,31,66,42,27,36,3,24,58,41.4,34,34,7,27,42,108,56,1
2222,Vitor Roque,br BRA,FW,Betis,es La Liga,20.17808219,2005,13.7,11,6,1,6,4,1,5,20,4,5,0,5,7,18,4,0
2223,Pablo Rosario,nl NED,"MF,DF",Nice,fr Ligue 1,28.32054795,1997,19,29,19,6,18,5,11,20,55,9,19,11,8,30,59,43,2
2224,Lasse Rosenboom,de GER,DF,Holstein Kiel,de Bundesliga,23.28767123,2002,16.6,38,26,20,14,4,27,38,71.1,11,26,8,18,17,55,64,2
2225,Max Rosenfelder,de GER,DF,Freiburg,de Bundesliga,22.22739726,2003,11.6,23,15,15,8,0,12,15,80,3,15,9,6,6,29,60,0
2226,Valentin Rosier,fr FRA,DF,Leganés,es La Liga,28.70684932,1996,27.1,69,51,48,15,6,41,66,62.1,25,39,14,25,50,119,143,2
2227,Tom Rothe,de GER,"DF,MF",Union Berlin,de Bundesliga,20.51232877,2004,16.9,41,24,25,13,3,27,47,57.4,20,38,3,35,16,57,49,1
2228,Anthony Rouault,fr FRA,DF,Rennes,fr Ligue 1,23.93150685,2001,8.8,9,6,7,2,0,4,4,100,0,12,10,2,7,16,57,0
2229,Anthony Rouault,fr FRA,DF,Stuttgart,de Bundesliga,23.93150685,2001,13.5,15,11,10,3,2,10,15,66.7,5,18,9,9,19,34,63,1
2230,Jonas Rouhi,se SWE,DF,Juventus,it Serie A,21.32054795,2004,2.3,4,1,1,3,0,0,1,0,1,2,0,2,3,7,2,0
2231,Jérôme Roussillon,fr FRA,"DF,MF",Union Berlin,de Bundesliga,32.32328767,1993,1.5,0,0,0,0,0,0,2,0,2,0,0,0,2,2,7,0
2232,Nicolò Rovella,it ITA,MF,Lazio,it Serie A,23.41369863,2001,26.8,74,42,32,35,7,34,66,51.5,32,18,4,14,44,118,41,3
2233,Jon Rowe,eng ENG,"FW,MF",Marseille,fr Ligue 1,22.0109589,2003,7.5,11,10,2,3,6,4,9,44.4,5,2,1,1,1,12,1,0
2234,Amir Rrahmani,xk KVX,DF,Napoli,it Serie A,31.1890411,1994,34.8,36,28,18,17,1,15,24,62.5,9,41,24,17,25,61,164,2
2235,Tommaso Rubino,it ITA,MF,Fiorentina,it Serie A,18.47945205,2006,0.1,0,0,0,0,0,0,1,0,1,0,0,0,0,0,0,0
2236,Antonio Rüdiger,de GER,DF,Real Madrid,es La Liga,32.16986301,1993,25.5,20,13,14,6,0,11,15,73.3,4,22,14,8,9,29,96,1
2237,Matteo Ruggeri,it ITA,DF,Atalanta,it Serie A,22.81369863,2002,17.7,38,23,15,13,10,25,35,71.4,10,27,3,24,16,54,39,1
2238,Aitor Ruibal,es ESP,"DF,FW",Betis,es La Liga,29.11780822,1996,11,21,15,15,3,3,16,27,59.3,11,15,4,11,11,32,27,0
2239,Abel Ruiz,es ESP,FW,Girona,es La Liga,25.2630137,2000,13.6,6,2,2,2,2,2,5,40,3,7,2,5,4,10,7,0
2240,Ferrán Ruiz,es ESP,MF,Girona,es La Liga,22.02191781,2003,0.2,0,0,0,0,0,0,0,,0,2,1,1,1,1,0,0
2241,Fabián Ruiz Peña,es ESP,MF,Paris S-G,fr Ligue 1,29.08493151,1996,20.7,36,23,13,15,8,20,46,43.5,26,24,3,21,16,52,27,1
2242,Gerónimo Rulli,ar ARG,GK,Marseille,fr Ligue 1,32.95616438,1992,31,3,2,3,0,0,3,7,42.9,4,1,0,1,1,4,25,2
2243,Georginio Rutter,fr FRA,"MF,FW",Brighton,eng Premier League,23.03835616,2002,18.4,39,15,13,18,8,14,36,38.9,22,20,3,17,10,49,13,2
2244,Mathew Ryan,au AUS,GK,Lens,fr Ligue 1,33.07123288,1992,11,1,0,1,0,0,1,2,50,1,0,0,0,0,1,1,2
2245,Julian Ryerson,no NOR,DF,Dortmund,de Bundesliga,27.46027397,1997,23.1,42,27,25,11,6,23,40,57.5,17,28,2,26,18,60,25,1
2246,Frederik Rønnow,dk DEN,GK,Union Berlin,de Bundesliga,32.74794521,1992,27,0,0,0,0,0,0,1,0,1,0,0,0,0,0,19,2
2247,José Sá,pt POR,GK,Wolves,eng Premier League,32.29315068,1993,27,2,2,2,0,0,2,2,100,0,0,0,0,0,2,14,1
2248,Elias Saad,tn TUN,"FW,MF",St. Pauli,de Bundesliga,25.35068493,1999,10,20,13,7,8,5,10,20,50,10,14,0,14,3,23,1,0
2249,Youssouf Sabaly,sn SEN,DF,Betis,es La Liga,32.16438356,1993,16.4,36,24,19,14,3,23,30,76.7,7,19,3,16,13,49,38,0
2250,Emmanuel Sabbi,us USA,"FW,MF",Le Havre,fr Ligue 1,27.35890411,1997,7.3,14,7,7,4,3,5,8,62.5,3,2,0,2,3,17,4,0
2251,Stefano Sabelli,it ITA,DF,Genoa,it Serie A,32.30410959,1993,20.5,55,29,26,24,5,19,46,41.3,27,28,7,21,20,75,59,0
2252,Marcel Sabitzer,at AUT,"MF,FW",Dortmund,de Bundesliga,31.13150685,1994,16.5,27,17,7,14,6,15,25,60,10,18,6,12,10,37,29,1
2253,Falaye Sacko,ml MLI,DF,Montpellier,fr Ligue 1,30.00821918,1995,12.7,14,8,9,4,1,9,19,47.4,10,17,7,10,12,26,21,0
2254,Umar Sadiq,ng NGA,FW,Valencia,es La Liga,28.24931507,1997,7.5,9,5,2,5,2,4,6,66.7,2,5,0,5,1,10,6,0
2255,Umar Sadiq,ng NGA,FW,Real Sociedad,es La Liga,28.24931507,1997,2.5,2,1,1,1,0,1,2,50,1,3,1,2,1,3,2,0
2256,Alexis Saelemaekers,be BEL,"DF,FW",Roma,it Serie A,25.85205479,1999,13.5,30,17,21,6,3,16,30,53.3,14,12,1,11,7,37,8,1
2257,Alexis Saelemaekers,be BEL,"DF,FW",Milan,it Serie A,25.85205479,1999,1,1,1,0,0,1,1,1,100,0,0,0,0,1,2,0,0
2258,Jorge Sáenz,es ESP,DF,Leganés,es La Liga,28.46027397,1996,13.8,26,17,12,13,1,7,13,53.8,6,18,10,8,20,46,120,0
2259,Matvei Safonov,ru RUS,GK,Paris S-G,fr Ligue 1,26.18630137,1999,9.8,0,0,0,0,0,0,0,,0,1,0,1,1,1,3,0
2260,Modibo Sagnan,ml MLI,DF,Montpellier,fr Ligue 1,26.05479452,1999,22.3,56,34,37,16,3,26,44,59.1,18,24,13,11,26,82,109,5
2261,Richie Sagrado,be BEL,DF,Venezia,it Serie A,21.25753425,2004,1.6,2,2,1,1,0,1,1,100,0,1,0,1,3,5,4,0
2262,Osame Sahraoui,ma MAR,"FW,MF",Lille,fr Ligue 1,23.89589041,2001,13.5,11,8,3,3,5,2,7,28.6,5,11,1,10,7,18,8,1
2263,Wesley Saïd,fr FRA,FW,Lens,fr Ligue 1,30.04109589,1995,9.9,15,11,2,10,3,5,12,41.7,7,6,0,6,2,17,2,0
2264,Théo Sainte-Luce,fr FRA,DF,Montpellier,fr Ligue 1,26.5369863,1998,9.8,24,11,16,4,4,16,31,51.6,15,15,4,11,10,34,30,1
2265,Bukayo Saka,eng ENG,"FW,MF",Arsenal,eng Premier League,23.66027397,2001,17.1,24,13,7,10,7,11,22,50,11,21,0,21,3,27,8,0
2266,Faik Sakar,de GER,MF,RB Leipzig,de Bundesliga,17.30136986,2008,0,0,0,0,0,0,0,0,,0,0,0,0,0,0,0,0
2267,Marco Sala,it ITA,DF,Como,it Serie A,25.91506849,1999,2.9,9,6,5,3,1,5,8,62.5,3,2,0,2,1,10,9,0
2268,Marco Sala,it ITA,DF,Lecce,it Serie A,25.91506849,1999,0.8,1,0,0,1,0,0,1,0,1,1,0,1,0,1,0,0
2269,Ibrahim Salah,ma MAR,FW,Brest,fr Ligue 1,23.67671233,2001,4,4,2,1,1,2,1,6,16.7,5,2,0,2,2,6,0,0
2270,Mohamed Salah,eg EGY,FW,Liverpool,eng Premier League,32.88493151,1992,33.5,20,11,7,5,8,7,16,43.8,9,11,0,11,7,27,5,0
2271,Anass Salah-Eddine,nl NED,DF,Roma,it Serie A,23.29041096,2002,1.7,1,1,1,0,0,0,0,,0,0,0,0,1,2,2,2
2272,Amine Salama,fr FRA,FW,Reims,fr Ligue 1,24.79452055,2000,4.1,3,2,0,2,1,0,3,0,3,2,1,1,1,4,0,0
2273,Jan Salas,es ESP,MF,Mallorca,es La Liga,19.73150685,2005,0.3,2,1,1,1,0,1,1,100,0,0,0,0,0,2,0,0
2274,Kike Salas,es ESP,DF,Sevilla,es La Liga,23.03013699,2002,20.4,38,23,18,14,6,22,35,62.9,13,21,11,10,29,67,125,0
2275,Manolis Saliakas,gr GRE,"MF,DF",St. Pauli,de Bundesliga,28.64109589,1996,24,43,21,22,17,4,24,47,51.1,23,36,8,28,19,62,59,0
2276,William Saliba,fr FRA,DF,Arsenal,eng Premier League,24.11232877,2001,32.3,60,36,35,23,2,21,27,77.8,6,24,15,9,21,81,111,6
2277,Mohammed Salisu,gh GHA,DF,Monaco,fr Ligue 1,26.04657534,1999,11.4,28,18,16,11,1,13,16,81.3,3,10,8,2,16,44,54,2
2278,Roland Sallai,hu HUN,"FW,MF",Freiburg,de Bundesliga,27.95068493,1997,0.5,2,1,1,1,0,0,0,,0,0,0,0,1,3,0,0
2279,Yoann Salmier,gf GUF,DF,Le Havre,fr Ligue 1,32.44931507,1992,8.9,14,7,9,4,1,10,13,76.9,3,12,8,4,10,24,59,0
2280,Lazar Samardzic,rs SRB,"MF,FW",Atalanta,it Serie A,23.1890411,2002,11.7,18,12,4,6,8,10,21,47.6,11,8,1,7,2,20,6,0
2281,Diadie Samassékou,ml MLI,MF,Hoffenheim,de Bundesliga,29.30958904,1996,3.2,5,5,1,2,2,2,4,50,2,4,2,2,5,10,5,0
2282,Mama Samba Baldé,gw GNB,FW,Lyon,fr Ligue 1,29.49041096,1995,0.4,2,2,0,2,0,0,0,,0,0,0,0,1,3,1,0
2283,Mama Samba Baldé,gw GNB,FW,Brest,fr Ligue 1,29.49041096,1995,12.6,12,8,4,3,5,3,13,23.1,10,7,0,7,6,18,14,0
2284,Brice Samba,fr FRA,GK,Rennes,fr Ligue 1,31.02465753,1994,15,2,1,2,0,0,1,1,100,0,0,0,0,0,2,11,2
2285,Brice Samba,fr FRA,GK,Lens,fr Ligue 1,31.02465753,1994,15,0,0,0,0,0,0,0,,0,0,0,0,1,1,6,2
2286,Albert Sambi Lokonga,be BEL,MF,Sevilla,es La Liga,25.53150685,1999,15.6,21,15,10,9,2,10,13,76.9,3,12,1,11,9,30,24,3
2287,Junior Sambia,fr FRA,"DF,FW",Empoli,it Serie A,28.65479452,1996,3.5,12,9,3,4,5,10,10,100,0,2,0,2,2,14,4,0
2288,Chuky san jose,es ESP,MF,Valladolid,es La Liga,21.01369863,2004,7.2,8,2,3,3,2,2,9,22.2,7,4,1,3,0,8,2,0
2289,Antonio Sanabria,py PAR,FW,Torino,it Serie A,29.16712329,1996,14.4,3,3,1,1,1,1,4,25,3,6,1,5,1,4,13,0
2290,Oihan Sancet,es ESP,MF,Athletic Club,es La Liga,25.02465753,2000,16.3,12,7,6,5,1,4,12,33.3,8,9,0,9,5,17,5,0
2291,Alexis Sánchez,cl CHI,FW,Udinese,it Serie A,36.37260274,1988,4.1,3,1,0,2,1,1,5,20,4,4,0,4,3,6,0,1
2292,Antonio Sánchez,es ESP,"MF,DF",Mallorca,es La Liga,28.3369863,1997,12.9,26,16,15,7,4,14,28,50,14,12,2,10,16,42,29,0
2293,Iván Sánchez,es ESP,"MF,FW",Valladolid,es La Liga,32.6109589,1992,14,34,20,17,9,8,11,26,42.3,15,18,3,15,13,47,10,0
2294,Javi Sánchez,es ESP,DF,Valladolid,es La Liga,28.13972603,1997,22.5,26,16,19,6,1,17,26,65.4,9,39,28,11,22,48,111,3
2295,Juanlu Sánchez,es ESP,"MF,DF",Sevilla,es La Liga,21.71780822,2003,15,35,25,20,12,3,25,39,64.1,14,17,0,17,10,45,15,0
2296,Manu Sánchez,es ESP,DF,Alavés,es La Liga,24.69315068,2000,25.5,69,45,34,25,10,35,57,61.4,22,46,9,37,28,97,61,1
2297,Robert Sánchez,es ESP,GK,Chelsea,eng Premier League,27.45753425,1997,28,0,0,0,0,0,0,1,0,1,0,0,0,2,2,20,9
2298,Jadon Sancho,eng ENG,FW,Chelsea,eng Premier League,25.10958904,2000,18.5,10,6,3,2,5,5,12,41.7,7,9,0,9,2,12,6,2
2299,Philipp Sander,de GER,MF,Gladbach,de Bundesliga,27.19726027,1998,14,32,16,16,14,2,10,21,47.6,11,15,6,9,21,53,42,3
2300,James Sands,us USA,"MF,DF",St. Pauli,de Bundesliga,24.82739726,2000,5,15,6,5,8,2,4,4,100,0,5,1,4,5,20,8,0
2301,Leroy Sané,de GER,FW,Bayern Munich,de Bundesliga,29.30958904,1996,17.5,21,14,4,8,9,11,21,52.4,10,8,0,8,7,28,3,0
2302,Arouna Sangante,sn SEN,DF,Le Havre,fr Ligue 1,23.06027397,2002,11.1,20,14,10,10,0,9,14,64.3,5,10,5,5,19,39,49,1
2303,Ibrahim Sangaré,ci CIV,MF,Nott'ham Forest,eng Premier League,27.41917808,1997,3.3,18,10,5,12,1,4,10,40,6,5,0,5,3,21,4,0
2304,Nhoa Sangui,fr FRA,"DF,MF",Reims,fr Ligue 1,19.18082192,2006,12.1,16,9,6,6,4,9,12,75,3,8,4,4,6,22,23,0
2305,Maroan Sannadi,es ESP,FW,Athletic Club,es La Liga,24.25205479,2001,5.3,1,0,1,0,0,1,4,25,3,1,0,1,0,1,1,0
2306,Kaishu Sano,jp JPN,MF,Mainz 05,de Bundesliga,24.34246575,2000,30.8,55,33,19,28,8,21,44,47.7,23,59,13,46,55,110,53,1
2307,Morgan Sanson,fr FRA,MF,Nice,fr Ligue 1,30.70958904,1994,2,4,2,1,3,0,0,2,0,2,2,0,2,4,8,2,0
2308,Nicola Sansone,it ITA,"MF,FW",Lecce,it Serie A,33.64657534,1991,0.7,0,0,0,0,0,0,0,,0,0,0,0,0,0,0,0
2309,Baptiste Santamaria,fr FRA,MF,Nice,fr Ligue 1,30.15342466,1995,9.5,19,9,9,7,3,13,21,61.9,8,14,3,11,16,35,19,1
2310,Baptiste Santamaria,fr FRA,MF,Rennes,fr Ligue 1,30.15342466,1995,5.4,11,4,7,3,1,6,11,54.5,5,10,4,6,12,23,7,0
2311,Jesús Santiago,es ESP,MF,Getafe,es La Liga,20.94246575,2004,3.6,12,7,6,6,0,5,9,55.6,4,5,2,3,1,13,3,0
2312,Andrey Santos,br BRA,MF,Strasbourg,fr Ligue 1,21.00273973,2004,29.7,106,71,45,49,12,48,84,57.1,36,45,14,31,28,134,67,1
2313,Kauã Santos,br BRA,GK,Eint Frankfurt,de Bundesliga,22.0630137,2003,8.5,0,0,0,0,0,0,0,,0,0,0,0,0,0,10,2
2314,Tiago Santos,pt POR,DF,Lille,fr Ligue 1,22.78082192,2002,4.5,12,7,4,5,3,6,9,66.7,3,2,0,2,2,14,4,0
2315,Pablo Sarabia,es ESP,"MF,FW",Wolves,eng Premier League,32.98082192,1992,8,15,8,4,8,3,9,14,64.3,5,10,0,10,4,19,7,1
2316,Jeremy Sarmiento,ec ECU,MF,Brighton,eng Premier League,22.88219178,2002,0.1,0,0,0,0,0,0,0,,0,0,0,0,0,0,0,0
2317,Amin Sarr,se SWE,FW,Hellas Verona,it Serie A,24.14794521,2001,18.7,21,12,3,8,10,5,9,55.6,4,17,3,14,2,23,14,0
2318,Ismaila Sarr,sn SEN,"MF,FW",Crystal Palace,eng Premier League,27.18630137,1998,26.6,21,10,9,9,3,7,23,30.4,16,22,7,15,8,29,34,0
2319,Malang Sarr,fr FRA,DF,Lens,fr Ligue 1,26.27671233,1999,15.4,21,13,12,6,3,16,27,59.3,11,18,9,9,22,43,63,3
2320,Mamadou Sarr,fr FRA,DF,Strasbourg,fr Ligue 1,19.67945205,2005,24.3,32,20,21,10,1,15,23,65.2,8,25,20,5,23,55,109,2
2321,Martin Satriano,uy URU,"FW,DF",Lens,fr Ligue 1,24.2,2001,0.5,3,1,1,1,1,3,3,100,0,0,0,0,0,3,2,0
2322,Razvan Sava,ro ROU,GK,Udinese,it Serie A,22.86849315,2002,12,0,0,0,0,0,0,0,,0,0,0,0,0,0,6,2
2323,Téji Savanier,fr FRA,MF,Montpellier,fr Ligue 1,33.36438356,1991,24.4,28,23,7,16,5,17,40,42.5,23,16,1,15,13,41,21,4
2324,Sávio,br BRA,"FW,MF",Manchester City,eng Premier League,21.06575342,2004,19.3,22,16,5,10,7,9,18,50,9,13,2,11,6,28,9,1
2325,Nicolò Savona,it ITA,DF,Juventus,it Serie A,22.1260274,2003,16.2,27,13,18,8,1,13,24,54.2,11,7,1,6,7,34,25,0
2326,Saba Sazonov,ge GEO,DF,Torino,it Serie A,23.25205479,2002,0,0,0,0,0,0,0,0,,0,1,1,0,0,0,0,0
2327,Joe Scally,us USA,DF,Gladbach,de Bundesliga,22.33972603,2002,27.9,42,30,23,17,2,26,45,57.8,19,33,11,22,16,58,84,2
2328,Giorgio Scalvini,it ITA,DF,Atalanta,it Serie A,21.39452055,2003,3,8,4,5,3,0,5,9,55.6,4,0,0,0,4,12,7,0
2329,Gianluca Scamacca,it ITA,FW,Atalanta,it Serie A,26.3369863,1999,0.1,0,0,0,0,0,0,0,,0,0,0,0,0,0,0,0
2330,Oliver Scarles,eng ENG,DF,West Ham,eng Premier League,19.39178082,2005,6.6,17,11,13,3,1,13,21,61.9,8,14,2,12,10,27,24,0
2331,Dane Scarlett,eng ENG,"FW,MF",Tottenham,eng Premier League,21.11232877,2004,0.4,1,0,0,1,0,0,0,,0,0,0,0,0,1,1,0
2332,Kevin Schade,de GER,FW,Brentford,eng Premier League,23.43287671,2001,22.2,34,23,14,9,11,12,20,60,8,15,2,13,5,39,31,0
2333,András Schäfer,hu HUN,MF,Union Berlin,de Bundesliga,26.05753425,1999,16.2,47,25,22,20,5,23,38,60.5,15,33,6,27,22,69,35,0
2334,Fabian Schär,ch SUI,DF,Newcastle Utd,eng Premier League,33.36986301,1991,28.6,32,19,15,15,2,14,34,41.2,20,36,24,12,40,72,113,3
2335,Patrik Schick,cz CZE,FW,Leverkusen,de Bundesliga,29.2739726,1996,16.4,6,5,1,3,2,1,5,20,4,6,0,6,2,8,14,1
2336,Stefan Schimmer,de GER,"FW,MF",Heidenheim,de Bundesliga,31.01643836,1994,2.7,2,0,1,1,0,1,2,50,1,1,0,1,0,2,4,0
2337,Joël Schingtienne,be BEL,DF,Venezia,it Serie A,22.7260274,2002,9.7,20,12,15,4,1,10,16,62.5,6,15,7,8,11,31,18,3
2338,Xaver Schlager,at AUT,MF,RB Leipzig,de Bundesliga,27.59726027,1997,2,4,2,2,1,1,3,7,42.9,4,7,0,7,0,4,3,0
2339,Keven Schlotterbeck,de GER,DF,Augsburg,de Bundesliga,28.01643836,1997,14.4,19,17,9,9,1,12,16,75,4,13,6,7,15,34,73,1
2340,Nico Schlotterbeck,de GER,DF,Dortmund,de Bundesliga,25.42191781,1999,22,38,24,21,16,1,27,45,60,18,31,15,16,22,60,79,1
2341,Jeffrey Schlupp,gh GHA,"MF,DF",Crystal Palace,eng Premier League,32.36164384,1992,1.1,2,0,1,0,1,0,3,0,3,6,0,6,0,2,2,0
2342,Romano Schmid,at AUT,MF,Werder Bremen,de Bundesliga,25.26575342,2000,29.5,40,23,10,20,10,21,45,46.7,24,42,3,39,11,51,9,2
2343,Niklas Schmidt,de GER,MF,Toulouse,fr Ligue 1,27.17534247,1998,2.3,6,4,1,5,0,4,7,57.1,3,0,0,0,1,7,4,0
2344,Jan Schöppner,de GER,MF,Heidenheim,de Bundesliga,25.89315068,1999,28.3,52,29,17,26,9,19,57,33.3,38,37,6,31,43,95,89,1
2345,Marvin Schulz,de GER,"MF,DF",Holstein Kiel,de Bundesliga,30.29863014,1995,3.2,5,4,2,2,1,2,8,25,6,10,6,4,0,5,15,0
2346,Alexander Schwolow,de GER,GK,Union Berlin,de Bundesliga,32.92054795,1992,5,0,0,0,0,0,0,0,,0,0,0,0,0,0,1,0
2347,Léo Scienza,br BRA,"FW,MF",Heidenheim,de Bundesliga,26.63835616,1998,12.3,16,11,9,5,2,6,17,35.3,11,13,1,12,5,21,9,1
2348,Alex Scott,eng ENG,MF,Bournemouth,eng Premier League,21.70136986,2003,7.9,26,13,10,8,8,18,40,45,22,17,4,13,10,36,13,0
2349,Simone Scuffet,it ITA,GK,Cagliari,it Serie A,28.9260274,1996,13,0,0,0,0,0,0,1,0,1,0,0,0,0,0,8,2
2350,Simone Scuffet,it ITA,GK,Napoli,it Serie A,28.9260274,1996,1,0,0,0,0,0,0,0,,0,0,0,0,0,0,2,0
2351,Jérémy Sebas,mq MTQ,"FW,MF",Strasbourg,fr Ligue 1,22.05479452,2003,2.1,3,2,1,1,1,2,3,66.7,1,2,0,2,0,3,4,0
2352,Aleksandar Sedlar,rs SRB,DF,Alavés,es La Liga,33.3890411,1991,5.7,17,9,7,10,0,8,10,80,2,2,1,1,9,26,18,1
2353,Jacopo Seghetti,it ITA,GK,Empoli,it Serie A,20.20821918,2005,1,0,0,0,0,0,0,0,,0,0,0,0,0,0,0,0
2354,Alidu Seidu,gh GHA,DF,Rennes,fr Ligue 1,24.91506849,2000,8.9,22,18,14,6,2,12,15,80,3,13,6,7,14,36,17,0
2355,Nicolas Seiwald,at AUT,"MF,DF",RB Leipzig,de Bundesliga,24,2001,21.2,49,29,18,26,5,24,48,50,24,38,8,30,29,78,67,2
2356,Hiroki Sekine,jp JPN,DF,Reims,fr Ligue 1,22.72876712,2002,7.9,8,6,5,2,1,6,15,40,9,13,6,7,5,13,45,1
2357,Matz Sels,be BEL,GK,Nott'ham Forest,eng Premier League,33.18356164,1992,34,1,1,1,0,0,1,1,100,0,0,0,0,0,1,22,1
2358,Nélson Semedo,pt POR,DF,Wolves,eng Premier League,31.4630137,1993,29.6,58,34,31,20,7,30,53,56.6,23,28,10,18,23,81,100,3
2359,Antoine Semenyo,gh GHA,FW,Bournemouth,eng Premier League,25.32054795,2000,32.6,53,34,16,24,13,16,42,38.1,26,59,8,51,10,63,35,1
2360,Marvin Senaya,tg TOG,DF,Strasbourg,fr Ligue 1,24.2630137,2001,2.5,8,3,5,2,1,6,12,50,6,6,2,4,7,15,12,0
2361,Marcos Senesi,ar ARG,DF,Bournemouth,eng Premier League,27.98356164,1997,11.3,35,21,22,11,2,14,30,46.7,16,15,7,8,11,46,54,0
2362,Stefano Sensi,it ITA,MF,Monza,it Serie A,29.74520548,1995,2.5,8,5,4,4,0,5,6,83.3,1,3,2,1,3,11,2,1
2363,Suat Serdar,de GER,MF,Hellas Verona,it Serie A,28.0630137,1997,12.9,29,18,9,17,3,8,21,38.1,13,15,4,11,8,37,18,0
2364,Sergi,es ESP,DF,Leganés,es La Liga,33.03835616,1992,30.5,36,27,20,15,1,16,29,55.2,13,35,28,7,38,74,172,2
2365,Nicolás Serrano,es ESP,FW,Athletic Club,es La Liga,22.16438356,2003,1.2,1,1,0,1,0,1,3,33.3,2,4,0,4,1,2,1,0
2366,Benjamin Šeško,si SVN,"FW,MF",RB Leipzig,de Bundesliga,21.9260274,2003,25.6,7,3,0,4,3,3,11,27.3,8,14,4,10,5,12,20,0
2367,Ryan Sessegnon,eng ENG,"FW,DF",Fulham,eng Premier League,24.96164384,2000,5.2,21,11,8,8,5,6,15,40,9,11,0,11,3,24,11,0
2368,Stephan El Shaarawy,it ITA,"DF,MF",Roma,it Serie A,32.51780822,1992,11.7,16,12,4,6,6,6,12,50,6,4,0,4,10,26,12,0
2369,Luke Shaw,eng ENG,DF,Manchester Utd,eng Premier League,29.8109589,1995,1.9,3,2,2,1,0,1,1,100,0,2,1,1,2,5,4,0
2370,Alen Sherri,al ALB,GK,Cagliari,it Serie A,27.38356164,1997,6,1,0,1,0,0,1,2,50,1,0,0,0,0,1,1,0
2371,Eldor Shomurodov,uz UZB,"FW,MF",Roma,it Serie A,29.84657534,1995,8.8,11,4,2,6,3,3,5,60,2,8,0,8,1,12,2,0
2372,Djibril Sidibé,fr FRA,DF,Toulouse,fr Ligue 1,32.76438356,1992,21.6,60,33,31,20,9,29,47,61.7,18,9,2,7,19,79,55,1
2373,Armindo Sieb,de GER,"FW,MF",Mainz 05,de Bundesliga,22.20821918,2003,8.5,10,4,4,5,1,3,10,30,7,4,0,4,1,11,7,0
2374,Vincent Sierro,ch SUI,MF,Toulouse,fr Ligue 1,29.56986301,1995,24.7,44,27,15,23,6,27,54,50,27,32,7,25,15,59,42,1
2375,Tim Siersleben,de GER,DF,Heidenheim,de Bundesliga,25.15342466,2000,11.1,20,13,12,7,1,7,17,41.2,10,16,6,10,17,37,57,0
2376,Zain Silcott-Duberry,ms MSR,FW,Bournemouth,eng Premier League,19.81917808,2005,0,1,1,0,0,1,1,1,100,0,0,0,0,0,1,0,0
2377,Kiliann Sildillia,fr FRA,DF,Freiburg,de Bundesliga,22.96712329,2002,8.9,17,10,8,6,3,7,13,53.8,6,16,5,11,11,28,37,0
2378,André Silva,pt POR,FW,Werder Bremen,de Bundesliga,29.49041096,1995,4.2,2,2,1,1,0,0,1,0,1,3,1,2,0,2,3,0
2379,André Silva,pt POR,"FW,MF",RB Leipzig,de Bundesliga,29.49041096,1995,1.5,1,1,1,0,0,0,1,0,1,1,0,1,1,2,2,0
2380,Bernardo Silva,pt POR,"MF,FW",Manchester City,eng Premier League,30.73150685,1994,26.7,52,34,15,28,9,24,52,46.2,28,33,7,26,20,72,28,3
2381,Caio Henrique Oliveira Silva,br BRA,DF,Monaco,fr Ligue 1,27.75890411,1997,19.4,36,26,15,19,2,23,42,54.8,19,22,6,16,20,56,51,0
2382,Fábio Silva,pt POR,FW,Las Palmas,es La Liga,22.79178082,2002,20.7,12,7,4,5,3,4,14,28.6,10,12,0,12,4,16,27,0
2383,Jota Silva,pt POR,"FW,MF",Nott'ham Forest,eng Premier League,25.75616438,1999,9.4,25,13,12,11,2,5,25,20,20,9,1,8,12,37,17,0
2384,Eric da Silva Moreira,de GER,"MF,DF",Nott'ham Forest,eng Premier League,19.00273973,2006,0.3,2,2,2,0,0,2,6,33.3,4,0,0,0,1,3,0,0
2385,Rui Silva,pt POR,GK,Betis,es La Liga,31.23561644,1994,15,0,0,0,0,0,0,1,0,1,1,0,1,0,0,7,0
2386,Marco Silvestri,it ITA,GK,Empoli,it Serie A,34.17260274,1991,5,0,0,0,0,0,0,2,0,2,0,0,0,0,0,3,1
2387,Abdallah Sima,sn SEN,"FW,MF",Brest,fr Ligue 1,23.87945205,2001,13,13,10,2,4,7,4,10,40,6,7,0,7,1,14,9,0
2388,Mohamed Simakan,fr FRA,DF,RB Leipzig,de Bundesliga,25.00273973,2000,0.6,0,0,0,0,0,0,0,,0,0,0,0,2,2,0,0
2389,Giovanni Simeone,ar ARG,FW,Napoli,it Serie A,29.83013699,1995,4.4,2,0,0,1,1,1,6,16.7,5,9,2,7,1,3,6,0
2390,Giuliano Simeone,ar ARG,MF,Atlético Madrid,es La Liga,22.37534247,2002,19,24,12,6,8,10,14,28,50,14,19,2,17,12,36,18,0
2391,Moses Simon,ng NGA,"FW,MF",Nantes,fr Ligue 1,29.8109589,1995,26,16,10,2,6,8,7,22,31.8,15,11,0,11,11,27,13,0
2392,Unai Simón,es ESP,GK,Athletic Club,es La Liga,27.89589041,1997,16,0,0,0,0,0,0,0,,0,1,0,1,1,1,10,4
2393,Xavi Simons,nl NED,MF,RB Leipzig,de Bundesliga,22.03561644,2003,21.9,25,18,5,15,5,12,25,48,13,16,3,13,12,37,17,1
2394,Jahmai Simpson-Pusey,eng ENG,DF,Manchester City,eng Premier League,19.49589041,2005,1.1,1,0,1,0,0,0,1,0,1,1,1,0,0,1,2,0
2395,Danel Sinani,lu LUX,"FW,MF",St. Pauli,de Bundesliga,28.07945205,1997,12.2,13,10,2,7,4,6,13,46.2,7,12,1,11,1,14,12,0
2396,Lassine Sinayoko,ml MLI,"FW,MF",Auxerre,fr Ligue 1,25.40273973,1999,22.7,31,18,9,13,9,11,22,50,11,16,2,14,10,41,35,0
2397,Wilfried Singo,ci CIV,DF,Monaco,fr Ligue 1,24.35616438,2000,21.3,36,22,23,10,3,19,27,70.4,8,13,6,7,42,78,100,2
2398,Luis Sinisterra,co COL,"FW,MF",Bournemouth,eng Premier League,25.87945205,1999,2.6,7,2,3,2,2,0,4,0,4,3,0,3,1,8,8,0
2399,Daley Sinkgraven,nl NED,DF,Las Palmas,es La Liga,29.83287671,1995,1,5,1,3,2,0,1,3,33.3,2,1,0,1,1,6,2,0
2400,Tobias Sippel,de GER,GK,Gladbach,de Bundesliga,37.11780822,1988,0.7,0,0,0,0,0,0,0,,0,0,0,0,0,0,0,0
2401,Jailson Siqueira,br BRA,"DF,MF",Celta Vigo,es La Liga,29.65479452,1995,6.8,13,11,9,3,1,9,11,81.8,2,6,4,2,9,22,28,1
2402,Ayanda Sishuba,be BEL,FW,Rennes,fr Ligue 1,20.24931507,2005,0,1,0,1,0,0,1,1,100,0,0,0,0,0,1,0,0
2403,Ibrahim Sissoko,ml MLI,FW,Saint-Étienne,fr Ligue 1,29.43287671,1995,9,11,9,5,3,3,2,5,40,3,10,2,8,2,13,13,0
2404,Ibrahima Sissoko,ml MLI,MF,Bochum,de Bundesliga,27.51780822,1997,27.6,61,41,28,28,5,24,44,54.5,20,35,10,25,35,96,56,0
2405,Niama Sissoko,ml MLI,"FW,MF",Reims,fr Ligue 1,19.38082192,2005,0.5,0,0,0,0,0,0,0,,0,1,0,1,0,0,0,0
2406,Antonio Sivera,es ESP,GK,Alavés,es La Liga,28.72876712,1996,27.2,2,1,2,0,0,2,2,100,0,1,0,1,0,2,17,0
2407,Tim Skarke,de GER,"FW,MF",Union Berlin,de Bundesliga,28.65479452,1996,11.7,13,11,5,7,1,9,18,50,9,7,0,7,5,18,17,0
2408,Ellyes Skhiri,tn TUN,MF,Eint Frankfurt,de Bundesliga,29.98356164,1995,22.1,35,22,11,20,4,17,41,41.5,24,29,6,23,29,64,40,4
2409,Oliver Skipp,eng ENG,MF,Leicester City,eng Premier League,24.63013699,2000,11.1,20,4,5,12,3,9,15,60,6,17,4,13,10,30,10,1
2410,Leo Skiri Østigård,no NOR,DF,Rennes,fr Ligue 1,25.43013699,1999,13.6,20,18,16,4,0,15,22,68.2,7,12,10,2,15,35,81,1
2411,Leo Skiri Østigård,no NOR,DF,Hoffenheim,de Bundesliga,25.43013699,1999,8.3,7,6,4,3,0,3,5,60,2,14,8,6,6,13,92,0
2412,Łukasz Skorupski,pl POL,GK,Bologna,it Serie A,33.99726027,1991,23.3,1,0,1,0,0,1,3,33.3,2,0,0,0,0,1,11,2
2413,Andreas Skov Olsen,dk DEN,"FW,DF",Wolfsburg,de Bundesliga,25.34520548,1999,5.1,8,6,5,3,0,4,4,100,0,4,0,4,2,10,9,0
2414,Robert Skov,dk DEN,"DF,MF",Union Berlin,de Bundesliga,28.95616438,1996,9.5,15,11,8,7,0,10,20,50,10,8,1,7,8,23,9,0
2415,Milan Škriniar,sk SVK,DF,Paris S-G,fr Ligue 1,30.22465753,1995,4.2,7,5,3,4,0,3,3,100,0,7,6,1,3,10,16,0
2416,Steven Skrzybski,de GER,"FW,MF",Holstein Kiel,de Bundesliga,32.45753425,1992,12.4,16,4,5,6,5,7,22,31.8,15,15,0,15,10,26,9,0
2417,Naatan Skyttä,fi FIN,FW,Toulouse,fr Ligue 1,22.99178082,2002,0.1,1,0,0,0,1,0,0,,0,0,0,0,0,1,0,0
2418,William Smallbone,ie IRL,MF,Southampton,eng Premier League,25.19726027,2000,7.2,18,11,8,8,2,7,21,33.3,14,8,0,8,2,20,12,2
2419,Adam Smith,eng ENG,DF,Bournemouth,eng Premier League,34.01369863,1991,15.7,21,10,10,5,6,12,25,48,13,12,5,7,14,35,47,1
2420,Eric Smith,se SWE,"DF,MF",St. Pauli,de Bundesliga,28.31780822,1997,29.4,45,29,25,17,3,22,37,59.5,15,35,10,25,37,82,102,4
2421,Justin Smith,ca CAN,MF,Espanyol,es La Liga,22.24383562,2003,2.3,9,3,3,6,0,4,6,66.7,2,5,1,4,4,13,3,0
2422,Emile Smith Rowe,eng ENG,MF,Fulham,eng Premier League,24.76712329,2000,21,31,18,7,14,10,8,24,33.3,16,20,2,18,11,42,16,0
2423,Ivan Smolčić,hr CRO,DF,Como,it Serie A,24.71232877,2000,6,15,9,8,6,1,9,12,75,3,8,2,6,10,25,22,0
2424,Eduard Sobol,ua UKR,DF,Strasbourg,fr Ligue 1,30.03835616,1995,1.1,0,0,0,0,0,0,2,0,2,2,1,1,2,2,14,0
2425,Simon Sohm,ch SUI,MF,Parma,it Serie A,24.0630137,2001,30.6,27,16,10,13,4,15,33,45.5,18,7,1,6,24,51,33,0
2426,Alex Sola,es ESP,"MF,FW",Getafe,es La Liga,25.90136986,1999,11.4,21,14,9,12,0,9,25,36,16,8,0,8,7,28,11,1
2427,Arnau Solà,es ESP,MF,Villarreal,es La Liga,22.08219178,2003,0.1,0,0,0,0,0,0,2,0,2,1,1,0,0,0,0,0
2428,Dominic Solanke,eng ENG,FW,Tottenham,eng Premier League,27.63561644,1997,23.5,18,11,1,12,5,4,14,28.6,10,18,7,11,0,18,22,0
2429,Ola Solbakken,no NOR,"MF,FW",Empoli,it Serie A,26.65479452,1998,7.5,6,3,0,6,0,3,6,50,3,0,0,0,2,8,8,0
2430,Carlos Soler,es ESP,"MF,FW",West Ham,eng Premier League,28.33424658,1997,15,13,10,7,5,1,6,22,27.3,16,19,6,13,8,21,21,2
2431,Julio Soler,ar ARG,FW,Bournemouth,eng Premier League,20.2109589,2005,0,1,1,1,0,0,1,1,100,0,1,0,1,0,1,0,0
2432,Oumar Solet,fr FRA,DF,Udinese,it Serie A,25.23561644,2000,15.6,31,18,17,12,2,19,26,73.1,7,27,15,12,15,46,66,3
2433,Jhon Solis,co COL,MF,Girona,es La Liga,20.58356164,2004,5.2,10,5,3,6,1,5,13,38.5,8,12,1,11,4,14,6,1
2434,Yann Sommer,ch SUI,GK,Inter,it Serie A,36.37808219,1988,31,0,0,0,0,0,0,0,,0,0,0,0,0,0,11,1
2435,David Soria,es ESP,GK,Getafe,es La Liga,32.08219178,1993,34,4,4,4,0,0,4,5,80,1,0,0,0,1,5,17,2
2436,Juan Soriano,es ESP,GK,Leganés,es La Liga,27.69589041,1997,6,1,1,1,0,0,1,1,100,0,0,0,0,0,1,2,0
2437,Borna Sosa,hr CRO,DF,Torino,it Serie A,27.28219178,1998,13.1,26,19,14,7,5,16,25,64,9,13,6,7,14,40,33,0
2438,Ramón Sosa,py PAR,"FW,MF",Nott'ham Forest,eng Premier League,25.6739726,1999,3,5,3,3,0,2,1,4,25,3,7,0,7,3,8,4,0
2439,Hugo Sotelo,es ESP,MF,Celta Vigo,es La Liga,21.37260274,2003,13.1,27,17,8,10,9,12,28,42.9,16,9,1,8,4,31,8,1
2440,Florian Sotoca,fr FRA,"FW,MF",Lens,fr Ligue 1,34.52328767,1990,19.7,22,13,3,8,11,12,22,54.5,10,12,2,10,13,35,25,0
2441,Riccardo Sottil,it ITA,"FW,MF",Fiorentina,it Serie A,25.91780822,1999,9.3,5,4,3,1,1,3,4,75,1,1,0,1,4,9,3,0
2442,Riccardo Sottil,it ITA,"FW,MF",Milan,it Serie A,25.91780822,1999,1.3,1,1,1,0,0,0,0,,0,0,0,0,0,1,0,0
2443,Tomáš Souček,cz CZE,MF,West Ham,eng Premier League,30.18082192,1995,25,40,19,19,18,3,20,37,54.1,17,34,17,17,18,58,74,1
2444,Matìas Soulé,ar ARG,"MF,FW",Roma,it Serie A,22.05205479,2003,15.9,19,12,9,4,6,7,17,41.2,10,22,2,20,8,27,19,0
2445,Boubakary Soumaré,fr FRA,MF,Leicester City,eng Premier League,26.18082192,1999,21.8,33,18,21,11,1,18,30,60,12,20,8,12,24,57,31,3
2446,Issa Soumaré,sn SEN,"FW,MF",Le Havre,fr Ligue 1,24.56438356,2000,18.1,19,10,7,9,3,9,40,22.5,31,16,4,12,14,33,25,0
2447,Djibril Sow,ch SUI,MF,Sevilla,es La Liga,28.23835616,1997,20.7,21,12,11,9,1,7,16,43.8,9,15,2,13,22,43,25,1
2448,Saidou Sow,gn GUI,DF,Strasbourg,fr Ligue 1,22.83287671,2002,11.3,9,5,6,3,0,6,12,50,6,15,9,6,15,24,37,2
2449,Saidou Sow,gn GUI,DF,Nantes,fr Ligue 1,22.83287671,2002,8.9,17,11,13,4,0,6,10,60,4,19,12,7,13,30,46,1
2450,Djed Spence,eng ENG,DF,Tottenham,eng Premier League,24.73424658,2000,16.8,39,30,22,11,6,19,25,76,6,22,9,13,17,56,55,1
2451,Leonardo Spinazzola,it ITA,"DF,FW",Napoli,it Serie A,32.10958904,1993,14,13,10,6,5,2,8,19,42.1,11,10,1,9,8,21,27,1
2452,Marco Sportiello,it ITA,GK,Milan,it Serie A,32.98356164,1992,1.4,0,0,0,0,0,0,0,,0,0,0,0,0,0,1,0
2453,Anton Stach,de GER,"MF,DF",Hoffenheim,de Bundesliga,26.46575342,1998,26.8,62,44,25,33,4,29,42,69,13,42,12,30,41,103,98,2
2454,Jens Stage,dk DEN,MF,Werder Bremen,de Bundesliga,28.48493151,1996,22.7,43,26,20,20,3,23,43,53.5,20,42,8,34,17,60,41,2
2455,Josip Stanišić,hr CRO,DF,Bayern Munich,de Bundesliga,25.08767123,2000,8.1,11,10,5,4,2,5,11,45.5,6,9,5,4,5,16,24,1
2456,Filip Stankovic,rs SRB,GK,Venezia,it Serie A,23.18630137,2002,15.2,0,0,0,0,0,0,0,,0,0,0,0,0,0,11,2
2457,Jay Stansfield,eng ENG,MF,Fulham,eng Premier League,22.44109589,2002,0,0,0,0,0,0,0,0,,0,0,0,0,0,0,0,0
2458,Carl Starfelt,se SWE,DF,Celta Vigo,es La Liga,29.92328767,1995,25.2,40,20,25,14,1,18,27,66.7,9,29,21,8,31,71,129,3
2459,Niklas Stark,de GER,DF,Werder Bremen,de Bundesliga,30.05479452,1995,21.4,33,21,20,11,2,14,21,66.7,7,38,25,13,32,65,121,1
2460,Lucas Stassin,be BEL,FW,Saint-Étienne,fr Ligue 1,20.43013699,2004,20,16,11,3,5,8,6,20,30,14,10,0,10,3,19,8,0
2461,Jason Steele,eng ENG,GK,Brighton,eng Premier League,34.70958904,1990,2,0,0,0,0,0,0,0,,0,0,0,0,0,0,1,0
2462,Orri Steinn Óskarsson,is ISL,FW,Real Sociedad,es La Liga,20.67945205,2004,10.5,6,6,2,1,3,2,8,25,6,10,1,9,2,8,11,0
2463,Pascal Stenzel,de GER,DF,Stuttgart,de Bundesliga,29.12328767,1996,2.4,1,0,1,0,0,0,1,0,1,5,1,4,2,3,5,0
2464,Jack Stephens,eng ENG,DF,Southampton,eng Premier League,31.26575342,1994,13.4,32,19,23,9,0,15,27,55.6,12,15,10,5,11,43,44,2
2465,Leonidas Stergiou,ch SUI,DF,Stuttgart,de Bundesliga,23.16986301,2002,9.5,24,13,9,11,4,16,19,84.2,3,16,5,11,14,38,39,0
2466,Raheem Sterling,eng ENG,"FW,MF",Arsenal,eng Premier League,30.40273973,1994,4.9,8,4,1,2,5,4,8,50,4,3,0,3,1,9,3,0
2467,Enzo Sternal,fr FRA,"FW,MF",Marseille,fr Ligue 1,17.93424658,2007,0.3,0,0,0,0,0,0,0,,0,0,0,0,0,0,0,0
2468,Finley Stevens,wls WAL,DF,St. Pauli,de Bundesliga,22.06575342,2003,0,0,0,0,0,0,0,0,,0,0,0,0,0,0,0,0
2469,Ross Stewart,sct SCO,FW,Southampton,eng Premier League,28.81369863,1996,3.2,3,2,1,0,2,2,6,33.3,4,3,0,3,0,3,6,0
2470,Angelo Stiller,de GER,MF,Stuttgart,de Bundesliga,24.08219178,2001,30.3,49,27,18,25,6,14,30,46.7,16,29,9,20,25,74,50,4
2471,Kevin Stöger,at AUT,MF,Gladbach,de Bundesliga,31.68493151,1993,16.8,37,21,23,10,4,16,37,43.2,21,24,3,21,15,52,26,3
2472,Stoichkov,es ESP,"MF,FW",Alavés,es La Liga,31.49315068,1993,7.8,14,9,6,7,1,6,11,54.5,5,2,0,2,1,15,7,0
2473,Petar Stojanović,si SVN,MF,Empoli,it Serie A,29.57260274,1995,0,0,0,0,0,0,0,0,,0,0,0,0,0,0,0,0
2474,Jakub Stolarczyk,pl POL,GK,Leicester City,eng Premier League,24.37260274,2000,7,2,1,2,0,0,1,2,50,1,0,0,0,0,2,5,0
2475,John Stones,eng ENG,"DF,MF",Manchester City,eng Premier League,30.93424658,1994,6.1,6,2,3,2,1,5,5,100,0,5,3,2,4,10,19,1
2476,Jørgen Strand Larsen,no NOR,FW,Wolves,eng Premier League,25.23835616,2000,27.4,9,6,2,3,4,4,27,14.8,23,18,4,14,5,14,27,0
2477,Gabriel Strefezza,br BRA,"FW,MF",Como,it Serie A,28.04383562,1997,26.1,52,38,19,18,15,20,51,39.2,31,23,2,21,12,64,23,0
2478,Cristhian Stuani,uy URU,FW,Girona,es La Liga,38.55890411,1986,8.3,7,6,1,5,1,3,4,75,1,4,1,3,5,12,7,0
2479,Álex Suárez,es ESP,DF,Las Palmas,es La Liga,32.12876712,1993,25.8,39,22,29,9,1,20,27,74.1,7,35,21,14,12,51,100,1
2480,Denis Suárez,es ESP,MF,Villarreal,es La Liga,31.32328767,1994,5.9,9,7,7,1,1,4,9,44.4,5,4,1,3,1,10,3,0
2481,Gabriel Suazo,cl CHI,DF,Toulouse,fr Ligue 1,27.73424658,1997,23.8,59,39,25,22,12,30,72,41.7,42,27,3,24,36,95,40,1
2482,Luka Sučić,hr CRO,MF,Real Sociedad,es La Liga,22.65205479,2002,17.5,23,16,6,12,5,9,24,37.5,15,26,2,24,13,36,15,1
2483,Yukinari Sugawara,jp JPN,"DF,MF",Southampton,eng Premier League,24.84931507,2000,16.3,29,16,14,14,1,18,30,60,12,17,7,10,10,39,46,3
2484,Niklas Süle,de GER,DF,Dortmund,de Bundesliga,29.66575342,1995,9.8,11,9,6,5,0,8,12,66.7,4,8,4,4,4,15,36,1
2485,Ibrahim Sulemana,gh GHA,MF,Atalanta,it Serie A,21.95068493,2003,1.4,5,2,2,3,0,1,3,33.3,2,1,0,1,0,5,1,0
2486,Kamaldeen Sulemana,gh GHA,"FW,MF",Southampton,eng Premier League,23.21369863,2002,13.1,16,14,6,4,6,8,13,61.5,5,9,0,9,6,22,9,0
2487,Crysencio Summerville,nl NED,"FW,MF",West Ham,eng Premier League,23.50958904,2001,8.7,13,7,2,8,3,3,9,33.3,6,13,4,9,0,13,7,0
2488,Tomáš Suslov,sk SVK,"MF,FW",Hellas Verona,it Serie A,22.90684932,2002,22,52,36,21,24,7,21,68,30.9,47,29,2,27,18,70,15,1
2489,Suso,es ESP,"FW,MF",Sevilla,es La Liga,31.45479452,1993,2.5,2,1,1,1,0,1,5,20,4,1,0,1,1,3,0,0
2490,Zion Suzuki,jp JPN,GK,Parma,it Serie A,22.70136986,2002,33.8,1,0,1,0,0,1,2,50,1,0,0,0,0,1,29,4
2491,Mattias Svanberg,se SWE,MF,Wolfsburg,de Bundesliga,26.3260274,1999,13.5,20,10,6,11,3,9,19,47.4,10,11,4,7,15,35,26,0
2492,Daniel Svensson,se SWE,"DF,FW",Dortmund,de Bundesliga,23.22191781,2002,6.7,10,7,4,4,2,4,8,50,4,8,3,5,4,14,22,0
2493,Marin Šverko,hr CRO,DF,Venezia,it Serie A,27.24383562,1998,11.6,17,6,11,6,0,8,10,80,2,9,4,5,16,33,42,3
2494,Mile Svilar,rs SRB,GK,Roma,it Serie A,25.68493151,1999,34,0,0,0,0,0,0,0,,0,0,0,0,0,0,10,2
2495,Michael Svoboda,at AUT,DF,Venezia,it Serie A,26.55068493,1998,14.6,26,14,19,6,1,8,19,42.1,11,19,11,8,22,48,66,2
2496,Williot Swedberg,se SWE,"FW,MF",Celta Vigo,es La Liga,21.25205479,2004,12.7,19,13,6,9,4,11,17,64.7,6,11,1,10,3,22,9,1
2497,Abakar Sylla,ci CIV,DF,Strasbourg,fr Ligue 1,22.35616438,2002,10.5,27,15,14,11,2,15,17,88.2,2,18,10,8,11,38,63,0
2498,Issiaga Sylla,gn GUI,DF,Montpellier,fr Ligue 1,31.3369863,1994,12.3,25,9,17,7,1,15,29,51.7,14,13,4,9,10,35,34,1
2499,Mamadou Sylla,sn SEN,"FW,MF",Valladolid,es La Liga,31.12328767,1994,16.5,6,3,2,2,2,2,8,25,6,6,0,6,3,9,12,1
2500,Wojciech Szczęsny,pl POL,GK,Barcelona,es La Liga,35.04383562,1990,13,1,1,1,0,0,0,0,,0,0,0,0,0,1,14,1
2501,Sammie Szmodics,ie IRL,"FW,MF",Ipswich Town,eng Premier League,29.60821918,1995,10.9,15,9,4,9,2,6,23,26.1,17,10,2,8,6,21,14,0
2502,Dominik Szoboszlai,hu HUN,MF,Liverpool,eng Premier League,24.52328767,2000,25.1,31,20,10,16,5,15,39,38.5,24,35,4,31,9,40,17,2
2503,Alexander Sørloth,no NOR,FW,Atlético Madrid,es La Liga,29.4109589,1995,14.8,8,4,2,4,2,3,5,60,2,5,1,4,1,9,23,0
2504,Musa Al-Taamari,jo JOR,"FW,MF",Montpellier,fr Ligue 1,27.89863014,1997,12.4,14,10,4,5,5,8,15,53.3,7,2,0,2,3,17,3,2
2505,Musa Al-Taamari,jo JOR,"FW,MF",Rennes,fr Ligue 1,27.89863014,1997,5.6,3,0,1,0,2,0,3,0,3,3,0,3,2,5,2,0
2506,Haris Tabakovic,ba BIH,FW,Hoffenheim,de Bundesliga,30.87123288,1994,8.9,3,1,1,0,2,0,3,0,3,4,2,2,1,4,16,0
2507,Nicolás Tagliafico,ar ARG,DF,Lyon,fr Ligue 1,32.6739726,1992,18.1,52,34,23,19,10,26,42,61.9,16,22,7,15,31,83,45,0
2508,Jonathan Tah,de GER,DF,Leverkusen,de Bundesliga,29.22465753,1996,30,14,9,10,3,1,7,12,58.3,5,21,15,6,33,47,136,2
2509,Adrien Tameze,cm CMR,"MF,DF",Torino,it Serie A,31.24383562,1994,7.2,5,2,2,3,0,1,10,10,9,8,5,3,10,15,8,1
2510,Axel Tapé,fr FRA,DF,Paris S-G,fr Ligue 1,17.73150685,2007,1,1,1,1,0,0,1,1,100,0,1,1,0,1,2,5,0
2511,Renato Tapia,pe PER,"MF,DF",Leganés,es La Liga,29.76712329,1995,22.2,51,29,24,24,3,18,38,47.4,20,49,19,30,22,73,68,2
2512,Edmond Tapsoba,bf BFA,DF,Leverkusen,de Bundesliga,26.24931507,1999,25.2,35,20,16,15,4,19,36,52.8,17,17,12,5,23,58,82,2
2513,Florian Tardieu,fr FRA,MF,Saint-Étienne,fr Ligue 1,33.03287671,1992,10.9,16,11,6,7,3,5,13,38.5,8,14,5,9,13,29,16,0
2514,Mehdi Taremi,ir IRN,FW,Inter,it Serie A,32.79452055,1992,6.7,4,1,1,1,2,0,2,0,2,8,1,7,0,4,10,0
2515,Matt Targett,eng ENG,DF,Newcastle Utd,eng Premier League,29.62465753,1995,0.2,0,0,0,0,0,0,1,0,1,0,0,0,1,1,1,0
2516,Oussama Targhalline,ma MAR,MF,Le Havre,fr Ligue 1,22.95616438,2002,11,19,14,12,3,4,5,12,41.7,7,14,7,7,19,38,14,2
2517,James Tarkowski,eng ENG,DF,Everton,eng Premier League,32.45479452,1992,32.5,64,40,39,22,3,24,39,61.5,15,57,42,15,41,105,213,4
2518,César Tárrega,es ESP,DF,Valencia,es La Liga,23.18356164,2002,29.6,44,33,28,13,3,18,28,64.3,10,35,18,17,20,64,205,2
2519,Nuno Tavares,pt POR,DF,Lazio,it Serie A,25.26849315,2000,17.2,28,21,15,8,5,14,32,43.8,18,18,2,16,19,47,39,1
2520,Marcus Tavernier,eng ENG,"FW,MF",Bournemouth,eng Premier League,26.11780822,1999,18.6,41,24,14,18,9,10,26,38.5,16,16,3,13,5,46,11,0
2521,Charlie Taylor,eng ENG,DF,Southampton,eng Premier League,31.62465753,1993,3,7,5,4,3,0,5,6,83.3,1,5,3,2,3,10,22,1
2522,Jack Taylor,ie IRL,MF,Ipswich Town,eng Premier League,26.8630137,1998,8.5,20,10,6,11,3,12,23,52.2,11,10,3,7,9,29,23,0
2523,Loum Tchaouna,fr FRA,"FW,MF",Lazio,it Serie A,21.65205479,2003,7.3,8,4,2,2,4,3,9,33.3,6,5,1,4,4,12,14,2
2524,Jackson Tchatchoua,cm CMR,"DF,MF",Hellas Verona,it Serie A,23.63561644,2001,32.2,47,29,34,10,3,27,41,65.9,14,20,9,11,12,59,65,2
2525,Enzo Tchato,cm CMR,DF,Montpellier,fr Ligue 1,22.44383562,2002,19.6,45,23,25,16,4,25,42,59.5,17,29,9,20,22,67,53,0
2526,Aurélien Tchouaméni,fr FRA,"MF,DF",Real Madrid,es La Liga,25.26575342,2000,26.3,41,20,21,18,2,19,38,50,19,28,20,8,42,83,77,1
2527,Álvaro Tejero,es ESP,"MF,DF",Espanyol,es La Liga,28.7890411,1996,12.9,12,4,5,6,1,5,19,26.3,14,9,1,8,11,23,31,1
2528,Martín Tejón,es ESP,"MF,DF",Valencia,es La Liga,21.06027397,2004,0.5,2,0,0,2,0,1,2,50,1,0,0,0,0,2,0,0
2529,Mathys Tel,fr FRA,FW,Tottenham,eng Premier League,20.01917808,2005,6.2,6,2,0,3,3,2,7,28.6,5,3,0,3,0,6,2,2
2530,Mathys Tel,fr FRA,"FW,MF",Bayern Munich,de Bundesliga,20.01917808,2005,2.8,2,2,0,2,0,0,0,,0,0,0,0,1,3,1,0
2531,Nathan Tella,ng NGA,"MF,FW",Leverkusen,de Bundesliga,25.83013699,1999,13.8,14,9,4,5,5,5,12,41.7,7,13,1,12,4,18,6,0
2532,Nahuel Tenaglia,ar ARG,DF,Alavés,es La Liga,29.19726027,1996,29.3,87,52,54,28,5,46,75,61.3,29,29,7,22,37,124,115,2
2533,Casper Tengstedt,dk DEN,"FW,MF",Hellas Verona,it Serie A,24.92328767,2000,15.5,7,5,0,5,2,4,8,50,4,5,1,4,3,10,27,0
2534,Marc-André ter Stegen,de GER,GK,Barcelona,es La Liga,33.0109589,1992,6.5,0,0,0,0,0,0,1,0,1,0,0,0,0,0,2,2
2535,Filippo Terracciano,it ITA,"DF,MF",Milan,it Serie A,22.23287671,2003,6,9,6,1,6,2,5,10,50,5,1,0,1,6,15,11,0
2536,Pietro Terracciano,it ITA,GK,Fiorentina,it Serie A,35.15616438,1990,3,0,0,0,0,0,0,0,,0,0,0,0,0,0,0,0
2537,Ramón Terrats,es ESP,"MF,FW",Villarreal,es La Liga,24.54246575,2000,1.5,3,3,1,2,0,2,4,50,2,3,1,2,2,5,3,0
2538,Ramón Terrats,es ESP,"MF,FW",Getafe,es La Liga,24.54246575,2000,10.1,14,6,7,2,5,7,24,29.2,17,7,1,6,4,18,12,0
2539,Martin Terrier,fr FRA,"MF,FW",Leverkusen,de Bundesliga,28.16712329,1997,6.5,4,2,1,0,3,1,4,25,3,3,0,3,1,5,1,0
2540,Tanner Tessmann,us USA,MF,Lyon,fr Ligue 1,23.60821918,2001,11.9,21,13,8,9,4,10,22,45.5,12,11,7,4,18,39,27,1
2541,Kenny Tete,nl NED,DF,Fulham,eng Premier League,29.56712329,1995,16.7,50,34,24,14,12,20,34,58.8,14,22,6,16,29,79,52,0
2542,Teddy Teuma,mt MLT,MF,Reims,fr Ligue 1,31.59178082,1993,8.3,18,10,6,6,6,7,25,28,18,12,2,10,12,30,8,1
2543,Jordan Teze,nl NED,DF,Monaco,fr Ligue 1,25.59178082,1999,5,16,8,6,9,1,5,13,38.5,8,12,1,11,3,19,11,0
2544,Florian Thauvin,fr FRA,"FW,MF",Udinese,it Serie A,32.26849315,1993,21.7,20,14,9,8,3,10,25,40,15,6,0,6,7,27,10,0
2545,Arthur Theate,be BEL,DF,Eint Frankfurt,de Bundesliga,24.94246575,2000,27,33,23,17,15,1,19,40,47.5,21,40,19,21,35,68,149,3
2546,Norman Theuerkauf,de GER,MF,Heidenheim,de Bundesliga,38.2739726,1987,0.2,0,0,0,0,0,0,0,,0,0,0,0,0,0,0,0
2547,Thiago,br BRA,FW,Brentford,eng Premier League,23.85479452,2001,1.5,2,2,1,0,1,0,1,0,1,0,0,0,2,4,2,1
2548,Malick Thiaw,de GER,DF,Milan,it Serie A,23.7369863,2001,19.2,24,17,15,6,3,6,10,60,4,14,12,2,15,39,73,1
2549,Denis Thomalla,de GER,MF,Heidenheim,de Bundesliga,32.71506849,1992,0,0,0,0,0,0,0,0,,0,0,0,0,0,0,0,0
2550,Luke Thomas,eng ENG,DF,Leicester City,eng Premier League,23.89863014,2001,9.7,25,20,19,4,2,18,32,56.3,14,13,5,8,18,43,39,1
2551,Sorba Thomas,wls WAL,"FW,MF",Nantes,fr Ligue 1,25.69863014,1999,12.9,12,6,6,4,2,8,16,50,8,10,1,9,6,18,22,1
2552,Adrien Thomasson,fr FRA,MF,Lens,fr Ligue 1,31.39726027,1993,26.2,85,46,41,24,20,50,86,58.1,36,40,3,37,17,102,27,2
2553,Morten Thorsby,no NOR,MF,Genoa,it Serie A,28.99726027,1996,20.1,45,30,18,17,10,14,26,53.8,12,21,1,20,5,50,28,0
2554,Khéphren Thuram,fr FRA,MF,Juventus,it Serie A,24.10684932,2001,22.8,39,18,13,22,4,18,30,60,12,29,8,21,11,50,33,1
2555,Marcus Thuram,fr FRA,FW,Inter,it Serie A,27.74246575,1997,24.4,18,10,7,5,6,3,14,21.4,11,15,3,12,3,21,15,0
2556,Cheikh Tidiane Niasse,sn SEN,MF,Hellas Verona,it Serie A,25.28767123,2000,7.4,14,11,4,10,0,8,15,53.3,7,17,4,13,17,31,16,2
2557,Youri Tielemans,be BEL,MF,Aston Villa,eng Premier League,27.99178082,1997,33.3,83,57,31,44,8,40,73,54.8,33,37,16,21,22,105,47,4
2558,Kieran Tierney,sct SCO,"DF,FW",Arsenal,eng Premier League,27.91232877,1997,2,5,4,3,1,1,3,5,60,2,0,0,0,2,7,5,0
2559,Phillip Tietz,de GER,FW,Augsburg,de Bundesliga,27.81917808,1997,17.1,11,6,2,7,2,5,8,62.5,3,7,1,6,5,16,26,0
2560,Jurriën Timber,nl NED,DF,Arsenal,eng Premier League,23.87945205,2001,26.9,58,38,17,30,11,18,27,66.7,9,19,4,15,22,80,44,1
2561,Jean-Clair Todibo,fr FRA,DF,West Ham,eng Premier League,25.34246575,1999,16.5,36,22,24,12,0,23,30,76.7,7,23,12,11,20,56,69,3
2562,Harry Toffolo,eng ENG,DF,Nott'ham Forest,eng Premier League,29.70684932,1995,1.5,5,3,3,1,1,3,4,75,1,2,2,0,2,7,12,0
2563,Umut Tohumcu,de GER,"MF,FW",Hoffenheim,de Bundesliga,20.72876712,2004,4,9,5,3,5,1,5,7,71.4,2,5,0,5,3,12,6,0
2564,Corentin Tolisso,fr FRA,MF,Lyon,fr Ligue 1,30.75068493,1994,24.8,53,22,20,23,10,32,62,51.6,30,50,12,38,21,74,39,1
2565,John Tolkin,us USA,"DF,MF",Holstein Kiel,de Bundesliga,22.75890411,2002,5.4,12,8,6,6,0,8,9,88.9,1,7,2,5,5,17,29,0
2566,Rafael Tolói,it ITA,DF,Atalanta,it Serie A,34.56438356,1990,4.7,10,5,3,5,2,4,11,36.4,7,8,2,6,7,17,10,0
2567,Raúl de Tomás,es ESP,"DF,FW",Rayo Vallecano,es La Liga,30.54520548,1994,0.2,2,2,1,0,1,0,0,,0,0,0,0,0,2,0,0
2568,Tiago Tomás,pt POR,"FW,MF",Wolfsburg,de Bundesliga,22.88219178,2002,20.9,33,19,15,11,7,15,35,42.9,20,17,4,13,9,42,19,0
2569,Takehiro Tomiyasu,jp JPN,DF,Arsenal,eng Premier League,26.49315068,1998,0.1,0,0,0,0,0,0,0,,0,0,0,0,0,0,1,0
2570,Fikayo Tomori,eng ENG,DF,Milan,it Serie A,27.37260274,1997,14.7,32,19,17,13,2,12,20,60,8,14,10,4,16,48,53,1
2571,Sandro Tonali,it ITA,MF,Newcastle Utd,eng Premier League,24.9890411,2000,25.2,46,29,19,22,5,21,43,48.8,22,30,10,20,30,76,32,2
2572,Pablo Torre,es ESP,"MF,FW",Barcelona,es La Liga,22.08493151,2003,3.4,5,4,1,3,1,2,4,50,2,0,0,0,3,8,5,1
2573,David Torres,es ESP,DF,Valladolid,es La Liga,22.16438356,2003,15.4,13,8,12,1,0,7,11,63.6,4,19,17,2,10,23,74,0
2574,Ferrán Torres,es ESP,"FW,MF",Barcelona,es La Liga,25.17534247,2000,11.3,7,4,2,2,3,3,8,37.5,5,7,1,6,4,11,5,0
2575,Pau Torres,es ESP,DF,Aston Villa,eng Premier League,28.29589041,1997,20.2,20,14,11,7,2,9,15,60,6,14,10,4,9,29,65,2
2576,Lucas Torró,es ESP,MF,Osasuna,es La Liga,30.79178082,1994,29.4,69,39,30,35,4,35,62,56.5,27,33,9,24,43,112,55,3
2577,Lorenzo Tosto,it ITA,DF,Empoli,it Serie A,19.26027397,2006,0,0,0,0,0,0,0,0,,0,0,0,0,0,0,0,0
2578,Abdoulaye Touré,gn GUI,MF,Le Havre,fr Ligue 1,31.16986301,1994,22.8,58,33,30,20,8,32,52,61.5,20,32,18,14,30,88,39,5
2579,Bazoumana Touré,ci CIV,"FW,MF",Hoffenheim,de Bundesliga,19.17260274,2006,5.7,11,9,2,7,2,2,8,25,6,3,0,3,3,14,2,0
2580,Birama Touré,ml MLI,"MF,DF",Montpellier,fr Ligue 1,32.90958904,1992,3.3,8,5,5,2,1,4,6,66.7,2,3,2,1,6,14,7,0
2581,Ousmane Toure,fr FRA,DF,Lille,fr Ligue 1,20.20547945,2005,0.1,0,0,0,0,0,0,0,,0,0,0,0,1,1,2,0
2582,Souleymane Touré,fr FRA,DF,Udinese,it Serie A,22.10136986,2003,8.1,7,6,4,3,0,4,5,80,1,15,6,9,9,16,17,1
2583,Lucas Tousart,fr FRA,MF,Union Berlin,de Bundesliga,28.01369863,1997,5.9,17,9,6,9,2,5,12,41.7,7,9,3,6,7,24,23,0
2584,Conor Townsend,eng ENG,DF,Ipswich Town,eng Premier League,32.16712329,1993,3.7,11,8,9,2,0,8,11,72.7,3,8,6,2,4,15,16,0
2585,Adama Traoré,es ESP,"FW,MF",Fulham,eng Premier League,29.27123288,1996,17.7,17,12,8,4,5,5,13,38.5,8,7,0,7,1,18,6,3
2586,Boubacar Traoré,ml MLI,MF,Wolves,eng Premier League,23.70410959,2001,0,2,0,0,2,0,1,1,100,0,0,0,0,0,2,0,0
2587,Hamari Traoré,ml MLI,DF,Real Sociedad,es La Liga,33.26575342,1992,5.6,14,9,8,5,1,11,16,68.8,5,4,1,3,6,20,16,0
2588,Omar Traoré,de GER,DF,Heidenheim,de Bundesliga,27.24383562,1998,27.2,46,23,30,15,1,23,39,59,16,34,6,28,20,66,62,0
2589,Kevin Trapp,de GER,GK,Eint Frankfurt,de Bundesliga,34.82191781,1990,22.5,0,0,0,0,0,0,0,,0,0,0,0,0,0,10,3
2590,Mark Travers,ie IRL,GK,Bournemouth,eng Premier League,25.96164384,1999,5,0,0,0,0,0,0,0,,0,0,0,0,0,0,5,0
2591,Óscar Trejo,ar ARG,MF,Rayo Vallecano,es La Liga,37.02191781,1988,5.4,7,5,1,4,2,3,9,33.3,6,8,0,8,4,11,5,0
2592,Philipp Treu,de GER,"MF,DF",St. Pauli,de Bundesliga,24.41643836,2000,30.4,60,42,35,16,9,38,65,58.5,27,49,11,38,19,79,84,2
2593,Ryan Trevitt,eng ENG,MF,Brentford,eng Premier League,22.14520548,2003,0,1,1,1,0,0,0,0,,0,0,0,0,0,1,0,0
2594,Christopher Trimmel,at AUT,"DF,MF",Union Berlin,de Bundesliga,38.1890411,1987,18.3,36,24,22,13,1,26,38,68.4,12,13,6,7,17,53,88,0
2595,Kieran Trippier,eng ENG,DF,Newcastle Utd,eng Premier League,34.62191781,1990,13.2,36,19,18,12,6,21,34,61.8,13,9,3,6,11,47,41,0
2596,Leandro Trossard,be BEL,FW,Arsenal,eng Premier League,30.41369863,1994,26.2,26,17,5,14,7,9,31,29,22,31,0,31,9,35,17,0
2597,Adrien Truffert,fr FRA,"DF,MF",Rennes,fr Ligue 1,23.45205479,2001,28.6,57,33,24,20,13,29,45,64.4,16,43,6,37,26,83,49,1
2598,Kostas Tsimikas,gr GRE,DF,Liverpool,eng Premier League,28.97808219,1996,7.4,27,17,13,11,3,13,19,68.4,6,5,2,3,10,37,16,0
2599,Viktor Tsyhankov,ua UKR,"FW,MF",Girona,es La Liga,27.46575342,1997,16.6,15,11,2,5,8,6,15,40,9,4,0,4,11,26,11,1
2600,Axel Tuanzebe,cd COD,DF,Ipswich Town,eng Premier League,27.46849315,1997,16.1,29,17,20,3,6,16,24,66.7,8,18,9,9,21,50,53,1
2601,Stefano Turati,it ITA,GK,Monza,it Serie A,23.66027397,2001,29.7,0,0,0,0,0,0,1,0,1,0,0,0,0,0,21,2
2602,Beñat Turrientes,es ESP,MF,Real Sociedad,es La Liga,23.25479452,2002,9.1,13,5,4,8,1,4,13,30.8,9,14,2,12,5,18,12,0
2603,Tuta,br BRA,"DF,MF",Eint Frankfurt,de Bundesliga,25.83287671,1999,23.6,42,25,24,16,2,26,38,68.4,12,39,19,20,40,82,123,1
2604,Chrisantus Uche,ng NGA,"FW,MF",Getafe,es La Liga,21.95890411,2003,24.8,28,17,6,16,6,6,15,40,9,18,2,16,9,37,17,0
2605,Destiny Udogie,it ITA,DF,Tottenham,eng Premier League,22.43013699,2002,20.4,74,47,41,26,7,33,47,70.2,14,40,6,34,21,95,35,1
2606,Manuel Ugarte Ribeiro,uy URU,MF,Manchester Utd,eng Premier League,24.0630137,2001,18,70,43,31,31,8,25,60,41.7,35,27,3,24,25,95,16,1
2607,Lesley Ugochukwu,fr FRA,MF,Southampton,eng Premier League,21.10684932,2004,16.9,49,24,15,30,4,18,33,54.5,15,26,9,17,14,63,21,1
2608,Lukas Ullrich,de GER,DF,Gladbach,de Bundesliga,21.13424658,2004,19.1,22,13,15,6,1,12,31,38.7,19,24,9,15,19,41,69,1
2609,Sven Ulreich,de GER,GK,Bayern Munich,de Bundesliga,36.75068493,1988,1,0,0,0,0,0,0,0,,0,0,0,0,0,0,0,0
2610,Enes Ünal,tr TUR,"FW,MF",Bournemouth,eng Premier League,27.98356164,1997,3.8,1,0,0,0,1,0,3,0,3,1,0,1,0,1,6,0
2611,Deniz Undav,de GER,"FW,MF",Stuttgart,de Bundesliga,28.79178082,1996,17.2,10,9,2,3,5,0,13,0,13,12,1,11,3,13,9,0
2612,Naci Ünüvar,nl NED,"MF,DF",Espanyol,es La Liga,21.89041096,2003,0.3,2,2,1,1,0,1,2,50,1,0,0,0,0,2,0,0
2613,Dayot Upamecano,fr FRA,DF,Bayern Munich,de Bundesliga,26.51780822,1998,19.5,36,22,18,16,2,16,29,55.2,13,17,7,10,34,70,45,1
2614,Kacper Urbanski,pl POL,MF,Bologna,it Serie A,20.65479452,2004,2.7,5,2,4,0,1,4,6,66.7,2,5,1,4,2,7,5,0
2615,Kacper Urbanski,pl POL,MF,Monza,it Serie A,20.65479452,2004,5.6,5,3,1,2,2,4,7,57.1,3,7,2,5,2,7,9,0
2616,Jonas Urbig,de GER,GK,Bayern Munich,de Bundesliga,21.7369863,2003,8,0,0,0,0,0,0,0,,0,0,0,0,0,0,9,2
2617,Can Uzun,tr TUR,"MF,FW",Eint Frankfurt,de Bundesliga,19.47671233,2005,7,10,4,1,4,5,5,9,55.6,4,9,0,9,1,11,3,0
2618,Josha Vagnoman,de GER,"DF,MF",Stuttgart,de Bundesliga,24.39452055,2000,19.2,24,12,11,11,2,17,31,54.8,14,15,2,13,12,36,54,1
2619,Lautaro Valenti,ar ARG,DF,Parma,it Serie A,26.30136986,1999,16,16,12,12,3,1,6,6,100,0,24,12,12,11,27,90,1
2620,Óscar Valentín,es ESP,MF,Rayo Vallecano,es La Liga,30.70410959,1994,18.6,53,40,21,19,13,32,68,47.1,36,33,6,27,21,74,48,2
2621,Nicolás Valentini,ar ARG,DF,Hellas Verona,it Serie A,24.07671233,2001,9.7,26,17,15,10,1,15,22,68.2,7,12,6,6,10,36,65,0
2622,Germán Valera,es ESP,MF,Valencia,es La Liga,23.13424658,2002,1.6,1,1,1,0,0,0,1,0,1,2,0,2,4,5,2,1
2623,Emanuele Valeri,it ITA,DF,Parma,it Serie A,26.40547945,1998,29.5,49,30,32,14,3,29,59,49.2,30,27,9,18,27,76,98,4
2624,Martin Valjent,sk SVK,DF,Mallorca,es La Liga,29.39452055,1995,26.7,27,18,20,6,1,13,16,81.3,3,28,18,10,16,43,168,1
2625,Álex Valle,es ESP,DF,Como,it Serie A,21.02465753,2004,9.4,23,11,9,12,2,13,17,76.5,4,10,2,8,6,29,36,0
2626,Jesús Vallejo,es ESP,DF,Real Madrid,es La Liga,28.3260274,1997,0.1,0,0,0,0,0,0,0,,0,0,0,0,0,0,2,0
2627,Mattia Valoti,it ITA,MF,Monza,it Serie A,31.65753425,1993,0.4,3,3,3,0,0,0,2,0,2,2,0,2,0,3,2,0
2628,Federico Valverde,uy URU,"MF,DF",Real Madrid,es La Liga,26.78356164,1998,28.7,41,25,16,20,5,24,35,68.6,11,34,5,29,50,91,48,1
2629,Ignace Van Der Brempt,be BEL,DF,Como,it Serie A,23.09041096,2002,12.1,39,31,27,10,2,23,31,74.2,8,11,5,6,13,52,31,0
2630,Siebe Van Der Heyden,be BEL,"DF,MF",Mallorca,es La Liga,26.92876712,1998,1.1,1,1,0,1,0,0,0,,0,1,0,1,2,3,3,0
2631,Siebe Van Der Heyden,be BEL,"DF,MF",St. Pauli,de Bundesliga,26.92876712,1998,9.3,17,10,10,7,0,8,18,44.4,10,8,4,4,17,34,40,2
2632,Virgil van Dijk,nl NED,DF,Liverpool,eng Premier League,33.82191781,1991,34,35,17,17,16,2,11,20,55,9,24,13,11,52,87,175,4
2633,Vanderson,br BRA,DF,Monaco,fr Ligue 1,23.86849315,2001,22.3,75,47,36,30,9,44,62,71,18,42,6,36,39,114,64,2
2634,Maarten Vandevoordt,be BEL,GK,RB Leipzig,de Bundesliga,23.18356164,2002,4.8,1,0,1,0,0,1,1,100,0,0,0,0,0,1,4,0
2635,Jamie Vardy,eng ENG,FW,Leicester City,eng Premier League,38.30958904,1987,29.5,18,13,6,7,5,4,13,30.8,9,8,4,4,5,23,23,0
2636,Ruben Vargas,ch SUI,"FW,MF",Sevilla,es La Liga,26.74520548,1998,7.5,7,4,1,5,1,3,8,37.5,5,9,0,9,3,10,10,0
2637,Ruben Vargas,ch SUI,"MF,FW",Augsburg,de Bundesliga,26.74520548,1998,3.4,2,1,1,1,0,1,4,25,3,1,0,1,2,4,1,1
2638,Nikola Vasilj,ba BIH,GK,St. Pauli,de Bundesliga,29.41917808,1995,32,0,0,0,0,0,0,2,0,2,0,0,0,0,0,22,3
2639,Devis Vásquez,co COL,GK,Empoli,it Serie A,26.97808219,1998,28,0,0,0,0,0,0,0,,0,0,0,0,0,0,19,4
2640,Johan Vásquez,mx MEX,DF,Genoa,it Serie A,26.53150685,1998,31.4,49,26,22,23,4,21,37,56.8,16,55,27,28,44,93,142,1
2641,Denis Vavro,sk SVK,DF,Wolfsburg,de Bundesliga,29.06575342,1996,25.3,17,12,13,4,0,7,18,38.9,11,42,28,14,31,48,214,3
2642,José Luis García Vayá,es ESP,MF,Valencia,es La Liga,26.72876712,1998,17.4,38,21,20,12,6,16,28,57.1,12,20,6,14,15,53,32,0
2643,Robinio Vaz,fr FRA,FW,Marseille,fr Ligue 1,18.20821918,2007,0.8,1,1,0,0,1,0,2,0,2,0,0,0,0,1,2,0
2644,Jesus Vazquez,es ESP,DF,Valencia,es La Liga,22.33424658,2003,9.1,20,16,11,7,2,8,17,47.1,9,15,5,10,7,27,27,0
2645,Lucas Vázquez,es ESP,DF,Real Madrid,es La Liga,33.84109589,1991,21.4,51,32,30,14,7,25,46,54.3,21,17,3,14,17,68,31,0
2646,Matías Vecino,uy URU,MF,Lazio,it Serie A,33.69315068,1991,7.9,12,6,3,8,1,4,17,23.5,13,7,3,4,5,17,10,0
2647,Danilo Veiga,pt POR,DF,Lecce,it Serie A,22.60547945,2002,3.4,7,6,4,3,0,5,10,50,5,5,0,5,4,11,7,0
2648,Renato Veiga,pt POR,"DF,MF",Chelsea,eng Premier League,21.76438356,2003,2,9,6,6,3,0,4,12,33.3,8,3,1,2,1,10,2,0
2649,Renato Veiga,pt POR,DF,Juventus,it Serie A,21.76438356,2003,8.6,15,11,6,8,1,9,13,69.2,4,12,10,2,11,26,49,0
2650,Alejo Véliz,ar ARG,FW,Espanyol,es La Liga,21.62191781,2003,11.2,1,1,0,1,0,1,6,16.7,5,11,2,9,4,5,21,1
2651,Miloš Veljković,rs SRB,DF,Werder Bremen,de Bundesliga,29.60273973,1995,11.4,10,5,6,3,1,7,15,46.7,8,14,9,5,2,12,47,1
2652,Joël Veltman,nl NED,DF,Brighton,eng Premier League,33.29863014,1992,18.3,42,28,23,16,3,30,51,58.8,21,22,7,15,18,60,66,0
2653,Micky van de Ven,nl NED,DF,Tottenham,eng Premier League,24.04109589,2001,10.6,10,6,5,4,1,8,14,57.1,6,9,6,3,10,20,36,1
2654,Lorenzo Venturino,it ITA,"FW,MF",Genoa,it Serie A,18.86575342,2006,1,2,1,1,0,1,1,2,50,1,1,0,1,0,2,3,0
2655,Nikolas Veratschnig,at AUT,"DF,MF",Mainz 05,de Bundesliga,22.2739726,2003,3.7,9,6,1,4,4,2,3,66.7,1,4,0,4,4,13,8,0
2656,Bart Verbruggen,nl NED,GK,Brighton,eng Premier League,22.70958904,2002,32,0,0,0,0,0,0,3,0,3,1,0,1,0,0,26,5
2657,Simone Verdi,it ITA,"MF,FW",Como,it Serie A,32.8109589,1992,1.3,2,2,0,1,1,0,2,0,2,2,0,2,0,2,2,0
2658,Jordan Veretout,fr FRA,MF,Lyon,fr Ligue 1,32.17534247,1993,15.4,26,13,13,11,2,16,38,42.1,22,15,2,13,5,31,23,1
2659,Arthur Vermeeren,be BEL,MF,RB Leipzig,de Bundesliga,20.23561644,2005,15.7,30,17,13,12,5,12,42,28.6,30,32,10,22,22,52,21,2
2660,Yorbe Vertessen,be BEL,"MF,FW",Union Berlin,de Bundesliga,24.31780822,2001,8,6,3,3,2,1,2,8,25,6,6,0,6,3,9,6,0
2661,Mikel Vesga,es ESP,MF,Athletic Club,es La Liga,31.95342466,1993,9.6,20,14,7,12,1,10,26,38.5,16,9,1,8,12,32,20,0
2662,Jannik Vestergaard,dk DEN,DF,Leicester City,eng Premier League,32.75068493,1992,15.5,22,10,16,6,0,9,15,60,6,21,14,7,16,38,74,1
2663,Ben Viadere,fr FRA,MF,Auxerre,fr Ligue 1,19.66849315,2005,0.1,0,0,0,0,0,0,0,,0,0,0,0,0,0,0,0
2664,Guglielmo Vicario,it ITA,GK,Tottenham,eng Premier League,28.57260274,1996,22,0,0,0,0,0,0,0,,0,0,0,0,1,1,14,5
2665,Carlos Vicente,es ESP,"FW,MF",Alavés,es La Liga,26.03013699,1999,30.4,41,26,23,10,8,23,57,40.4,34,28,2,26,13,54,37,0
2666,Pau Victor Delgado,es ESP,FW,Barcelona,es La Liga,23.43561644,2001,3.3,2,1,0,1,1,0,3,0,3,6,1,5,2,4,5,0
2667,Nacho Vidal,es ESP,DF,Osasuna,es La Liga,30.2739726,1995,1.4,2,0,0,1,1,1,4,25,3,1,0,1,0,2,6,0
2668,Gabriel Vidovic,hr CRO,MF,Bayern Munich,de Bundesliga,21.42191781,2003,0.2,0,0,0,0,0,0,0,,0,2,0,2,0,0,0,0
2669,Gabriel Vidovic,hr CRO,MF,Mainz 05,de Bundesliga,21.42191781,2003,0,0,0,0,0,0,0,0,,0,0,0,0,0,0,0,0
2670,Fran Vieites,es ESP,GK,Betis,es La Liga,25.99178082,1999,4,0,0,0,0,0,0,0,,0,0,0,0,0,0,1,0
2671,Samuele Vignato,it ITA,MF,Monza,it Serie A,21.1890411,2004,5,6,3,0,4,2,3,6,50,3,1,0,1,0,6,6,0
2672,Asier Villalibre,es ESP,FW,Alavés,es La Liga,27.59178082,1997,3.5,1,1,0,0,1,1,2,50,1,1,0,1,1,2,7,0
2673,Iván Villar,es ESP,GK,Celta Vigo,es La Liga,27.81917808,1997,4,0,0,0,0,0,0,0,,0,0,0,0,0,0,3,0
2674,Carlos Vinícius,br BRA,"MF,FW",Fulham,eng Premier League,30.10958904,1995,0.2,0,0,0,0,0,0,1,0,1,1,0,1,0,0,0,0
2675,Nicolas Viola,it ITA,"MF,FW",Cagliari,it Serie A,35.55890411,1989,12.7,14,7,6,7,1,1,10,10,9,4,0,4,2,16,5,0
2676,Viti,es ESP,DF,Las Palmas,es La Liga,27.63013699,1997,19.5,65,43,41,17,7,29,43,67.4,14,26,6,20,24,89,52,0
2677,Mattia Viti,it ITA,DF,Empoli,it Serie A,23.2739726,2002,24.6,59,41,41,15,3,31,46,67.4,15,36,17,19,45,104,102,3
2678,Vitinha,pt POR,"FW,MF",Genoa,it Serie A,25.1369863,2000,12.1,20,5,11,4,5,10,26,38.5,16,12,1,11,11,31,17,0
2679,Vitinha,pt POR,MF,Paris S-G,fr Ligue 1,25.21917808,2000,21.7,41,21,13,26,2,24,46,52.2,22,26,7,19,13,54,19,2
2680,Daniel Vivian,es ESP,DF,Athletic Club,es La Liga,25.80273973,1999,24.7,37,23,21,13,3,19,28,67.9,9,22,9,13,34,71,114,2
2681,Dušan Vlahović,rs SRB,FW,Juventus,it Serie A,25.2630137,2000,19.4,3,1,0,1,2,1,5,20,4,7,3,4,1,4,8,3
2682,Vanja Vlahović,rs SRB,"FW,MF",Atalanta,it Serie A,21.11506849,2004,0.7,1,1,0,0,1,0,0,,0,0,0,0,0,1,0,0
2683,Nikola Vlašić,hr CRO,"MF,FW",Torino,it Serie A,27.58082192,1997,20.7,34,17,10,16,8,11,29,37.9,18,13,3,10,9,43,13,0
2684,Alessandro Vogliacco,it ITA,DF,Genoa,it Serie A,26.63561644,1998,7.9,15,3,7,7,1,10,12,83.3,2,11,7,4,9,24,20,0
2685,Alessandro Vogliacco,it ITA,DF,Parma,it Serie A,26.63561644,1998,8.6,5,2,5,0,0,3,5,60,2,15,10,5,3,8,37,0
2686,Kevin Vogt,de GER,DF,Union Berlin,de Bundesliga,33.6109589,1991,14.5,11,8,6,5,0,7,12,58.3,5,16,8,8,9,20,75,0
2687,Mërgim Vojvoda,xk KVX,DF,Torino,it Serie A,30.25205479,1995,12.3,18,10,5,9,4,7,14,50,7,13,3,10,7,25,24,1
2688,Mërgim Vojvoda,xk KVX,DF,Como,it Serie A,30.25205479,1995,6,6,4,3,3,0,5,5,100,0,6,4,2,2,8,15,0
2689,Kevin Volland,de GER,"FW,MF",Union Berlin,de Bundesliga,32.76164384,1992,0.7,0,0,0,0,0,0,0,,0,1,0,1,0,0,1,0
2690,Aster Vranckx,be BEL,MF,Wolfsburg,de Bundesliga,22.58082192,2002,5.7,10,5,2,8,0,2,7,28.6,5,14,3,11,9,19,13,0
2691,Stefan de Vrij,nl NED,DF,Inter,it Serie A,33.24109589,1992,17.2,16,10,11,4,1,8,11,72.7,3,18,10,8,21,37,74,0
2692,Ibrahima Wadji,sn SEN,"FW,MF",Saint-Étienne,fr Ligue 1,29.99726027,1995,2.2,6,6,3,2,1,3,7,42.9,4,0,0,0,1,7,0,0
2693,Robert Wagner,de GER,MF,St. Pauli,de Bundesliga,21.80547945,2003,4.4,8,3,2,6,0,4,13,30.8,9,8,0,8,2,10,11,0
2694,Elye Wahi,fr FRA,FW,Marseille,fr Ligue 1,22.33424658,2003,6.4,0,0,0,0,0,0,4,0,4,1,0,1,1,1,0,0
2695,Elye Wahi,fr FRA,"FW,MF",Eint Frankfurt,de Bundesliga,22.33424658,2003,2.2,0,0,0,0,0,0,1,0,1,1,0,1,0,0,1,0
2696,Hauke Wahl,de GER,DF,St. Pauli,de Bundesliga,31.05205479,1994,31,34,25,19,13,2,21,34,61.8,13,43,25,18,31,65,163,4
2697,Kyle Walker,eng ENG,DF,Manchester City,eng Premier League,34.93424658,1990,10.8,17,10,7,7,3,14,26,53.8,12,13,4,9,3,20,13,1
2698,Kyle Walker,eng ENG,DF,Milan,it Serie A,34.93424658,1990,6.9,16,8,11,4,1,13,16,81.3,3,9,5,4,8,24,14,1
2699,Kyle Walker-Peters,eng ENG,DF,Southampton,eng Premier League,28.05753425,1997,32.4,44,29,22,15,7,16,35,45.7,19,27,15,12,19,63,90,1
2700,Christian Walton,eng ENG,GK,Ipswich Town,eng Premier League,29.48219178,1995,6,0,0,0,0,0,0,1,0,1,0,0,0,0,0,1,1
2701,Sebastian Walukiewicz,pl POL,DF,Torino,it Serie A,25.07945205,2000,18.2,38,20,18,16,4,23,31,74.2,8,21,8,13,18,56,58,0
2702,Sebastian Walukiewicz,pl POL,DF,Empoli,it Serie A,25.07945205,2000,2,1,0,1,0,0,0,1,0,1,3,3,0,1,2,15,0
2703,Aaron Wan-Bissaka,eng ENG,DF,West Ham,eng Premier League,27.43561644,1997,31,61,43,29,27,5,19,26,73.1,7,31,9,22,59,120,115,0
2704,Paul Wanner,de GER,"MF,FW",Heidenheim,de Bundesliga,19.36164384,2005,17.7,33,22,15,17,1,14,30,46.7,16,13,0,13,4,37,20,0
2705,Danny Ward,wls WAL,GK,Leicester City,eng Premier League,31.86575342,1993,1.5,0,0,0,0,0,0,0,,0,0,0,0,0,0,1,0
2706,Joel Ward,eng ENG,DF,Crystal Palace,eng Premier League,35.51232877,1989,0,0,0,0,0,0,0,0,,0,0,0,0,0,0,0,0
2707,James Ward-Prowse,eng ENG,MF,West Ham,eng Premier League,30.50410959,1994,8.9,13,9,7,3,3,3,12,25,9,6,3,3,5,18,13,0
2708,James Ward-Prowse,eng ENG,MF,Nott'ham Forest,eng Premier League,30.50410959,1994,4.4,4,1,1,3,0,2,2,100,0,3,2,1,5,9,8,0
2709,Kjell-Arik Wätjen,de GER,MF,Dortmund,de Bundesliga,19.2109589,2006,0.2,0,0,0,0,0,0,0,,0,0,0,0,0,0,2,0
2710,Ollie Watkins,eng ENG,FW,Aston Villa,eng Premier League,29.34246575,1995,25.9,9,6,0,5,4,3,11,27.3,8,11,3,8,8,17,15,2
2711,Timothy Weah,us USA,"FW,DF",Juventus,it Serie A,25.19452055,2000,15.9,31,17,12,12,7,12,19,63.2,7,25,4,21,11,42,23,1
2712,Adam Webster,eng ENG,DF,Brighton,eng Premier League,30.32876712,1995,6.9,8,5,4,3,1,5,11,45.5,6,12,9,3,14,22,28,1
2713,Julian Weigl,de GER,MF,Gladbach,de Bundesliga,29.65205479,1995,30,50,23,24,21,5,25,41,61,16,49,22,27,46,96,77,2
2714,Timon Weiner,de GER,GK,Holstein Kiel,de Bundesliga,26.29041096,1999,25,0,0,0,0,0,0,1,0,1,0,0,0,0,0,17,3
2715,Nelson Weiper,de GER,"FW,MF",Mainz 05,de Bundesliga,20.13150685,2005,7.7,5,4,2,3,0,2,4,50,2,5,0,5,2,7,4,1
2716,Mitchell Weiser,de GER,"DF,MF",Werder Bremen,de Bundesliga,31.03561644,1994,29.9,56,37,17,31,8,26,49,53.1,23,29,2,27,21,77,58,3
2717,Noah Weißhaupt,de GER,"FW,MF",St. Pauli,de Bundesliga,23.61917808,2001,12.2,6,4,3,0,3,3,8,37.5,5,6,0,6,2,8,8,1
2718,Noah Weißhaupt,de GER,FW,Freiburg,de Bundesliga,23.61917808,2001,0.9,0,0,0,0,0,0,1,0,1,0,0,0,0,0,1,0
2719,Danny Welbeck,eng ENG,FW,Brighton,eng Premier League,34.43561644,1990,20.6,22,13,6,12,4,6,17,35.3,11,16,2,14,5,27,12,0
2720,Welington,br BRA,"DF,MF",Southampton,eng Premier League,24.20273973,2001,2.4,13,5,9,3,1,7,12,58.3,5,3,1,2,3,16,12,0
2721,Timo Werner,de GER,"FW,MF",Tottenham,eng Premier League,29.16164384,1996,5.7,6,4,3,3,0,3,13,23.1,10,10,1,9,1,7,7,0
2722,Adam Wharton,eng ENG,MF,Crystal Palace,eng Premier League,20.92054795,2004,14,34,14,14,16,4,17,43,39.5,26,10,2,8,18,52,25,0
2723,Ben White,eng ENG,DF,Arsenal,eng Premier League,27.56986301,1997,10.5,13,9,9,2,2,11,28,39.3,17,9,7,2,15,28,35,0
2724,Silvan Widmer,ch SUI,DF,Mainz 05,de Bundesliga,32.16438356,1993,4.5,10,5,2,6,2,7,11,63.6,4,6,1,5,5,15,20,0
2725,Mats Wieffer,nl NED,"MF,DF",Brighton,eng Premier League,25.4630137,1999,7.7,33,19,11,18,4,16,27,59.3,11,13,1,12,11,44,17,2
2726,Mateusz Wieteska,pl POL,DF,Cagliari,it Serie A,28.22465753,1997,2,1,0,0,1,0,1,1,100,0,3,2,1,7,8,6,0
2727,Caleb Wiley,us USA,"DF,MF",Strasbourg,fr Ligue 1,20.36438356,2004,3,1,0,0,1,0,0,1,0,1,3,1,2,4,5,5,0
2728,Iñaki Williams,gh GHA,"FW,MF",Athletic Club,es La Liga,30.88493151,1994,28.4,17,10,4,8,5,12,23,52.2,11,32,4,28,12,29,32,0
2729,Neco Williams,wls WAL,DF,Nott'ham Forest,eng Premier League,24.05753425,2001,24.8,73,44,54,14,5,43,70,61.4,27,39,9,30,24,97,119,2
2730,Nico Williams,es ESP,FW,Athletic Club,es La Liga,22.8109589,2002,21.3,27,17,10,11,6,10,31,32.3,21,19,1,18,6,33,9,0
2731,Willian,br BRA,"FW,MF",Fulham,eng Premier League,36.73424658,1988,2.7,3,1,0,2,1,1,5,20,4,0,0,0,1,4,1,0
2732,Joe Willock,eng ENG,"MF,FW",Newcastle Utd,eng Premier League,25.70410959,1999,10.6,25,14,14,8,3,18,28,64.3,10,22,5,17,5,30,7,0
2733,Callum Wilson,eng ENG,FW,Newcastle Utd,eng Premier League,33.18082192,1992,3,2,2,0,1,1,0,2,0,2,2,0,2,1,3,1,0
2734,Harry Wilson,wls WAL,"FW,MF",Fulham,eng Premier League,28.11780822,1997,11.1,14,9,8,3,3,9,15,60,6,13,1,12,5,19,7,1
2735,Patrick Wimmer,at AUT,"MF,FW",Wolfsburg,de Bundesliga,23.92876712,2001,18.2,42,31,19,17,6,14,42,33.3,28,31,4,27,31,73,13,2
2736,Jonas Wind,dk DEN,"FW,MF",Wolfsburg,de Bundesliga,26.23561644,1999,20.8,9,5,1,7,1,3,7,42.9,4,16,3,13,6,15,15,0
2737,Harry Winks,eng ENG,MF,Leicester City,eng Premier League,29.24931507,1996,17.1,24,11,12,10,2,13,30,43.3,17,19,7,12,9,33,20,0
2738,Ben Winterburn,eng ENG,"FW,MF",Bournemouth,eng Premier League,20.6630137,2004,0.3,0,0,0,0,0,0,1,0,1,0,0,0,2,2,0,0
2739,Florian Wirtz,de GER,"MF,FW",Leverkusen,de Bundesliga,22.00273973,2003,23.1,32,20,10,12,10,9,20,45,11,25,1,24,8,40,5,0
2740,Yoane Wissa,cd COD,FW,Brentford,eng Premier League,28.66575342,1996,28.4,21,11,6,7,8,10,25,40,15,28,7,21,8,29,20,3
2741,Dani de Wit,nl NED,"MF,FW",Bochum,de Bundesliga,27.2630137,1998,12.2,25,13,9,13,3,16,29,55.2,13,15,4,11,11,36,23,1
2742,Axel Witsel,be BEL,DF,Atlético Madrid,es La Liga,36.30684932,1989,8.5,13,12,4,8,1,10,12,83.3,2,15,8,7,9,22,32,1
2743,Maximilian Wittek,de GER,DF,Bochum,de Bundesliga,29.70136986,1995,28.1,61,40,38,18,5,37,52,71.2,15,52,8,44,27,88,81,2
2744,Marius Wolf,de GER,DF,Augsburg,de Bundesliga,29.9369863,1995,22.6,26,16,12,11,3,15,39,38.5,24,26,5,21,23,49,50,1
2745,Nick Woltemade,de GER,"FW,MF",Stuttgart,de Bundesliga,23.21643836,2002,16.1,9,6,2,4,3,6,10,60,4,22,2,20,1,10,13,1
2746,Jeong Woo-yeong,kr KOR,"MF,FW",Union Berlin,de Bundesliga,25.61917808,1999,14,10,7,5,5,0,3,11,27.3,8,10,1,9,11,21,11,0
2747,Chris Wood,nz NZL,FW,Nott'ham Forest,eng Premier League,33.40547945,1991,28.9,4,4,1,1,2,1,8,12.5,7,11,7,4,5,9,23,1
2748,Nathan Wood-Gordon,eng ENG,DF,Southampton,eng Premier League,22.9260274,2002,6.9,10,7,6,3,1,5,8,62.5,3,8,5,3,4,14,26,2
2749,Christopher Wooh,cm CMR,DF,Rennes,fr Ligue 1,23.62465753,2001,16.2,36,19,21,13,2,18,27,66.7,9,22,8,14,23,59,63,0
2750,Luke Woolfenden,eng ENG,DF,Ipswich Town,eng Premier League,26.53424658,1998,13.2,9,6,5,4,0,2,5,40,3,21,14,7,19,28,76,0
2751,Granit Xhaka,ch SUI,MF,Leverkusen,de Bundesliga,32.6,1992,30.2,44,25,13,25,6,22,39,56.4,17,28,7,21,11,55,46,4
2752,Lamine Yamal,es ESP,FW,Barcelona,es La Liga,17.80821918,2007,27.7,39,26,5,17,17,15,34,44.1,19,12,0,12,13,52,3,0
2753,Daniel Yáñez,es ESP,FW,Real Madrid,es La Liga,18.10136986,2007,0,0,0,0,0,0,0,0,,0,0,0,0,0,0,0,0
2754,Erencan Yardimci,tr TUR,"FW,MF",Hoffenheim,de Bundesliga,23.24383562,2002,3.5,4,3,1,3,0,1,2,50,1,2,0,2,1,5,2,0
2755,Yehor Yarmoliuk,ua UKR,MF,Brentford,eng Premier League,21.17534247,2004,12.5,37,23,14,17,6,23,46,50,23,23,6,17,10,47,31,0
2756,Ryan Yates,eng ENG,MF,Nott'ham Forest,eng Premier League,27.44931507,1997,20.7,41,21,23,14,4,17,37,45.9,20,35,9,26,26,67,59,1
2757,John Yeboah,ec ECU,"FW,MF",Venezia,it Serie A,24.8630137,2000,11,4,3,1,2,1,0,9,0,9,4,0,4,4,8,2,0
2758,Bertuğ Yıldırım,tr TUR,FW,Getafe,es La Liga,22.8109589,2002,11.6,10,5,0,7,3,2,7,28.6,5,12,2,10,1,11,16,0
2759,Kenan Yıldız,tr TUR,"FW,MF",Juventus,it Serie A,20,2005,24.7,51,28,11,25,15,16,28,57.1,12,24,0,24,5,56,11,3
2760,Leny Yoro,fr FRA,DF,Manchester Utd,eng Premier League,19.47123288,2005,11.9,25,10,16,8,1,11,17,64.7,6,5,3,2,17,42,40,0
2761,Ashley Young,eng ENG,"DF,FW",Everton,eng Premier League,39.81917808,1985,18,51,29,23,21,7,32,51,62.7,19,10,3,7,23,74,58,1
2762,Etienne Youte Kinkoue,fr FRA,DF,Le Havre,fr Ligue 1,23.30136986,2002,22.8,18,9,10,7,1,12,18,66.7,6,34,21,13,26,44,147,3
2763,Illia Zabarnyi,ua UKR,DF,Bournemouth,eng Premier League,22.67123288,2002,31.6,46,32,26,19,1,30,44,68.2,14,33,20,13,38,84,165,2
2764,Eloge Zabi,ci CIV,"DF,MF",Reims,fr Ligue 1,18.60821918,2006,0.2,0,0,0,0,0,0,0,,0,0,0,0,0,0,1,0
2765,Mattia Zaccagni,it ITA,FW,Lazio,it Serie A,29.88219178,1995,27.2,34,24,12,18,4,14,27,51.9,13,16,1,15,25,59,19,2
2766,Dan-Axel Zagadou,fr FRA,"DF,MF",Stuttgart,de Bundesliga,25.91780822,1999,0.3,0,0,0,0,0,0,0,,0,0,0,0,1,1,1,0
2767,Yoram Zague,fr FRA,DF,Paris S-G,fr Ligue 1,18.96986301,2006,1.8,4,3,2,1,1,2,3,66.7,1,2,0,2,2,6,2,0
2768,Wilfried Zaha,ci CIV,FW,Lyon,fr Ligue 1,32.47945205,1992,0.8,1,1,1,0,0,1,2,50,1,3,0,3,1,2,0,0
2769,Warren Zaïre-Emery,fr FRA,"MF,DF",Paris S-G,fr Ligue 1,19.15616438,2006,21.4,46,23,16,19,11,21,42,50,21,33,6,27,19,65,20,2
2770,Miha Zajc,si SVN,MF,Toulouse,fr Ligue 1,30.84109589,1994,2.9,4,4,1,2,1,3,5,60,2,2,1,1,3,7,7,0
2771,Denis Zakaria,ch SUI,MF,Monaco,fr Ligue 1,28.45205479,1996,22.8,40,25,15,19,6,24,33,72.7,9,31,8,23,33,73,35,1
2772,Arsen Zakharyan,ru RUS,"MF,FW",Real Sociedad,es La Liga,21.93972603,2003,0.8,1,1,1,0,0,1,1,100,0,1,1,0,1,2,0,0
2773,Nicola Zalewski,pl POL,"DF,FW",Roma,it Serie A,23.27671233,2002,5.9,8,6,3,2,3,2,7,28.6,5,7,2,5,4,12,8,2
2774,Nicola Zalewski,pl POL,DF,Inter,it Serie A,23.27671233,2002,3.3,4,2,3,1,0,2,4,50,2,3,1,2,2,6,3,1
2775,Andre-Frank Zambo Anguissa,cm CMR,MF,Napoli,it Serie A,29.4630137,1995,28.8,40,25,7,28,5,14,33,42.4,19,19,6,13,32,72,36,1
2776,Francesco Zampano,it ITA,DF,Venezia,it Serie A,31.59178082,1993,17.9,30,20,19,9,2,14,28,50,14,20,0,20,6,36,28,2
2777,Nicolò Zaniolo,it ITA,FW,Fiorentina,it Serie A,25.83835616,1999,3.1,2,1,1,1,0,0,2,0,2,2,1,1,0,2,1,0
2778,Nicolò Zaniolo,it ITA,"FW,MF",Atalanta,it Serie A,25.83835616,1999,4,0,0,0,0,0,0,2,0,2,0,0,0,1,1,0,0
2779,Alessandro Zanoli,it ITA,"FW,DF",Genoa,it Serie A,24.58356164,2000,18.1,26,18,11,12,3,9,20,45,11,18,3,15,12,38,39,0
2780,Duván Zapata,co COL,FW,Torino,it Serie A,34.09041096,1991,6.5,7,5,2,0,5,0,3,0,3,2,1,1,2,9,7,0
2781,Gabriele Zappa,it ITA,DF,Cagliari,it Serie A,25.36438356,1999,31.3,36,20,18,16,2,16,30,53.3,14,39,21,18,23,59,85,1
2782,Davide Zappacosta,it ITA,DF,Atalanta,it Serie A,32.89589041,1992,20.8,26,16,15,5,6,20,38,52.6,18,25,6,19,11,37,27,2
2783,Bryan Zaragoza,es ESP,"FW,MF",Osasuna,es La Liga,24.02465753,2001,16.9,13,9,8,4,1,6,20,30,14,9,0,9,1,14,8,0
2784,Anass Zaroury,ma MAR,"FW,MF",Lens,fr Ligue 1,24.48767123,2000,14.1,20,15,4,11,5,9,23,39.1,14,8,0,8,4,24,12,0
2785,Oier Zarraga,es ESP,MF,Udinese,it Serie A,26.32876712,1999,8,14,9,7,7,0,8,19,42.1,11,6,3,3,2,16,7,0
2786,David Zec,si SVN,DF,Holstein Kiel,de Bundesliga,25.3260274,2000,14.1,19,8,14,5,0,12,15,80,3,28,15,13,14,33,80,3
2787,Jordan Zemura,zw ZIM,DF,Udinese,it Serie A,25.46849315,1999,14,25,13,13,9,3,13,24,54.2,11,16,3,13,15,40,37,0
2788,Robin Zentner,de GER,GK,Mainz 05,de Bundesliga,30.51506849,1994,31,2,1,2,0,0,1,2,50,1,0,0,0,0,2,31,4
2789,Alessio Zerbin,it ITA,DF,Venezia,it Serie A,26.16986301,1999,14,49,28,28,12,9,27,49,55.1,22,26,3,23,13,62,22,0
2790,Alessio Zerbin,it ITA,"FW,DF",Napoli,it Serie A,26.16986301,1999,0,2,1,2,0,0,1,1,100,0,0,0,0,0,2,0,0
2791,Kevin Zeroli,it ITA,MF,Monza,it Serie A,20.30958904,2005,3.5,5,1,2,3,0,0,1,0,1,6,1,5,2,7,7,0
2792,Kevin Zeroli,it ITA,MF,Milan,it Serie A,20.30958904,2005,0.1,1,1,0,1,0,0,0,,0,0,0,0,0,1,0,0
2793,Cedric Zesiger,ch SUI,DF,Augsburg,de Bundesliga,26.86027397,1998,11.1,10,5,7,3,0,7,11,63.6,4,15,8,7,19,29,77,1
2794,Cedric Zesiger,ch SUI,DF,Wolfsburg,de Bundesliga,26.86027397,1998,5.8,13,8,6,5,2,6,12,50,6,6,5,1,3,16,28,0
2795,Michael Zetterer,de GER,GK,Werder Bremen,de Bundesliga,29.8109589,1995,32,0,0,0,0,0,0,1,0,1,1,0,1,1,1,10,6
2796,Nathan Zeze,fr FRA,DF,Nantes,fr Ligue 1,19.87671233,2005,14.6,32,18,18,14,0,22,31,71,9,20,8,12,22,54,109,1
2797,Edon Zhegrova,xk KVX,"FW,MF",Lille,fr Ligue 1,26.09315068,1999,10.9,5,2,3,0,2,2,7,28.6,5,8,0,8,4,9,1,0
2798,Piotr Zieliński,pl POL,MF,Inter,it Serie A,30.95616438,1994,10.2,13,9,5,7,1,6,13,46.2,7,9,4,5,6,19,11,1
2799,Oleksandr Zinchenko,ua UKR,"DF,MF",Arsenal,eng Premier League,28.38356164,1996,5.1,4,1,1,2,1,2,7,28.6,5,5,0,5,4,8,6,0
2800,Joshua Zirkzee,nl NED,"FW,MF",Manchester Utd,eng Premier League,23.95068493,2001,15.6,14,8,3,8,3,5,10,50,5,15,4,11,6,20,8,1
2801,Budu Zivzivadze,ge GEO,FW,Heidenheim,de Bundesliga,31.15068493,1994,10.1,16,10,1,9,6,4,8,50,4,9,0,9,3,19,7,0
2802,Luc Zogbé,ci CIV,DF,Brest,fr Ligue 1,20.11232877,2005,7.1,32,18,17,11,4,18,26,69.2,8,11,2,9,14,46,22,1
2803,Nadir Zortea,it ITA,"DF,FW",Cagliari,it Serie A,25.8739726,1999,27.6,28,12,15,11,2,13,32,40.6,19,8,0,8,16,44,43,2
2804,Aristide Zossou,ci CIV,MF,Auxerre,fr Ligue 1,19.88767123,2005,0.2,0,0,0,0,0,0,0,,0,0,0,0,0,0,0,0
2805,Yanis Zouaoui,dz ALG,"DF,FW",Le Havre,fr Ligue 1,30.81643836,1994,10.5,18,8,9,7,2,11,15,73.3,4,14,2,12,8,26,43,0
2806,Igor Zubeldia,es ESP,DF,Real Sociedad,es La Liga,28.09589041,1997,22.7,32,21,21,9,2,14,25,56,11,31,18,13,25,57,91,2
2807,Martín Zubimendi,es ESP,MF,Real Sociedad,es La Liga,26.24931507,1999,28.9,66,35,28,27,11,28,42,66.7,14,38,15,23,36,102,73,3
2808,Edhy Zuliani,it ITA,DF,Toulouse,fr Ligue 1,20.72876712,2004,0.1,0,0,0,0,0,0,0,,0,0,0,0,1,1,0,0
2809,Szymon Żurkowski,pl POL,MF,Empoli,it Serie A,27.60547945,1997,1.2,6,4,2,4,0,4,4,100,0,3,0,3,1,7,2,0
2810,Martin Ødegaard,no NOR,MF,Arsenal,eng Premier League,26.37808219,1998,23.7,19,11,9,7,3,4,24,16.7,20,5,0,5,4,23,5,1
2811,Milan Đurić,ba BIH,FW,Monza,it Serie A,34.95068493,1990,14.1,1,1,0,1,0,0,3,0,3,6,0,6,2,3,17,0
2812,Milan Đurić,ba BIH,FW,Parma,it Serie A,34.95068493,1990,2.6,0,0,0,0,0,0,2,0,2,3,0,3,0,0,1,0
1,Patrick van Aanholt,nl NED,DF,Sparta R'dam,,34.68219178,1990,17.4,24,16,12,11,1,8,26,30.8,18,15,4,11,19,43,42,0
2,Paxten Aaronson,us USA,"MF,FW",Utrecht,,21.69041096,2003,27.7,109,64,42,52,15,40,77,51.9,37,34,7,27,36,145,22,0
3,Jayden Addai,nl NED,"FW,DF",AZ Alkmaar,,19.69041096,2005,3.4,6,3,2,3,1,1,9,11.1,8,7,0,7,1,7,5,0
4,Bobby Adekanye,nl NED,"FW,MF",Go Ahead Eag,,26.21917808,1999,8.6,9,4,2,6,1,3,13,23.1,10,5,0,5,0,9,6,0
5,Aske Adelgaard,dk DEN,DF,Go Ahead Eag,,21.48219178,2003,12.6,18,12,11,5,2,15,24,62.5,9,11,4,7,9,27,42,0
6,Shawn Adewoye,be BEL,DF,Fortuna Sittard,,24.84931507,2000,19.4,30,17,25,3,2,23,31,74.2,8,30,19,11,29,59,115,0
7,Olivier Aertssen,nl NED,DF,Zwolle,,20.74246575,2004,12.4,29,20,20,5,4,14,22,63.6,8,17,9,8,14,43,69,0
8,Amar Ahmed,se SWE,"FW,MF",Willem II,,21.20547945,2004,7.6,11,4,4,4,3,7,14,50,7,12,5,7,10,21,6,0
9,Isaiah Ahmed,cw CUW,MF,Heerenveen,,19.35068493,2005,0.1,1,0,1,0,0,0,1,0,1,0,0,0,0,1,0,0
10,Makan Aiko,fr FRA,FW,Fortuna Sittard,,24.32328767,2001,13.1,9,3,2,1,6,2,4,50,2,12,2,10,9,18,6,0
11,Chuba Akpom,eng ENG,FW,Ajax,,29.56986301,1995,9.2,9,7,5,2,2,4,8,50,4,8,0,8,0,9,11,0
12,Hamdi Akujobi,nl NED,DF,Almere City,,25.28767123,2000,26,54,40,38,13,3,22,34,64.7,12,27,17,10,28,82,86,0
13,Gerald Alders,nl NED,DF,Twente,,19.99452055,2005,0.1,1,1,1,0,0,0,0,,0,0,0,0,0,1,3,0
14,Hussein Ali,iq IRQ,DF,Heerenveen,,23.17808219,2002,2.4,9,6,6,3,0,6,6,100,0,2,0,2,1,10,12,0
15,Jaydon Amauri Banel,nl NED,FW,Ajax,,20.54246575,2004,0.7,0,0,0,0,0,0,0,,0,0,0,0,0,0,0,0
16,Jamal Amofa,nl NED,DF,Go Ahead Eag,,26.44109589,1998,1.8,1,1,1,0,0,1,1,100,0,0,0,0,1,2,4,0
17,Silas Andersen,dk DEN,MF,Utrecht,,20.89315068,2004,0,0,0,0,0,0,0,2,0,2,1,0,1,0,0,0,0
18,Oliver Antman,fi FIN,"FW,MF",Go Ahead Eag,,23.72054795,2001,24.8,27,17,15,9,3,15,24,62.5,9,22,2,20,10,37,33,0
19,Anouar El Azzouzi,nl NED,"MF,DF",Zwolle,,23.93424658,2001,30,87,51,36,43,8,40,67,59.7,27,25,10,15,38,125,98,3
20,Julian Baas,nl NED,MF,Sparta R'dam,,23.05205479,2002,9.4,18,12,7,10,1,13,20,65,7,12,3,9,12,30,20,0
21,Youri Baas,nl NED,DF,Ajax,,22.13424658,2003,22.7,27,12,14,11,2,15,25,60,10,19,10,9,33,60,86,2
22,Isaac Babadi,nl NED,MF,PSV Eindhoven,,20.07945205,2005,1.9,5,5,2,1,2,2,3,66.7,1,5,0,5,3,8,0,0
23,Leandro Bacuna,cw CUW,"DF,MF",Groningen,,33.70410959,1991,23.2,31,21,15,12,4,19,35,54.3,16,28,7,21,20,51,62,1
24,Thibo Baeten,be BEL,"MF,FW",Go Ahead Eag,,22.91780822,2002,0.1,0,0,0,0,0,0,1,0,1,0,0,0,0,0,0,0
25,Esmir Bajraktarevic,ba BIH,"FW,DF",PSV Eindhoven,,20.15342466,2005,0.2,0,0,0,0,0,0,1,0,1,0,0,0,0,0,0,0
26,Saïd Bakari,km COM,DF,Sparta R'dam,,30.61643836,1994,20.8,47,29,29,17,1,31,63,49.2,32,32,11,21,24,71,79,0
27,Johan Bakayoko,be BEL,FW,PSV Eindhoven,,22.04109589,2003,17,19,14,4,6,9,9,16,56.3,7,9,1,8,8,27,10,0
28,Nordin Bakker,nl NED,GK,Almere City,,27.50958904,1997,31,0,0,0,0,0,0,2,0,2,0,0,0,0,0,35,3
29,Max Balard,au AUS,MF,NAC Breda,,24.45479452,2000,29.6,63,32,32,28,3,25,46,54.3,21,45,16,29,43,106,79,2
30,Alex Balboa,gq EQG,MF,Almere City,,24.16438356,2001,4.5,7,2,5,0,2,3,12,25,9,6,1,5,2,9,14,0
31,Théo Barbet,fr FRA,DF,Almere City,,24.16438356,2001,8.8,13,6,7,5,1,3,8,37.5,5,16,12,4,11,24,67,0
32,Vasilios Barkas,gr GRE,GK,Utrecht,,30.93150685,1994,29,1,1,1,0,0,1,2,50,1,0,0,0,0,1,11,0
33,Samuel Bastien,cd COD,"MF,FW",Fortuna Sittard,,28.60547945,1996,14.4,16,10,4,7,5,7,16,43.8,9,9,1,8,3,19,15,0
34,Riechedly Bazoer,nl NED,MF,AZ Alkmaar,,28.56164384,1996,0,2,1,0,2,0,0,0,,0,0,0,0,1,3,0,0
35,Guus Beaumont,nl NED,MF,Almere City,,22.98630137,2002,0.1,0,0,0,0,0,0,0,,0,0,0,0,1,1,0,0
36,Thomas Beelen,nl NED,DF,Feyenoord,,23.89863014,2001,18.9,20,15,9,8,3,8,12,66.7,4,14,12,2,31,51,69,2
37,Raffael Behounek,at AUT,DF,Willem II,,28.05205479,1997,29.9,33,18,22,11,0,22,42,52.4,20,39,31,8,32,65,177,1
38,Kristijan Belic,rs SRB,MF,AZ Alkmaar,,24.11232877,2001,6.5,28,20,11,13,4,8,19,42.1,11,11,6,5,12,40,9,2
39,Mimeirhel Benita,nl NED,DF,Heracles Almelo,,21.4630137,2003,19.7,57,32,37,16,4,32,55,58.2,23,23,9,14,36,93,77,2
40,Walter Benítez,ar ARG,GK,PSV Eindhoven,,32.29041096,1993,30.5,1,1,1,0,0,1,2,50,1,0,0,0,0,1,16,2
41,Mitchell van Bergen,nl NED,FW,Sparta R'dam,,25.68767123,1999,9.6,10,5,3,4,3,6,8,75,2,8,0,8,6,16,5,0
42,Mitchell van Bergen,nl NED,FW,Twente,,25.68767123,1999,8.9,7,4,1,4,2,2,5,40,3,8,0,8,0,7,6,0
43,Thom van Bergen,nl NED,FW,Groningen,,21.3260274,2004,24.7,36,22,14,17,5,10,20,50,10,21,2,19,9,45,30,0
44,Steven Berghuis,nl NED,"FW,MF",Ajax,,33.37534247,1991,13.7,17,10,8,7,2,9,19,47.4,10,5,0,5,6,23,4,0
45,Steven Bergwijn,nl NED,FW,Ajax,,27.57260274,1997,0.2,0,0,0,0,0,0,0,,0,0,0,0,0,0,0,0
46,Gijs Besselink,nl NED,MF,Twente,,20.88493151,2004,3.6,7,4,3,3,1,3,5,60,2,3,1,2,3,10,6,0
47,Daniel Bielica,pl POL,GK,NAC Breda,,26.01369863,1999,30,1,1,1,0,0,0,1,0,1,0,0,0,0,1,14,2
48,Justin Bijlow,nl NED,GK,Feyenoord,,27.28219178,1998,4,0,0,0,0,0,0,0,,0,1,0,1,0,0,2,0
49,Adrian Blake,eng ENG,"FW,MF",Utrecht,,19.80547945,2005,3.9,12,4,8,2,2,6,7,85.7,1,6,0,6,2,14,1,0
50,Thijmen Blokzijl,nl NED,DF,Groningen,,20.1890411,2005,21.7,29,16,19,8,2,17,25,68,8,25,15,10,31,60,105,3
51,Paweł Bochniewicz,pl POL,DF,Heerenveen,,29.26027397,1996,12.3,9,7,4,5,0,5,12,41.7,7,15,11,4,24,33,50,1
52,Jeremy Bokila,cd COD,FW,Willem II,,36.47123288,1988,14.2,10,5,2,4,4,2,11,18.2,9,10,2,8,1,11,17,0
53,Ruben van Bommel,nl NED,FW,AZ Alkmaar,,20.75342466,2004,14.1,30,17,8,14,8,13,35,37.1,22,25,1,24,10,40,6,0
54,Taylor Booth,us USA,"FW,MF",Utrecht,,23.92876712,2001,2.9,4,3,1,2,1,2,5,40,3,1,0,1,3,7,11,0
55,Taylor Booth,us USA,FW,Twente,,23.92876712,2001,3,7,2,1,3,3,3,7,42.9,4,0,0,0,0,7,2,0
56,Olivier Boscagli,fr FRA,DF,PSV Eindhoven,,27.46027397,1997,25.8,55,35,27,24,4,32,41,78,9,19,13,6,37,92,92,1
57,Jesse Bosch,nl NED,MF,Willem II,,25.25479452,2000,27.9,61,35,18,30,13,30,58,51.7,28,36,12,24,24,85,72,0
58,Sven Bouland,nl NED,DF,Groningen,,0,,0.5,0,0,0,0,0,0,1,0,1,0,0,0,0,0,1,0
59,Rayane Bounida,be BEL,FW,Ajax,,19.17260274,2006,0.2,0,0,0,0,0,0,0,,0,0,0,0,0,0,0,0
60,Can Bozdogan,de GER,MF,Utrecht,,24.08219178,2001,4.5,10,7,5,5,0,2,5,40,3,7,2,5,4,14,7,0
61,Mattijs Branderhorst,nl NED,GK,Fortuna Sittard,,31.34246575,1993,25,1,1,1,0,0,1,1,100,0,0,0,0,1,2,16,4
62,Oliver Braude,no NOR,DF,Heerenveen,,21.2,2004,26,91,64,57,28,6,56,83,67.5,27,40,9,31,30,121,89,1
63,Myron van Brederode,nl NED,FW,AZ Alkmaar,,21.83013699,2003,1.9,2,0,1,0,1,2,5,40,3,5,0,5,0,2,1,0
64,Michael Bresser,nl NED,DF,PSV Eindhoven,,18.03013699,2007,0,0,0,0,0,0,0,0,,0,0,0,0,0,0,0,0
65,Jakob Breum,dk DEN,"MF,FW",Go Ahead Eag,,21.4630137,2003,21.8,22,12,8,9,5,8,26,30.8,18,20,6,14,8,30,20,2
66,Brian Brobbey,nl NED,FW,Ajax,,23.25479452,2002,16.1,6,5,2,1,3,4,7,57.1,3,14,2,12,3,9,9,0
67,Michael Brouwer,nl NED,GK,Utrecht,,32.28493151,1993,2,0,0,0,0,0,0,0,,0,0,0,0,0,0,3,0
68,Luuk Brouwers,nl NED,"MF,FW",Heerenveen,,27.00547945,1998,19.4,30,17,9,19,2,12,26,46.2,14,19,3,16,21,51,35,0
69,Jordy Bruijn,nl NED,MF,Heracles Almelo,,28.78356164,1996,3.4,6,4,1,5,0,0,5,0,5,7,1,6,1,7,4,1
70,Max Bruns,nl NED,DF,Twente,,22.49315068,2002,17.2,19,7,12,7,0,9,14,64.3,5,17,15,2,23,42,66,0
71,Thomas Bruns,nl NED,"MF,FW",Heracles Almelo,,33.32328767,1992,10.2,25,16,5,14,6,12,19,63.2,7,16,1,15,2,27,17,0
72,Charles-Andréas Brym,ca CAN,"FW,MF",Sparta R'dam,,26.73972603,1998,3.4,3,2,2,1,0,1,3,33.3,2,0,0,0,0,3,4,0
73,Charles-Andréas Brym,ca CAN,FW,Almere City,,26.73972603,1998,11.4,6,6,0,3,3,2,7,28.6,5,9,1,8,0,6,3,0
74,Hugo Bueno,es ESP,DF,Feyenoord,,22.62739726,2002,13.1,17,15,10,4,3,9,13,69.2,4,11,4,7,11,28,22,0
75,Thomas Buitink,nl NED,"FW,MF",Zwolle,,24.89041096,2000,2.6,0,0,0,0,0,0,0,,0,1,0,1,0,0,1,0
76,Ezequiel Bullaude,ar ARG,"MF,FW",Fortuna Sittard,,24.52328767,2000,20.4,30,19,10,12,8,15,43,34.9,28,18,2,16,12,42,18,0
77,Abdurrahman Burak Sayın,,FW,Fortuna Sittard,,0,,0,0,0,0,0,0,0,0,,0,0,0,0,0,0,0,0
78,Maxime Busi,be BEL,DF,NAC Breda,,25.55616438,1999,8.6,20,11,13,4,3,12,24,50,12,9,5,4,5,25,28,1
79,Zico Buurmeester,nl NED,"MF,FW",AZ Alkmaar,,22.90958904,2002,12.2,27,14,9,16,2,16,25,64,9,15,2,13,10,37,16,1
80,Àlex Carbonell,es ESP,MF,Almere City,,27.63561644,1997,2.6,7,4,5,2,0,4,6,66.7,2,3,3,0,2,9,6,0
81,Julián Carranza,ar ARG,FW,Feyenoord,,24.95342466,2000,8.8,9,5,2,5,2,2,5,40,3,5,1,4,1,10,7,0
82,Stephano Carrillo,mx MEX,FW,Feyenoord,,19.16164384,2006,0.6,1,1,0,0,1,0,0,,0,0,0,0,0,1,0,0
83,Yoann Cathline,fr FRA,FW,Utrecht,,22.78630137,2002,20.2,22,20,4,13,5,10,19,52.6,9,9,1,8,6,28,13,1
84,Kayky Chagas,br BRA,"FW,DF",Sparta R'dam,,21.89863014,2003,1.3,1,1,0,1,0,1,1,100,0,1,0,1,2,3,2,0
85,Jordy Clasie,nl NED,MF,AZ Alkmaar,,33.85479452,1991,20.2,49,23,12,30,7,13,27,48.1,14,14,1,13,32,81,41,2
86,Pelle Clement,nl NED,"MF,FW",Sparta R'dam,,28.96164384,1996,17.5,25,15,13,9,3,12,30,40,18,20,9,11,23,48,45,0
87,Denilho Cleonise,nl NED,"FW,MF",RKC Waalwijk,,23.40547945,2001,12.1,6,5,5,1,0,4,15,26.7,11,12,0,12,3,9,12,1
88,Amara Conde,de GER,MF,Heerenveen,,28.3260274,1997,7.2,27,20,13,10,4,15,25,60,10,7,2,5,2,29,8,0
89,Vito van Crooy,nl NED,"MF,FW",NEC Nijmegen,,29.2630137,1996,19,27,15,13,10,4,14,29,48.3,15,18,6,12,9,36,26,1
90,Alessio da Cruz,cv CPV,FW,Fortuna Sittard,,28.29315068,1997,13.2,11,6,3,3,5,4,11,36.4,7,5,0,5,2,13,9,1
91,Ro-Zangelo Daal,nl NED,FW,AZ Alkmaar,,21.23013699,2004,0.5,2,2,1,1,0,1,1,100,0,0,0,0,0,2,0,0
92,Jasper Dahlhaus,nl NED,"DF,FW",Fortuna Sittard,,23.43561644,2001,17.4,39,24,23,13,3,19,38,50,19,30,8,22,31,70,53,0
93,Matteo Dams,be BEL,DF,PSV Eindhoven,,21.15616438,2004,10.2,27,21,13,11,3,14,23,60.9,9,13,5,8,15,42,21,0
94,Damil Dankerlui,sr SUR,"DF,FW",Almere City,,28.69589041,1996,1.8,4,3,3,1,0,3,5,60,2,1,0,1,0,4,8,0
95,Argyrios Darelas,gr GRE,"MF,FW",NEC Nijmegen,,21.55068493,2003,0.5,0,0,0,0,0,0,0,,0,0,0,0,0,0,0,0
96,Brynjolfur Darri Willumsson,is ISL,"FW,MF",Groningen,,24.72876712,2000,9.9,8,5,2,3,3,2,7,28.6,5,8,0,8,1,9,1,0
97,Jari De Busser,be BEL,GK,Go Ahead Eag,,25.5369863,1999,14,0,0,0,0,0,0,0,,0,0,0,0,0,0,7,1
98,Brian De Keersmaecker,be BEL,MF,Heracles Almelo,,24.99726027,2000,27.6,69,40,30,31,8,27,57,47.4,30,50,11,39,38,107,57,1
99,Mats Deijl,nl NED,DF,Go Ahead Eag,,27.80547945,1997,31,48,33,23,18,7,29,44,65.9,15,29,15,14,11,59,106,1
100,Maxim Dekker,nl NED,DF,AZ Alkmaar,,21.03835616,2004,5.5,2,1,0,2,0,0,0,,0,3,0,3,6,8,21,0
101,Logan Delaurier Chaubet,fr FRA,FW,Almere City,,23.03561644,2002,6.2,6,3,1,3,2,2,10,20,8,4,0,4,8,14,5,1
102,Branco van den Boomen,nl NED,MF,Ajax,,29.7890411,1995,7,12,4,1,10,1,4,8,50,4,8,3,5,1,13,7,0
103,Damian van der Haar,nl NED,DF,Zwolle,,21.29863014,2004,19.9,35,21,21,12,2,25,47,53.2,22,20,5,15,16,51,72,1
104,Mickey van der Hart,nl NED,GK,Heerenveen,,30.89315068,1994,18,0,0,0,0,0,0,0,,0,0,0,0,0,0,5,3
105,Mike van der Hoorn,nl NED,DF,Utrecht,,32.55342466,1992,26.4,33,18,22,9,2,18,27,66.7,9,26,10,16,34,67,171,2
106,Djevencio van der Kust,sr SUR,DF,Sparta R'dam,,24.01369863,2001,10.3,17,13,10,7,0,8,17,47.1,9,20,8,12,10,27,35,0
107,Richard van der Venne,nl NED,"MF,FW",RKC Waalwijk,,32.96986301,1992,8.2,8,6,2,4,2,5,13,38.5,8,10,2,8,2,10,8,0
108,Silvester van der Water,nl NED,"FW,MF",RKC Waalwijk,,28.59452055,1996,6.9,6,3,3,1,2,3,17,17.6,14,5,0,5,8,14,17,0
109,David van der Werff,nl NED,MF,Groningen,,20.67671233,2004,0.2,0,0,0,0,0,0,0,,0,0,0,0,0,0,0,0
110,Anthony Descotte,be BEL,"FW,MF",Utrecht,,21.75342466,2003,4.4,3,1,0,3,0,2,6,33.3,4,3,0,3,1,4,0,0
111,Sergiño Dest,us USA,DF,PSV Eindhoven,,24.50136986,2000,2,2,2,0,2,0,1,5,20,4,1,0,1,2,4,1,0
112,Matisse Didden,be BEL,DF,Utrecht,,23.57260274,2001,4.6,2,1,1,1,0,1,3,33.3,2,5,4,1,3,5,34,1
113,Thomas Didillon,fr FRA,GK,Willem II,,29.43287671,1995,31,0,0,0,0,0,0,1,0,1,0,0,0,0,0,13,3
114,Mitchell Dijks,nl NED,DF,Fortuna Sittard,,32.23287671,1993,17.2,35,24,21,12,2,22,42,52.4,20,12,1,11,16,51,44,1
115,Elijah Dijkstra,nl NED,DF,AZ Alkmaar,,18.74794521,2006,1,1,0,1,0,0,1,1,100,0,1,0,1,2,3,3,0
116,Julius Dirksen,nl NED,"DF,MF",Go Ahead Eag,,22.25205479,2003,0.8,2,2,1,1,0,2,3,66.7,1,2,1,1,0,2,5,0
117,Nick Doodeman,nl NED,"FW,MF",Willem II,,28.53424658,1996,14.5,13,10,6,3,4,7,9,77.8,2,10,4,6,5,18,19,0
118,Couhaib Driouech,ma MAR,FW,PSV Eindhoven,,23.04931507,2002,3,3,3,1,1,1,1,6,16.7,5,0,0,0,0,3,2,0
119,Joel Drommel,nl NED,GK,PSV Eindhoven,,28.46575342,1996,0.5,0,0,0,0,0,0,0,,0,0,0,0,0,0,0,0
120,Laros Duarte,cv CPV,MF,Groningen,,28.18082192,1997,0.2,1,1,0,1,0,0,0,,0,0,0,0,1,2,0,0
121,Oliver Edvardsen,no NOR,FW,Ajax,,26.12876712,1999,3.2,4,3,0,4,0,0,1,0,1,4,2,2,4,8,4,0
122,Oliver Edvardsen,no NOR,"FW,MF",Go Ahead Eag,,26.12876712,1999,9.9,11,6,6,4,1,6,13,46.2,7,9,3,6,5,16,16,0
123,Victor Edvardsen,se SWE,"FW,MF",Go Ahead Eag,,29.30410959,1996,27.4,7,5,1,4,2,2,11,18.2,9,7,1,6,4,11,13,0
124,Espen van Ee,nl NED,MF,Heerenveen,,21.83287671,2003,23.5,71,42,28,32,11,34,58,58.6,24,38,12,26,28,99,28,4
125,Mike Eerdhuijzen,nl NED,DF,Sparta R'dam,,24.8109589,2000,28.2,31,18,20,10,1,15,34,44.1,19,38,21,17,42,73,180,2
126,Roshon van Eijma,cw CUW,DF,RKC Waalwijk,,26.90410959,1998,17.9,23,16,18,5,0,18,25,72,7,32,17,15,32,55,141,2
127,Carel Eiting,nl NED,MF,Sparta R'dam,,27.22739726,1998,9.8,21,13,6,9,6,12,20,60,8,15,5,10,10,31,26,0
128,Carel Eiting,nl NED,MF,Twente,,27.22739726,1998,6.5,23,17,9,12,2,7,12,58.3,5,14,0,14,6,29,7,0
129,Hjalmar Ekdal,se SWE,DF,Groningen,,26.5369863,1998,11,18,12,8,10,0,12,12,100,0,9,4,5,12,30,75,0
130,Úmaro Embaló,pt POR,FW,Fortuna Sittard,,23.99726027,2001,0.1,0,0,0,0,0,0,0,,0,0,0,0,0,0,0,0
131,Noam Emeran,fr FRA,"DF,MF",Groningen,,22.6109589,2002,0.7,2,2,0,2,0,1,3,33.3,2,2,0,2,3,5,0,0
132,Mario Engels,de GER,"FW,MF",Heracles Almelo,,31.53424658,1993,23.3,22,17,10,6,6,6,14,42.9,8,11,0,11,8,30,14,0
133,Alonzo Engwanda,be BEL,"MF,DF",Utrecht,,22.26849315,2003,11.1,36,26,13,20,3,10,21,47.6,11,13,2,11,27,63,26,1
134,Ante Erceg,hr CRO,"FW,MF",Fortuna Sittard,,35.39452055,1989,3.2,4,2,2,1,1,1,2,50,1,2,0,2,0,4,1,0
135,Luca Everink,nl NED,DF,Go Ahead Eag,,24.23287671,2001,0.6,1,1,1,0,0,0,0,,0,1,0,1,0,1,8,0
136,Juan Familia-Castillo,nl NED,DF,RKC Waalwijk,,25.30684932,2000,14.4,31,24,22,9,0,19,33,57.6,14,23,5,18,8,39,56,1
137,Kevin Felida,cw CUW,"MF,FW",RKC Waalwijk,,25.47945205,1999,4.7,12,6,7,4,1,9,13,69.2,4,13,1,12,3,15,6,1
138,Saná Fernandes,pt POR,"FW,MF",NAC Breda,,19.15342466,2006,5.2,8,6,3,3,2,4,6,66.7,2,2,0,2,4,12,1,0
139,Nick Fichtinger,nl NED,MF,Zwolle,,21.07945205,2004,9.5,49,38,20,20,9,14,38,36.8,24,22,9,13,9,58,28,0
140,Kolbeinn Finnsson,is ISL,DF,Utrecht,,25.69315068,1999,1,5,5,5,0,0,4,5,80,1,3,2,1,0,5,7,0
141,Kian Fitz-Jim,nl NED,MF,Ajax,,21.83287671,2003,12.7,26,14,7,13,6,12,29,41.4,17,17,3,14,10,36,13,1
142,Ryan Flamingo,nl NED,DF,PSV Eindhoven,,22.34246575,2002,29.7,43,25,23,17,3,22,32,68.8,10,40,18,22,37,80,132,3
143,Sherel Floranus,cw CUW,DF,Almere City,,26.69863014,1998,2,5,4,4,1,0,3,7,42.9,4,3,2,1,3,8,7,0
144,Sherel Floranus,cw CUW,DF,Zwolle,,26.69863014,1998,17,33,22,16,14,3,14,25,56,11,18,6,12,24,57,86,0
145,Carlos Forbs,pt POR,FW,Ajax,,21.12876712,2004,0.4,1,1,0,1,0,0,0,,0,0,0,0,0,1,0,0
146,Ryan Fosso,ch SUI,MF,Fortuna Sittard,,22.88219178,2002,26.3,34,19,11,21,2,13,31,41.9,18,25,9,16,40,74,45,2
147,Oscar Fraulo,dk DEN,MF,Utrecht,,21.4109589,2003,16.3,29,16,11,13,5,9,31,29,22,17,2,15,20,49,37,0
148,Anton Gaaei,dk DEN,DF,Ajax,,22.45753425,2002,17.8,29,18,12,12,5,15,20,75,5,14,1,13,12,41,41,0
149,Matt Garbett,nz NZL,"FW,MF",NAC Breda,,23.06027397,2002,6.4,8,5,5,2,1,4,15,26.7,11,6,0,6,5,13,2,1
150,Anselmo García MacNulty,ie IRL,DF,Zwolle,,22.20547945,2003,31,32,16,27,4,1,20,27,74.1,7,40,24,16,31,63,190,2
151,Stijn van Gassel,nl NED,GK,NEC Nijmegen,,28.54520548,1996,2,0,0,0,0,0,0,0,,0,0,0,0,0,0,3,1
152,Lutsharel Geertruida,nl NED,DF,Feyenoord,,24.79726027,2000,3,4,3,2,1,1,2,3,66.7,1,1,0,1,3,7,2,0
153,Liam van Gelderen,nl NED,DF,RKC Waalwijk,,24.11780822,2001,27,53,33,46,4,3,29,37,78.4,8,39,21,18,48,101,167,1
154,Djomar Giersthove,nl NED,DF,Feyenoord,,20.16712329,2005,0.1,0,0,0,0,0,0,0,,0,0,0,0,0,0,0,0
155,Teun Gijselhart,nl NED,MF,Zwolle,,20.07945205,2005,0.3,3,2,1,2,0,2,3,66.7,1,0,0,0,0,3,1,0
156,Santiago Giménez,mx MEX,FW,Feyenoord,,24.04657534,2001,8.5,5,2,0,2,3,0,1,0,1,5,0,5,0,5,5,0
157,Mika Godts,be BEL,FW,Ajax,,19.90958904,2005,16.8,21,11,10,7,4,8,19,42.1,11,18,2,16,4,25,10,1
158,Wouter Goes,nl NED,DF,AZ Alkmaar,,20.90136986,2004,20.8,25,10,12,11,2,14,26,53.8,12,22,14,8,23,48,93,3
159,Facundo González,uy URU,DF,Feyenoord,,21.91232877,2003,0.9,1,1,0,0,1,1,1,100,0,0,0,0,1,2,5,0
160,Roberto González,es ESP,"MF,FW",NEC Nijmegen,,24.3260274,2001,10.9,12,9,5,3,4,7,15,46.7,8,10,0,10,3,15,7,0
161,Tristan Gooijer,nl NED,DF,Zwolle,,20.67123288,2004,0.3,0,0,0,0,0,0,1,0,1,1,1,0,0,0,5,0
162,Marvin da Graça,lu LUX,DF,Almere City,,30.2109589,1995,6,11,10,5,5,1,7,8,87.5,1,6,3,3,11,22,29,0
163,Simon Graves Jensen,dk DEN,DF,Zwolle,,25.95342466,1999,22.7,14,8,8,6,0,10,13,76.9,3,33,24,9,17,31,176,0
164,Leo Greiml,at AUT,DF,NAC Breda,,23.83835616,2001,26.7,56,39,42,12,2,38,57,66.7,19,50,32,18,43,99,216,0
165,Dario Grujcic,at AUT,"DF,MF",Fortuna Sittard,,25.96164384,1999,2.9,11,8,7,3,1,10,11,90.9,1,8,4,4,4,15,22,0
166,Baptiste Guillaume,be BEL,"FW,MF",Almere City,,29.88493151,1995,4.3,3,2,0,2,1,0,1,0,1,1,0,1,1,4,3,0
167,Eser Gürbüz,nl NED,FW,Heerenveen,,18.16438356,2007,1.5,5,3,1,4,0,5,9,55.6,4,2,1,1,1,6,4,1
168,Rodrigo Guth,br BRA,DF,Fortuna Sittard,,24.48219178,2000,27.5,45,24,29,15,1,22,31,71,9,37,18,19,22,67,195,2
169,Jonathan de Guzmán,nl NED,MF,Sparta R'dam,,37.64109589,1987,0.4,0,0,0,0,0,0,0,,0,0,0,0,1,1,0,0
170,Anis Hadj Moussa,dz ALG,"FW,MF",Feyenoord,,23.22739726,2002,19.4,27,19,9,12,6,13,29,44.8,16,30,0,30,8,35,12,3
171,Alen Halilović,hr CRO,"MF,FW",Fortuna Sittard,,28.87945205,1996,19.7,24,13,8,11,5,11,30,36.7,19,19,0,19,7,31,8,0
172,Denzel Hall,nl NED,DF,Heerenveen,,23.95342466,2001,6.2,18,7,9,5,4,6,11,54.5,5,7,2,5,11,29,23,0
173,Sébastien Haller,ci CIV,FW,Utrecht,,30.86849315,1994,12.2,12,5,0,8,4,6,15,40,9,9,1,8,0,12,18,0
174,Dávid Hancko,sk SVK,DF,Feyenoord,,27.39178082,1997,29,38,27,20,14,4,20,25,80,5,34,16,18,25,63,96,3
175,Kornelius Hansen,no NOR,"FW,MF",Almere City,,23.99726027,2001,20.2,14,8,6,3,5,8,24,33.3,16,8,1,7,6,20,25,0
176,Sontje Hansen,nl NED,"FW,MF",NEC Nijmegen,,22.98082192,2002,18.5,16,8,3,8,5,10,24,41.7,14,15,2,13,9,25,13,2
177,Quilindschy Hartman,nl NED,DF,Feyenoord,,23.47123288,2001,6.2,10,6,4,5,1,4,9,44.4,5,7,4,3,6,16,20,0
178,Jorrel Hato,nl NED,DF,Ajax,,19.16164384,2006,26,55,35,25,22,8,31,41,75.6,10,34,9,25,20,75,57,4
179,Mike Hauptmeijer,nl NED,GK,Zwolle,,28.13150685,1997,4,0,0,0,0,0,0,0,,0,0,0,0,0,0,1,1
180,Thom Haye,id IDN,MF,Almere City,,30.23287671,1995,19.7,45,28,19,20,6,23,42,54.8,19,26,3,23,29,74,32,1
181,Jordan Henderson,eng ENG,MF,Ajax,,34.88219178,1990,17.8,30,16,9,16,5,18,31,58.1,13,22,6,16,22,52,39,1
182,Lucas Vennegoor of Hesselink,nl NED,"FW,MF",Twente,,19.14246575,2006,0.7,1,1,0,1,0,0,1,0,1,0,0,0,0,1,1,0
183,Mees Hilgers,id IDN,DF,Twente,,23.97808219,2001,18.4,47,29,24,23,0,31,48,64.6,17,15,1,14,14,61,72,0
184,Mees Hoedemakers,nl NED,MF,NEC Nijmegen,,27.20821918,1998,19.2,50,35,25,17,8,27,47,57.4,20,22,12,10,21,71,43,0
185,Justin Hoogma,nl NED,DF,Heracles Almelo,,26.89863014,1998,2.8,5,4,5,0,0,4,6,66.7,2,3,1,2,1,6,26,0
186,Sydney van Hooijdonk,nl NED,FW,NAC Breda,,25.24109589,2000,9.8,8,7,2,4,2,3,6,50,3,3,1,2,0,8,10,0
187,Nikolai Hopland,no NOR,DF,Heerenveen,,20.78082192,2004,25.9,39,21,18,20,1,19,29,65.5,10,22,11,11,24,63,144,4
188,Siebe Horemans,be BEL,DF,Utrecht,,26.92328767,1998,26.2,68,52,39,20,9,39,74,52.7,35,22,11,11,46,114,130,2
189,Jizz Hornkamp,nl NED,"FW,MF",Heracles Almelo,,27.16164384,1998,15.3,9,6,2,5,2,2,8,25,6,18,2,16,3,12,20,0
190,Jeroen Houwen,nl NED,GK,RKC Waalwijk,,29.20821918,1996,24,1,0,1,0,0,1,1,100,0,0,0,0,0,1,9,1
191,Johan Hove,no NOR,MF,Groningen,,24.65753425,2000,19.4,26,14,9,15,2,15,21,71.4,6,20,5,15,18,44,37,0
192,Joël Ideho,nl NED,FW,Sparta R'dam,,21.8,2003,1.9,7,4,1,4,2,4,7,57.1,3,7,0,7,2,9,2,0
193,Younes Taha El Idrissi,ma MAR,FW,Twente,,0,,1.6,7,3,3,0,4,2,7,28.6,5,2,0,2,2,9,1,0
194,Mohammed Ihattaren,nl NED,"MF,FW",RKC Waalwijk,,23.22465753,2002,14.5,18,11,8,6,4,7,10,70,3,11,1,10,7,25,18,1
195,Hwang In-beom,kr KOR,MF,Feyenoord,,28.62191781,1996,16.2,29,18,8,15,6,19,39,48.7,20,10,2,8,16,45,21,2
196,Zidane Iqbal,iq IRQ,MF,Utrecht,,22.02191781,2003,16.1,22,15,8,14,0,8,19,42.1,11,6,3,3,18,40,20,0
197,Luka Ivanušec,hr CRO,"FW,MF",Feyenoord,,26.43835616,1998,5.4,4,3,1,3,0,3,6,50,3,7,2,5,1,5,1,0
198,Joey Jacobs,nl NED,DF,Almere City,,25.06849315,2000,11.7,18,14,11,7,0,9,13,69.2,4,15,13,2,17,35,74,0
199,Alireza Jahanbakhsh,ir IRN,"FW,MF",Heerenveen,,31.73150685,1993,16.1,31,17,12,15,4,17,32,53.1,15,9,0,9,13,44,26,1
200,Alexander Jakobsen,eg EGY,"FW,MF",RKC Waalwijk,,31.13150685,1994,0.8,3,3,3,0,0,2,3,66.7,1,0,0,0,0,3,1,0
201,Dean James,id IDN,DF,Go Ahead Eag,,25.01369863,2000,18.3,22,13,11,6,5,10,23,43.5,13,17,6,11,9,31,63,0
202,Dominik Janošek,cz CZE,MF,NAC Breda,,26.89315068,1998,12.2,7,3,3,3,1,4,13,30.8,9,5,0,5,3,10,15,0
203,Dies Janse,nl NED,DF,Ajax,,19.29589041,2006,3,4,2,3,1,0,3,5,60,2,1,0,1,2,6,6,0
204,Ali Jasim,iq IRQ,"FW,MF",Almere City,,21.28767123,2004,2.5,2,2,0,1,1,1,4,25,3,1,0,1,1,3,0,0
205,Victor Jensen,dk DEN,MF,Utrecht,,25.23561644,2000,11.1,18,13,9,8,1,7,15,46.7,8,4,1,3,2,20,14,2
206,Owen Johnson,nl NED,MF,Fortuna Sittard,,19.66849315,2005,0,0,0,0,0,0,0,0,,0,0,0,0,0,0,0,0
207,Miliano Jonathans,nl NED,"FW,MF",Utrecht,,21.08219178,2004,2.3,3,1,1,2,0,2,3,66.7,1,1,0,1,2,5,4,0
208,Luuk de Jong,nl NED,FW,PSV Eindhoven,,34.68767123,1990,24.2,21,12,3,11,7,9,25,36,16,17,4,13,4,25,34,0
209,Tika de Jonge,nl NED,MF,Groningen,,22.15068493,2003,13.8,42,21,17,21,4,21,31,67.7,10,18,5,13,19,61,46,0
210,Patrick Joosten,nl NED,"MF,FW",Willem II,,29.05753425,1996,7.2,3,3,0,2,1,2,6,33.3,4,3,1,2,4,7,3,1
211,Mauro Júnior,br BRA,"DF,MF",PSV Eindhoven,,25.99726027,1999,19.3,43,28,23,12,8,30,44,68.2,14,20,2,18,14,57,41,0
212,Hidde Jurjus,nl NED,GK,Groningen,,31.23287671,1994,1,0,0,0,0,0,0,0,,0,0,0,0,0,0,1,0
213,Daniël van Kaam,nl NED,MF,Heracles Almelo,,24.86575342,2000,11.6,22,12,12,8,2,9,13,69.2,4,8,2,6,7,29,23,0
214,Junior Kadile,fr FRA,"FW,MF",Almere City,,22.38356164,2002,22.2,45,22,18,17,10,13,30,43.3,17,22,4,18,11,56,21,0
215,Jochem van de Kamp,nl NED,"MF,FW",Almere City,,21.50410959,2003,22.2,51,29,16,29,6,20,34,58.8,14,25,6,19,32,83,40,0
216,Ahmetcan Kaplan,tr TUR,DF,Ajax,,22.29863014,2003,6.2,15,6,8,4,3,7,10,70,3,6,3,3,3,18,33,0
217,Daniel Karlsbakk,no NOR,FW,Heerenveen,,22.07671233,2003,3,0,0,0,0,0,0,1,0,1,4,0,4,1,1,7,0
218,Souffian El Karouani,ma MAR,DF,Utrecht,,24.54246575,2000,30,71,45,37,27,7,28,41,68.3,13,27,6,21,28,99,93,0
219,Rick Karsdorp,nl NED,DF,PSV Eindhoven,,30.22739726,1995,7.5,17,12,9,6,2,12,18,66.7,6,2,2,0,4,21,13,0
220,Neraysho Kasanwirjo,nl NED,DF,Feyenoord,,23.20821918,2002,1.3,1,1,1,0,0,0,0,,0,4,2,2,2,3,4,0
221,Denso Kasius,nl NED,DF,AZ Alkmaar,,22.57808219,2002,13.1,28,23,19,5,4,19,32,59.4,13,13,5,8,22,50,44,1
222,Adam Kayed,ps PLE,"MF,DF",NAC Breda,,23.17534247,2002,5.1,18,10,7,8,3,7,13,53.8,6,6,0,6,3,21,12,0
223,Dennis Kaygin,de GER,"MF,FW",Willem II,,21.09041096,2004,1.5,2,0,0,2,0,0,1,0,1,1,0,1,1,3,4,0
224,Emilio Kehrer,de GER,"FW,MF",Willem II,,23.1260274,2002,8.2,12,8,6,4,2,2,13,15.4,11,11,2,9,2,14,18,0
225,Fabian de Keijzer,nl NED,GK,Heracles Almelo,,24.98630137,2000,31,1,0,1,0,0,1,3,33.3,2,1,0,1,0,1,10,1
226,Boy Kemper,nl NED,DF,NAC Breda,,25.87123288,1999,24.7,41,22,20,19,2,22,35,62.9,13,30,15,15,26,67,87,0
227,Sam Kersten,nl NED,DF,Heerenveen,,27.26027397,1998,23.9,46,30,30,16,0,26,39,66.7,13,34,19,15,28,74,139,1
228,Joey Kesting,nl NED,GK,RKC Waalwijk,,24.16164384,2001,3,0,0,0,0,0,0,0,,0,0,0,0,0,0,2,0
229,Joshua Kitolano,no NOR,MF,Sparta R'dam,,23.75342466,2001,15.6,29,19,11,16,2,9,25,36,16,19,6,13,11,40,22,0
230,Mathias Kjølø,no NOR,MF,Twente,,23.85479452,2001,6.8,11,9,5,5,1,6,9,66.7,3,4,2,2,6,17,10,1
231,Davy Klaassen,nl NED,MF,Ajax,,32.2,1993,21.8,31,9,13,9,9,15,33,45.5,18,33,14,19,12,43,44,2
232,Mike Kleijn,nl NED,DF,Sparta R'dam,,20.23287671,2005,1.1,3,3,3,0,0,0,0,,0,1,0,1,3,6,2,0
233,Mats Köhlert,de GER,DF,Heerenveen,,27.00821918,1998,24.5,54,30,32,16,6,34,63,54,29,30,7,23,38,92,65,1
234,Don-Angelo Konadu,nl NED,FW,Ajax,,19.00547945,2006,0.7,1,0,0,0,1,0,1,0,1,1,0,1,0,1,0,0
235,Terence Kongolo,nl NED,DF,NAC Breda,,31.21917808,1994,7.8,17,12,12,3,2,6,9,66.7,3,17,10,7,19,36,49,1
236,Luuk Koopmans,nl NED,GK,Fortuna Sittard,,31.46027397,1993,6,0,0,0,0,0,0,0,,0,0,0,0,0,0,2,0
237,Peer Koopmeiners,nl NED,"MF,DF",AZ Alkmaar,,25.00273973,2000,28,103,59,32,53,18,50,87,57.5,37,39,10,29,25,128,67,0
238,Hasip Korkmazyürek,de GER,MF,Fortuna Sittard,,22.0109589,2003,0.1,0,0,0,0,0,0,0,,0,1,1,0,0,0,0,0
239,Roy Kortsmit,nl NED,GK,NAC Breda,,32.69041096,1992,1,0,0,0,0,0,0,0,,0,0,0,0,0,0,1,0
240,Martin Koscelník,sk SVK,DF,NAC Breda,,30.17534247,1995,1.2,7,2,6,1,0,2,4,50,2,0,0,0,4,11,7,0
241,Kacper Kostorz,pl POL,"FW,MF",NAC Breda,,25.70410959,1999,5.9,3,2,1,1,1,2,4,50,2,7,2,5,1,4,3,0
242,Joris Kramer,nl NED,DF,Go Ahead Eag,,28.75616438,1996,30.8,25,14,14,10,1,12,20,60,8,35,28,7,26,51,229,2
243,Michiel Kramer,nl NED,FW,RKC Waalwijk,,36.41917808,1988,7.3,3,1,0,3,0,1,4,25,3,4,2,2,1,4,7,0
244,Filip Krastev,bg BUL,"FW,MF",Zwolle,,23.55342466,2001,21.5,55,40,25,22,8,26,58,44.8,32,46,1,45,35,90,28,1
245,Wessel Kuhn,nl NED,DF,PSV Eindhoven,,18.63287671,2006,0.1,0,0,0,0,0,0,0,,0,0,0,0,2,2,1,0
246,Roy Kuijpers,nl NED,"FW,MF",NAC Breda,,25.29589041,2000,2.6,3,3,3,0,0,1,5,20,4,1,0,1,2,5,4,0
247,Bas Kuipers,nl NED,DF,Twente,,30.71506849,1994,16.4,15,11,4,5,6,8,12,66.7,4,29,11,18,15,30,56,0
248,Luka Kulenović,ba BIH,FW,Heracles Almelo,,25.59726027,1999,14.4,12,8,2,8,2,3,6,50,3,9,2,7,2,14,7,0
249,Harry Kuster,nl NED,"FW,MF",Twente,,19.64657534,2005,0.1,0,0,0,0,0,0,0,,0,0,0,0,0,0,0,0
250,Dave Kwakman,nl NED,"MF,FW",AZ Alkmaar,,20.74246575,2004,1.7,5,1,2,2,1,5,6,83.3,1,0,0,0,2,7,4,1
251,Dave Kwakman,nl NED,"FW,MF",Groningen,,20.74246575,2004,9,22,18,7,7,8,14,23,60.9,9,17,2,15,5,27,6,0
252,Amine Lachkar,nl NED,MF,Willem II,,22.04657534,2003,17.7,54,33,22,29,3,26,40,65,14,41,21,20,20,74,42,1
253,Gustaf Lagerbielke,se SWE,DF,Twente,,25.06849315,2000,16.1,33,22,19,11,3,24,34,70.6,10,18,6,12,16,49,117,0
254,Mayckel Lahdo,se SWE,FW,AZ Alkmaar,,22.34520548,2002,9.4,10,7,2,4,4,6,18,33.3,12,8,0,8,3,13,5,0
255,Boris lambert,be BEL,MF,Willem II,,25.06849315,2000,13.7,33,18,18,13,2,16,32,50,16,22,7,15,33,66,57,2
256,Sam Lammers,nl NED,FW,Twente,,28.01369863,1997,16.7,8,4,2,2,4,4,7,57.1,3,9,0,9,4,12,13,0
257,Tygo Land,nl NED,MF,PSV Eindhoven,,19.31232877,2006,0.4,0,0,0,0,0,0,1,0,1,0,0,0,0,0,0,0
258,Noa Lang,nl NED,FW,PSV Eindhoven,,25.88219178,1999,18,17,13,5,8,4,6,17,35.3,11,17,1,16,3,20,6,0
259,Tobias Lauritsen,no NOR,FW,Sparta R'dam,,27.67945205,1997,27.1,11,6,3,3,5,4,13,30.8,9,17,2,15,0,11,31,0
260,James Lawrence,wls WAL,DF,Almere City,,32.70136986,1992,16.8,20,9,9,9,2,7,19,36.8,12,19,11,8,20,40,93,1
261,Richy Ledezma,us USA,DF,PSV Eindhoven,,24.66027397,2000,18.7,27,19,10,10,7,14,28,50,14,11,3,8,15,42,26,2
262,Clint Leemans,nl NED,MF,NAC Breda,,29.63561644,1995,17,29,15,11,11,7,11,23,47.8,12,12,6,6,4,33,29,0
263,Julian Lelieveld,nl NED,"DF,MF",RKC Waalwijk,,27.44383562,1997,20.9,60,42,43,12,5,36,56,64.3,20,40,18,22,21,81,104,1
264,Bryan Limbombe,be BEL,"MF,FW",Heracles Almelo,,23.97534247,2001,4.2,2,2,2,0,0,0,2,0,2,2,1,1,0,2,4,0
265,Marcus Linday,se SWE,MF,Heerenveen,,21.92328767,2003,13,32,21,16,16,0,12,25,48,13,16,1,15,12,44,16,2
266,Bryan Linssen,nl NED,FW,NEC Nijmegen,,34.57260274,1990,6.7,9,5,2,6,1,3,11,27.3,8,5,1,4,1,10,9,0
267,Evert Linthorst,nl NED,MF,Go Ahead Eag,,25.17260274,2000,25.1,20,11,9,7,4,10,21,47.6,11,34,14,20,18,38,58,3
268,Enric Llansana,nl NED,MF,Go Ahead Eag,,24.0630137,2001,28.2,106,67,54,46,6,37,72,51.4,35,46,8,38,37,143,102,1
269,Chris Lokesa,be BEL,"FW,MF",RKC Waalwijk,,20.49041096,2004,10.3,13,6,6,5,2,7,16,43.8,9,7,0,7,7,20,6,0
270,Tim van de Loo,,MF,RKC Waalwijk,,0,,17.7,42,24,20,17,5,23,36,63.9,13,20,7,13,27,69,37,1
271,Marcos López,pe PER,MF,Feyenoord,,25.45479452,1999,1,0,0,0,0,0,0,0,,0,1,0,1,0,0,5,0
272,Jordan Lotomba,ch SUI,DF,Feyenoord,,26.59726027,1998,5.4,11,10,3,6,2,3,4,75,1,5,2,3,8,19,7,1
273,Hirving Lozano,mx MEX,FW,PSV Eindhoven,,29.76438356,1995,3.2,8,7,4,3,1,4,7,57.1,3,5,0,5,1,9,1,0
274,Sayfallah Ltaief,tn TUN,FW,Twente,,25.03561644,2000,12.8,24,12,9,10,5,10,21,47.6,11,13,0,13,2,26,5,0
275,Boyd Lucassen,nl NED,"DF,FW",NAC Breda,,26.84383562,1998,13.6,42,26,18,20,4,21,32,65.6,11,21,4,17,16,58,59,0
276,Milos Lukovic,rs SRB,FW,Heerenveen,,19.46027397,2005,5.9,3,2,0,1,2,1,4,25,3,8,0,8,0,3,2,0
277,Thierry Lutonda,be BEL,DF,Zwolle,,24.52054795,2000,5.2,22,11,11,9,2,14,20,70,6,11,4,7,8,30,22,0
278,Leftheris Lyratzis,gr GRE,DF,NEC Nijmegen,,25.19726027,2000,7.4,8,5,3,5,0,6,10,60,4,3,1,2,5,13,22,0
279,Enes Mahmutovic,lu LUX,DF,NAC Breda,,27.95342466,1997,6.2,8,3,6,2,0,7,9,77.8,2,13,8,5,13,21,42,0
280,Seiya Maikuma,jp JPN,DF,AZ Alkmaar,,27.55068493,1997,20.1,71,44,33,29,9,36,52,69.2,16,30,7,23,25,96,84,1
281,Tyrell Malacia,nl NED,DF,PSV Eindhoven,,25.71506849,1999,3.8,10,3,6,3,1,6,6,100,0,3,0,3,4,14,9,0
282,Christopher Mamengi,nl NED,DF,Almere City,,24.08767123,2001,2.5,3,3,2,1,0,2,5,40,3,2,2,0,4,7,10,0
283,Sivert Mannsverk,no NOR,MF,Ajax,,22.99178082,2002,2,1,1,0,0,1,1,1,100,0,2,1,1,1,2,5,0
284,Braydon Manu,gh GHA,"FW,DF",Zwolle,,28.10410959,1997,0.7,0,0,0,0,0,0,0,,0,2,0,2,0,0,0,0
285,Elías Már Ómarsson,is ISL,FW,NAC Breda,,30.29315068,1995,24,14,10,5,7,2,5,17,29.4,12,13,3,10,5,19,19,0
286,Richonell Margaret,sr SUR,FW,RKC Waalwijk,,24.65753425,2000,25.1,46,25,18,16,12,15,26,57.7,11,13,0,13,8,54,16,0
287,Maxim Mariani,nl NED,DF,Groningen,,20.50136986,2004,0.2,0,0,0,0,0,0,0,,0,0,0,0,0,0,2,0
288,Iván Márquez,es ESP,DF,NEC Nijmegen,,30.90410959,1994,21.6,25,15,16,8,1,18,25,72,7,27,15,12,27,52,125,0
289,Bruno Martins Indi,nl NED,DF,AZ Alkmaar,,33.23561644,1992,6.1,3,2,1,2,0,1,1,100,0,1,1,0,4,7,26,1
290,Matheus,br BRA,GK,Ajax,,32.79452055,1992,9,0,0,0,0,0,0,0,,0,0,0,0,0,0,4,1
291,Jens Mathijsen,,DF,Willem II,,0,,0.9,7,4,4,3,0,3,3,100,0,3,3,0,0,7,10,0
292,Faiz Mattoir,km COM,"FW,MF",Almere City,,24.81369863,2000,3.1,5,2,4,1,0,0,3,0,3,2,1,1,2,7,3,0
293,Faissal Al Mazyani,be BEL,DF,RKC Waalwijk,,20.29315068,2005,15.2,43,28,26,12,5,27,47,57.4,20,30,15,15,35,78,61,0
294,Dylan Mbayo,be BEL,"FW,MF",Zwolle,,23.56438356,2001,20.9,28,18,10,12,6,10,25,40,15,10,0,10,8,36,16,0
295,Mexx Meerdink,nl NED,"FW,MF",AZ Alkmaar,,21.78082192,2003,7.7,9,3,1,4,4,2,7,28.6,5,7,1,6,1,10,5,0
296,Ringo Meerveld,nl NED,"MF,FW",Willem II,,24.36986301,2000,29.4,21,11,10,9,2,8,23,34.8,15,23,2,21,12,33,32,1
297,Aaron Meijers,nl NED,DF,RKC Waalwijk,,37.51780822,1987,8.2,15,8,10,4,1,10,21,47.6,11,9,4,5,10,25,24,0
298,Rick Meissen,nl NED,DF,Sparta R'dam,,23.19178082,2002,8.5,12,7,9,3,0,6,10,60,4,17,13,4,13,25,43,1
299,Rui Mendes,de GER,"MF,FW",Groningen,,25.48219178,1999,5.7,5,3,2,2,1,2,5,40,3,5,0,5,0,5,1,0
300,Julien Mesbahi,ma MAR,FW,Twente,,19.25753425,2006,0,0,0,0,0,0,0,0,,0,0,0,0,0,0,3,0
301,Ivan Mesík,sk SVK,DF,Heracles Almelo,,23.9260274,2001,29.3,25,16,15,10,0,10,19,52.6,9,52,42,10,31,56,231,0
302,Metinho,br BRA,MF,Sparta R'dam,,22.03287671,2003,4,9,7,6,2,1,5,8,62.5,3,2,1,1,4,13,14,0
303,Edouard Michut,fr FRA,"MF,FW",Fortuna Sittard,,22.16986301,2003,9.5,29,21,11,14,4,14,26,53.8,12,15,4,11,11,40,12,0
304,Sven Mijnans,nl NED,"MF,FW",AZ Alkmaar,,25.15616438,2000,22,34,16,8,20,6,18,30,60,12,37,7,30,16,50,16,0
305,Antoni Milambo,nl NED,MF,Feyenoord,,20.08767123,2005,20.1,35,23,9,21,5,14,24,58.3,10,26,4,22,9,44,15,2
306,Lorenzo Milani,it ITA,DF,Heracles Almelo,,23.95342466,2001,3.1,1,1,1,0,0,1,3,33.3,2,5,1,4,3,4,17,0
307,Mateja Milovanovic,rs SRB,DF,Heerenveen,,21.04657534,2004,0.2,0,0,0,0,0,0,0,,0,1,0,1,0,0,1,0
308,David Min,nl NED,FW,Utrecht,,25.86575342,1999,13.1,9,7,2,4,3,2,13,15.4,11,12,2,10,2,11,16,0
309,Damon Mirani,nl NED,DF,Heracles Almelo,,28.97808219,1996,30.5,41,24,29,10,2,22,41,53.7,19,47,29,18,31,72,190,1
310,Jeyland Mitchell,cr CRC,DF,Feyenoord,,20.59726027,2004,0.2,0,0,0,0,0,0,1,0,1,1,0,1,0,0,2,0
311,Shunsuke Mito,jp JPN,FW,Sparta R'dam,,22.6,2002,15.7,27,19,9,16,2,15,28,53.6,13,16,0,16,13,40,19,1
312,Josip Mitrović,hr CRO,"DF,MF",Fortuna Sittard,,24.89863014,2000,9.1,19,11,6,11,2,8,22,36.4,14,6,0,6,10,29,20,0
313,Jakub Moder,pl POL,MF,Feyenoord,,26.07671233,1999,10.3,24,15,6,11,7,11,21,52.4,10,12,4,8,10,34,24,2
314,Jorthy Mokio,be BEL,"MF,DF",Ajax,,17.17808219,2008,4.4,11,5,6,4,1,5,7,71.4,2,9,2,7,4,15,11,1
315,Lars Mol,nl NED,MF,NAC Breda,,20.63561644,2004,2.6,3,0,2,0,1,2,3,66.7,1,1,0,1,3,6,5,0
316,Jamiro Monteiro,cv CPV,MF,Zwolle,,31.44657534,1993,21.2,57,31,26,21,10,22,41,53.7,19,24,2,22,14,71,5,1
317,Alex Mortensen,se SWE,"FW,MF",Groningen,,22.8109589,2002,0.1,0,0,0,0,0,0,0,,0,0,0,0,0,0,0,0
318,David Møller Wolfe,no NOR,DF,AZ Alkmaar,,23.03287671,2002,24.8,27,23,11,12,4,13,28,46.4,15,18,5,13,24,51,51,0
319,Chris Nadje,fr FRA,MF,Feyenoord,,23.72328767,2001,2.2,4,2,0,3,1,2,2,100,0,2,0,2,0,4,0,0
320,Adamo Nagalo,bf BFA,DF,PSV Eindhoven,,22.61643836,2002,1.9,5,3,3,2,0,1,1,100,0,2,1,1,1,6,11,0
321,Adi Nalic,ba BIH,"MF,FW",Almere City,,27.42465753,1997,7.7,11,9,6,3,2,4,12,33.3,8,6,1,5,10,21,2,0
322,Younes Namli,dk DEN,"FW,MF",Zwolle,,30.8739726,1994,9.6,17,11,5,8,4,10,22,45.5,12,17,1,16,5,22,11,1
323,Mohamed Nassoh,nl NED,FW,Sparta R'dam,,22.27123288,2003,15.8,30,19,17,9,4,19,30,63.3,11,22,4,18,7,37,11,1
324,Gerrit Nauber,de GER,DF,Go Ahead Eag,,33.06027397,1992,26.7,23,14,17,6,0,8,10,80,2,44,38,6,15,38,141,0
325,Camiel Neghli,nl NED,FW,Sparta R'dam,,23.49315068,2001,15.4,18,12,6,10,2,9,28,32.1,19,19,2,17,15,33,13,0
326,Ion Nicolaescu,md MDA,FW,Heerenveen,,26.65753425,1998,13.2,6,2,2,2,2,2,4,50,2,5,1,4,0,6,7,0
327,Reuven Niemeijer,nl NED,"MF,DF",RKC Waalwijk,,30.10684932,1995,2.5,4,4,3,1,0,2,2,100,0,3,0,3,1,5,1,0
328,Bart Nieuwkoop,nl NED,"DF,MF",Feyenoord,,29.16164384,1996,5.2,14,10,6,5,3,7,9,77.8,2,9,3,6,6,20,12,1
329,Olivier de Nijs,nl NED,"MF,FW",Almere City,,20.48493151,2004,0.3,2,1,1,1,0,1,3,33.3,2,0,0,0,0,2,0,0
330,Rob Nizet,be BEL,DF,Willem II,,23.05753425,2002,7.6,15,10,10,2,3,9,13,69.2,4,2,0,2,14,29,27,0
331,Kristian Nökkvi Hlynsson,is ISL,MF,Sparta R'dam,,21.27945205,2004,10.5,11,6,4,7,0,3,13,23.1,10,8,0,8,8,19,10,0
332,Kristian Nökkvi Hlynsson,is ISL,"MF,FW",Ajax,,21.27945205,2004,2.1,4,2,1,2,1,3,5,60,2,3,0,3,1,5,1,0
333,Andries Noppert,nl NED,GK,Heerenveen,,31.07671233,1994,13,0,0,0,0,0,0,0,,0,0,0,0,0,0,7,0
334,Ché Nunnely,nl NED,"FW,MF",Heerenveen,,26.24657534,1999,2.9,10,6,5,4,1,6,11,54.5,5,3,1,2,2,12,2,0
335,Bram Nuytinck,nl NED,DF,NEC Nijmegen,,35.00273973,1990,18.8,27,12,15,10,2,15,26,57.7,11,24,15,9,16,43,119,1
336,Armando Obispo,nl NED,DF,PSV Eindhoven,,26.16712329,1999,4.3,2,1,0,1,1,2,6,33.3,4,7,5,2,6,8,24,0
337,Koki Ogawa,jp JPN,FW,NEC Nijmegen,,27.73972603,1997,17.8,8,2,4,4,0,3,10,30,7,5,0,5,2,10,12,1
338,Noah Ohio,nl NED,FW,Utrecht,,22.29863014,2003,6.9,5,1,0,3,2,3,6,50,3,4,1,3,1,6,9,0
339,Lars Olden Larsen,no NOR,"MF,FW",NEC Nijmegen,,26.63013699,1998,3,6,3,2,3,1,1,5,20,4,0,0,0,1,7,5,0
340,Fredrik Oldrup Jensen,no NOR,MF,NAC Breda,,31.96438356,1993,13,28,20,16,10,2,14,32,43.8,18,26,9,17,10,38,27,0
341,Nick Olij,nl NED,GK,Sparta R'dam,,29.75890411,1995,31,0,0,0,0,0,0,1,0,1,0,0,0,0,0,6,0
342,Lucas Oliveira Rosa,br BRA,DF,Ajax,,25.08767123,2000,2.1,7,4,4,3,0,3,5,60,2,1,0,1,3,10,7,0
343,Simon Olsson,se SWE,MF,Heerenveen,,27.63835616,1997,8.7,19,9,6,10,3,4,21,19,17,2,0,2,5,24,2,1
344,Basar Onal,tr TUR,"FW,MF",NEC Nijmegen,,20.83013699,2004,14.4,22,13,10,6,6,13,28,46.4,15,13,1,12,7,29,8,1
345,Diego van Oorschot,nl NED,"MF,FW",Heracles Almelo,,19.5890411,2005,0.3,1,1,0,1,0,0,0,,0,0,0,0,0,1,0,0
346,Thijs Oosting,nl NED,"FW,MF",Groningen,,25.00821918,2000,8.7,10,4,2,6,2,4,14,28.6,10,7,1,6,2,12,10,0
347,Fredrik Oppegard,no NOR,DF,PSV Eindhoven,,22.74246575,2002,3.1,2,1,0,1,1,1,1,100,0,1,0,1,1,3,2,0
348,Yanick van Osch,nl NED,GK,RKC Waalwijk,,28.11506849,1997,3,0,0,0,0,0,0,0,,0,0,0,0,0,0,4,0
349,Ibrahim Osman,gh GHA,"FW,MF",Feyenoord,,20.43013699,2004,8.7,10,5,6,1,3,5,11,45.5,6,3,0,3,6,16,4,0
350,Sami Ouaissa,nl NED,"MF,FW",NEC Nijmegen,,20.5890411,2004,17.5,18,7,5,9,4,8,20,40,12,11,2,9,14,32,10,0
351,Ayoub Oufkir,nl NED,"FW,DF",Sparta R'dam,,19.33150685,2006,0.5,3,3,2,1,0,1,1,100,0,1,0,1,1,4,1,0
352,Yassin Oukili,nl NED,MF,RKC Waalwijk,,24.33424658,2001,21.6,62,39,32,24,6,28,49,57.1,21,22,4,18,22,84,41,2
353,Thomas Ouwejan,nl NED,"DF,MF",NEC Nijmegen,,28.59452055,1996,17.9,45,28,26,14,5,25,41,61,16,17,6,11,23,68,48,0
354,Rome-Jayden Owusu-Oduro,nl NED,GK,AZ Alkmaar,,20.84109589,2004,25,1,0,1,0,0,1,1,100,0,0,0,0,2,3,12,1
355,Igor Paixão,br BRA,"FW,MF",Feyenoord,,24.85205479,2000,29,41,24,13,18,10,22,37,59.5,15,18,1,17,10,51,31,4
356,Troy Parrott,ie IRL,FW,AZ Alkmaar,,23.24657534,2002,24.2,19,13,6,4,9,6,17,35.3,11,12,1,11,2,21,20,1
357,Remko Pasveer,nl NED,GK,Ajax,,41.48767123,1983,21,1,1,1,0,0,1,1,100,0,0,0,0,1,2,12,4
358,Raul Paula,de GER,"FW,MF",NAC Breda,,21.2739726,2004,7.2,5,5,0,5,0,4,11,36.4,7,6,0,6,3,8,8,0
359,Marcus Pedersen,no NOR,MF,Feyenoord,,24.80273973,2000,0.1,0,0,0,0,0,0,0,,0,0,0,0,0,0,0,0
360,Marvin Peersman,be BEL,DF,Groningen,,34.23013699,1991,19,34,25,21,10,3,18,27,66.7,9,17,13,4,22,56,91,0
361,Joey Pelupessy,id IDN,"MF,DF",Groningen,,31.97260274,1993,3.3,7,6,3,4,0,1,2,50,1,5,1,4,1,8,11,0
362,Alexandre Penetra,pt POR,DF,AZ Alkmaar,,23.65205479,2001,25.8,19,13,10,9,0,12,21,57.1,9,22,15,7,32,51,134,2
363,Ricardo Pepi,us USA,FW,PSV Eindhoven,,22.31780822,2003,7.7,6,5,1,3,2,2,2,100,0,4,0,4,1,7,7,0
364,Brayann Pereira,fr FRA,DF,NEC Nijmegen,,21.95616438,2003,20.5,70,46,47,16,7,38,56,67.9,18,31,4,27,19,89,70,1
365,Lucas Pérez,es ESP,"FW,MF",PSV Eindhoven,,36.64931507,1988,0.2,1,1,0,1,0,0,0,,0,0,0,0,0,1,0,0
366,Ivan Perišić,hr CRO,FW,PSV Eindhoven,,36.25205479,1989,17.5,21,16,6,10,5,14,34,41.2,20,26,2,24,5,26,20,0
367,Kristoffer Peterson,se SWE,"FW,MF",Fortuna Sittard,,30.43287671,1994,18.3,24,16,11,8,5,12,31,38.7,19,19,2,17,7,31,26,1
368,Hristiyan Petrov,bg BUL,DF,Heerenveen,,22.8630137,2002,1.1,4,2,2,2,0,1,1,100,0,5,0,5,5,9,8,0
369,Oscar Pettersson,se SWE,"FW,MF",Go Ahead Eag,,25.25479452,2000,1.5,0,0,0,0,0,0,1,0,1,2,1,1,1,1,3,0
370,Ivo Pinto,pt POR,DF,Fortuna Sittard,,35.32328767,1990,25.5,46,32,27,17,2,21,36,58.3,15,18,6,12,20,66,86,0
371,Miodrag Pivas,rs SRB,"DF,MF",Willem II,,19.96712329,2005,0.3,0,0,0,0,0,0,0,,0,1,0,1,0,0,2,0
372,Luca Plogmann,de GER,GK,Go Ahead Eag,,25.15342466,2000,17,0,0,0,0,0,0,0,,0,0,0,0,0,0,11,3
373,Suf Podgoreanu,il ISR,"FW,MF",Heracles Almelo,,23.28767123,2002,23,33,21,17,13,3,11,27,40.7,16,18,0,18,14,47,32,0
374,Emanuel Poku,nl NED,FW,Almere City,,19.79452055,2005,1.4,0,0,0,0,0,0,2,0,2,3,0,3,0,0,1,0
375,Ernest Poku,nl NED,FW,AZ Alkmaar,,21.26575342,2004,14.3,21,11,6,11,4,11,19,57.9,8,11,2,9,2,23,11,1
376,Romano Postema,nl NED,"FW,MF",Groningen,,23.23835616,2002,12.1,6,5,2,2,2,5,13,38.5,8,5,1,4,4,10,12,0
377,Wouter Prins,nl NED,DF,Groningen,,21.24109589,2004,16.6,64,35,41,16,7,43,55,78.2,12,17,8,9,21,85,71,0
378,Dirk Proper,nl NED,MF,NEC Nijmegen,,23.19178082,2002,24,48,31,19,23,6,20,42,47.6,22,27,9,18,21,69,60,0
379,Ruben Providence,ht HAI,"FW,MF",Almere City,,23.82739726,2001,5.5,4,3,3,1,0,3,9,33.3,6,2,0,2,2,6,3,2
380,Jeffry Puriel,bq BOE,FW,Almere City,,22.46575342,2002,0.3,1,0,0,0,1,1,1,100,0,1,0,1,0,1,0,0
381,Teo Quintero,ve VEN,DF,Sparta R'dam,,26.17534247,1999,6.4,15,10,12,3,0,5,9,55.6,4,14,12,2,6,21,49,1
382,Bojan Radulovic,rs SRB,FW,Fortuna Sittard,,25.34794521,1999,3.4,3,3,0,2,1,1,2,50,1,0,0,0,0,3,2,0
383,Dimitris Rallis,nl NED,FW,Heerenveen,,20.10958904,2005,9.6,2,1,1,1,0,0,4,0,4,12,1,11,2,4,8,0
384,Diant Ramaj,de GER,GK,Ajax,,23.62465753,2001,1,0,0,0,0,0,0,0,,0,0,0,0,0,0,0,0
385,Christian Rasmussen,dk DEN,FW,Ajax,,22.29041096,2003,2.4,5,2,1,3,1,2,3,66.7,1,3,0,3,0,5,0,0
386,Khaled Razak,nl NED,FW,Willem II,,19.39178082,2005,0.1,0,0,0,0,0,0,0,,0,0,0,0,0,0,1,0
387,Givairo Read,nl NED,DF,Feyenoord,,18.92328767,2006,19,59,33,32,23,4,34,45,75.6,11,17,2,15,13,72,53,0
388,Tim Receveur,nl NED,MF,Almere City,,33.76438356,1991,1,3,2,1,1,1,1,2,50,1,1,0,1,1,4,2,0
389,Zepiqueno Redmond,nl NED,FW,Feyenoord,,18.86849315,2006,1.8,2,2,0,1,1,0,1,0,1,2,0,2,0,2,1,0
390,Youri Regeer,nl NED,MF,Ajax,,21.71232877,2003,0.3,1,1,0,1,0,0,0,,0,1,0,1,0,1,0,0
391,Youri Regeer,nl NED,MF,Twente,,21.71232877,2003,14.9,27,13,8,12,7,13,24,54.2,11,16,4,12,18,45,24,0
392,Eliano Reijnders,id IDN,DF,Zwolle,,24.53150685,2000,10.4,22,13,12,8,2,15,31,48.4,16,10,3,7,14,36,40,0
393,Boyd Reith,nl NED,DF,Sparta R'dam,,25.91506849,1999,9.7,28,21,14,10,4,15,23,65.2,8,5,0,5,10,38,31,0
394,Devyne Rensch,nl NED,DF,Ajax,,22.29315068,2003,12.4,31,21,12,10,9,19,28,67.9,9,14,6,8,16,47,15,0
395,Marco Rente,de GER,DF,Groningen,,28.1890411,1997,26,41,34,31,8,2,15,41,36.6,26,27,14,13,53,94,132,3
396,Stije Resink,nl NED,MF,Almere City,,21.9369863,2003,2.6,10,6,5,4,1,8,12,66.7,4,3,2,1,1,11,7,1
397,Stije Resink,nl NED,MF,Groningen,,21.9369863,2003,20.7,79,54,32,38,9,40,60,66.7,20,39,6,33,21,100,41,3
398,Milan Robberechts,be BEL,MF,Fortuna Sittard,,21.16986301,2004,0.1,2,1,0,0,2,0,0,,0,0,0,0,0,2,0,0
399,Thomas Robinet,fr FRA,"MF,FW",Almere City,,28.71232877,1996,27.1,28,18,7,10,11,11,23,47.8,12,22,4,18,13,41,43,0
400,Miguel Rodríguez,es ESP,"FW,MF",Utrecht,,22.01643836,2003,12.1,29,16,12,9,8,16,41,39,25,14,0,14,18,47,4,1
401,Robin Roefs,nl NED,GK,NEC Nijmegen,,22.29589041,2003,29,0,0,0,0,0,0,1,0,1,0,0,0,1,1,20,3
402,Godfried Roemeratoe,cw CUW,MF,RKC Waalwijk,,25.70958904,1999,16.3,39,16,24,12,3,17,31,54.8,14,30,13,17,16,55,34,1
403,Ole Romeny,id IDN,FW,Utrecht,,24.8739726,2000,8.1,10,4,5,4,1,6,15,40,9,2,1,1,6,16,18,0
404,Bart van Rooij,nl NED,DF,Twente,,23.94246575,2001,28.7,62,40,33,26,3,29,51,56.9,22,26,6,20,31,93,122,0
405,Bart van Rooij,nl NED,DF,NEC Nijmegen,,23.94246575,2001,2,8,6,2,6,0,6,9,66.7,3,1,0,1,2,10,11,0
406,Kaj de Rooij,nl NED,"FW,MF",Zwolle,,24.44109589,2000,3.2,4,2,1,3,0,2,4,50,2,3,0,3,2,6,4,0
407,Ruben Roosken,nl NED,DF,Heracles Almelo,,25.17534247,2000,13.6,36,20,22,9,5,16,27,59.3,11,15,2,13,16,52,42,0
408,Loreintz Rosier,fr FRA,"MF,DF",Fortuna Sittard,,26.72328767,1998,21.9,39,25,22,15,2,20,38,52.6,18,35,13,22,39,78,95,1
409,Daan Rots,nl NED,FW,Twente,,23.77808219,2001,22.4,49,31,17,15,17,26,66,39.4,40,25,2,23,7,56,25,1
410,Mats Rots,nl NED,DF,Heracles Almelo,,19.15068493,2006,11.6,22,15,11,6,5,14,27,51.9,13,16,7,9,11,33,35,0
411,Manu Royo,es ESP,DF,NAC Breda,,31.18082192,1994,1.2,0,0,0,0,0,0,1,0,1,0,0,0,2,2,9,0
412,Daniele Rugani,it ITA,DF,Ajax,,30.76712329,1994,7.2,7,1,3,4,0,3,4,75,1,6,3,3,12,19,50,1
413,Pim Saathof,nl NED,DF,Go Ahead Eag,,21.35068493,2003,0.9,2,0,2,0,0,0,1,0,1,1,1,0,0,2,4,1
414,Michal Sadílek,cz CZE,"MF,DF",Twente,,25.92876712,1999,15.1,42,25,13,24,5,25,44,56.8,19,24,9,15,17,59,36,0
415,Ibrahim Sadiq,gh GHA,FW,AZ Alkmaar,,24.99452055,2000,10.2,15,9,7,6,2,9,21,42.9,12,13,2,11,6,21,9,0
416,Danilo Al Saed,iq IRQ,"MF,FW",Heerenveen,,26.19178082,1999,2.2,8,4,6,2,0,3,7,42.9,4,2,0,2,0,8,1,0
417,Ismael Saibari,ma MAR,MF,PSV Eindhoven,,24.26575342,2001,17.7,38,18,13,17,8,18,31,58.1,13,18,3,15,10,48,15,1
418,Anass Salah-Eddine,nl NED,DF,Twente,,23.29315068,2002,14.2,33,19,22,8,3,14,23,60.9,9,10,2,8,16,49,26,1
419,Giandro Sambo,cw CUW,"FW,DF",Heracles Almelo,,18.68493151,2006,0.2,2,2,1,0,1,0,0,,0,0,0,0,0,2,1,0
420,Philippe Sandler,nl NED,DF,NEC Nijmegen,,28.23013699,1997,12.7,16,10,9,7,0,8,15,53.3,7,16,7,9,20,36,48,0
421,Cisse Sandra,be BEL,"FW,MF",Willem II,,21.38356164,2003,20.8,9,3,3,3,3,4,18,22.2,14,14,5,9,14,23,14,0
422,Kodai Sano,jp JPN,"MF,FW",NEC Nijmegen,,21.60821918,2003,18.9,29,16,12,13,4,19,41,46.3,22,24,3,21,22,51,28,2
423,Leo Sauer,sk SVK,"MF,FW",NAC Breda,,19.38356164,2005,25.4,39,21,16,16,7,20,32,62.5,12,24,1,23,3,42,22,1
424,Jasper Schendelaar,nl NED,GK,Zwolle,,24.67123288,2000,27,0,0,0,0,0,0,2,0,2,0,0,0,0,0,13,5
425,Tristan Schenkhuizen,nl NED,"MF,FW",Fortuna Sittard,,20.81369863,2004,0.1,0,0,0,0,0,0,0,,0,0,0,0,0,0,0,0
426,Sem Scheperman,nl NED,MF,Heracles Almelo,,22.8630137,2002,17.2,74,40,31,35,8,38,65,58.5,27,33,8,25,28,102,58,1
427,Lasse Schöne,dk DEN,MF,NEC Nijmegen,,38.93972603,1986,3.1,4,1,2,1,1,2,8,25,6,5,3,2,6,10,6,0
428,Erik Schouten,nl NED,DF,Willem II,,33.71780822,1991,14.6,21,15,15,5,1,13,18,72.2,5,21,17,4,12,33,103,0
429,Jerdy Schouten,nl NED,MF,PSV Eindhoven,,28.30958904,1997,14.4,15,7,6,6,3,6,13,46.2,7,10,3,7,9,24,13,1
430,Lewis Schouten,nl NED,MF,AZ Alkmaar,,21.24657534,2004,0,0,0,0,0,0,0,0,,0,0,0,0,0,0,0,0
431,Jorg Schreuders,nl NED,"MF,FW",Groningen,,20.65205479,2004,18.7,29,20,7,18,4,9,23,39.1,14,20,0,20,9,38,10,1
432,Ilias Sebaoui,be BEL,"FW,MF",Heerenveen,,23.58356164,2001,20.8,19,12,10,8,1,8,39,20.5,31,17,1,16,14,33,29,0
433,Mats Seuntjens,nl NED,"FW,MF",Groningen,,33.04931507,1992,7.3,12,10,5,5,2,8,11,72.7,3,2,0,2,1,13,3,0
434,Kento Shiogai,jp JPN,FW,NEC Nijmegen,,20.10958904,2005,5.5,10,8,5,5,0,6,11,54.5,5,5,1,4,1,11,8,1
435,Kaj Sierhuis,nl NED,FW,Fortuna Sittard,,27.02191781,1998,4.4,1,1,0,0,1,0,3,0,3,3,1,2,1,2,3,0
436,Oskar Siira Sivertsen,no NOR,FW,Go Ahead Eag,,21.21643836,2004,0.6,2,1,1,0,1,1,3,33.3,2,0,0,0,2,4,3,0
437,Daley Sinkgraven,nl NED,"MF,FW",Fortuna Sittard,,29.83561644,1995,0.9,5,2,2,1,2,2,2,100,0,2,1,1,1,6,6,0
438,Aymen Sliti,nl NED,"FW,MF",Feyenoord,,19.11506849,2006,0.5,0,0,0,0,0,0,1,0,1,0,0,0,1,1,0,0
439,Gijs Smal,nl NED,"DF,MF",Feyenoord,,27.67671233,1997,13,13,6,8,3,2,7,13,53.8,6,13,3,10,6,19,24,0
440,Levi Smans,nl NED,"MF,FW",Heerenveen,,21.11232877,2004,22.5,21,14,8,5,8,11,26,42.3,15,21,4,17,10,31,12,1
441,Kees Smit,nl NED,"MF,FW",AZ Alkmaar,,19.28767123,2006,8.8,19,12,8,7,4,8,20,40,12,11,2,9,4,23,17,0
442,Milan Smit,nl NED,"FW,MF",Go Ahead Eag,,22.22191781,2003,8.5,5,4,2,2,1,4,5,80,1,9,2,7,2,7,10,0
443,Kamal Sowah,gh GHA,"MF,FW",NAC Breda,,25.31780822,2000,6.8,14,10,4,5,5,4,10,40,6,4,0,4,2,16,6,0
444,Mark Spenkelink,nl NED,GK,RKC Waalwijk,,28.26849315,1997,1,0,0,0,0,0,0,0,,0,0,0,0,0,0,0,0
445,Tommy St. Jago,nl NED,DF,Willem II,,25.33424658,2000,30,75,47,54,17,4,43,65,66.2,22,53,30,23,30,105,141,1
446,Finn Stam,nl NED,DF,Groningen,,22.06027397,2003,9,19,11,12,5,2,12,16,75,4,15,10,5,11,30,63,2
447,Casper Staring,nl NED,MF,NAC Breda,,24.25479452,2001,6,17,8,11,6,0,7,16,43.8,9,10,2,8,9,26,14,0
448,Sem Steijn,nl NED,MF,Twente,,23.4630137,2001,27.7,11,7,0,11,0,4,21,19,17,15,3,12,9,20,22,0
449,Calvin Stengs,nl NED,"MF,FW",Feyenoord,,26.37808219,1998,5.9,6,2,3,2,1,4,6,66.7,2,2,0,2,1,7,1,0
450,Sean Steur,nl NED,MF,Ajax,,17.31232877,2008,0.1,0,0,0,0,0,0,0,,0,0,0,0,0,0,2,0
451,Finn Stokkers,nl NED,FW,Go Ahead Eag,,29.04657534,1996,3.9,2,1,0,2,0,0,3,0,3,2,0,2,2,4,2,0
452,Mathis Suray,be BEL,"FW,MF",Go Ahead Eag,,23.77534247,2001,13.2,30,16,14,10,6,13,31,41.9,18,19,2,17,3,33,21,0
453,Josip Šutalo,hr CRO,DF,Ajax,,25.18082192,2000,24.7,28,15,20,8,0,14,23,60.9,9,29,16,13,59,87,124,4
454,Youssuf Sylla,be BEL,"FW,MF",Willem II,,22.37534247,2002,1.8,0,0,0,0,0,0,0,,0,2,1,1,0,0,7,0
455,Anas Tahiri,be BEL,MF,Almere City,,29.97260274,1995,17.2,25,12,11,12,2,13,20,65,7,11,4,7,6,31,28,0
456,Benjamin Tahirovic,ba BIH,MF,Ajax,,22.17260274,2003,0.8,0,0,0,0,0,0,1,0,1,0,0,0,0,0,0,0
457,Juho Talvitie,fi FIN,"FW,MF",Heracles Almelo,,20.1260274,2005,14.4,13,8,7,6,0,5,23,21.7,18,24,5,19,11,24,12,0
458,Oussama Targhalline,ma MAR,MF,Feyenoord,,22.95890411,2002,2,9,6,2,5,2,5,6,83.3,1,1,0,1,1,10,4,0
459,Kenneth Taylor,nl NED,"MF,FW",Ajax,,22.96986301,2002,24.4,33,18,13,17,3,12,30,40,18,22,4,18,17,50,26,1
460,Søren Tengstedt,dk DEN,"MF,FW",Go Ahead Eag,,24.84657534,2000,4.7,8,6,4,2,2,4,7,57.1,3,2,0,2,0,8,4,0
461,Jordan Teze,nl NED,DF,PSV Eindhoven,,25.59452055,1999,0.4,2,2,2,0,0,1,1,100,0,0,0,0,1,3,1,0
462,Ryan Thomas,nz NZL,MF,Zwolle,,30.37260274,1994,8,22,17,12,8,2,13,25,52,12,12,3,9,21,43,27,2
463,Guus Til,nl NED,MF,PSV Eindhoven,,27.36712329,1997,21.2,23,13,6,12,5,10,24,41.7,14,21,4,17,6,29,10,0
464,Malik Tillman,us USA,"MF,FW",PSV Eindhoven,,22.9369863,2002,18.3,52,35,17,25,10,23,31,74.2,8,33,5,28,26,78,17,1
465,Quinten Timber,nl NED,MF,Feyenoord,,23.88219178,2001,15.5,36,24,9,21,6,11,18,61.1,7,16,0,16,10,46,10,3
466,Mickaël Tirpan,be BEL,DF,Willem II,,31.53150685,1993,21.4,50,32,30,18,2,23,44,52.3,21,24,8,16,28,78,74,1
467,Jens Toornstra,nl NED,MF,Utrecht,,36.08493151,1989,14.3,24,12,6,14,4,13,27,48.1,14,17,1,16,12,36,19,0
468,Bertrand Traoré,bf BFA,FW,Ajax,,29.66027397,1995,17.6,16,10,5,5,6,8,15,53.3,7,12,0,12,8,24,17,1
469,Gernot Trauner,at AUT,DF,Feyenoord,,33.11232877,1992,12.7,15,8,7,8,0,7,11,63.6,4,17,14,3,30,45,62,2
470,Jacob Trenskow,dk DEN,"FW,MF",Heerenveen,,24.43835616,2000,16.6,24,14,6,9,9,13,36,36.1,23,19,0,19,14,38,17,0
471,Luka Tunjić,de GER,"FW,MF",Fortuna Sittard,,19.45753425,2005,3.3,3,1,1,1,1,2,8,25,6,4,1,3,3,6,4,0
472,Fofin Turay,nl NED,MF,Groningen,,20.90958904,2004,0,0,0,0,0,0,0,0,,0,0,0,0,0,0,0,0
473,Calvin Twigt,nl NED,MF,Go Ahead Eag,,22.26027397,2003,5,7,5,3,2,2,5,6,83.3,1,3,2,1,3,10,15,0
474,Przemysław Tytoń,pl POL,GK,Twente,,38.33150685,1987,2,0,0,0,0,0,0,0,,0,0,0,0,0,0,2,0
475,Ayase Ueda,jp JPN,FW,Feyenoord,,26.64931507,1998,10.6,4,3,0,4,0,0,3,0,3,1,1,0,1,5,7,1
476,Lars Unnerstall,de GER,GK,Twente,,34.79178082,1990,29,0,0,0,0,0,0,0,,0,0,0,0,0,0,18,6
477,Naci Ünüvar,nl NED,FW,Twente,,21.89315068,2003,4.3,9,5,6,1,2,3,6,50,3,10,0,10,1,10,3,0
478,Kyan Vaesen,be BEL,FW,Willem II,,24.06027397,2001,18.4,12,6,4,4,4,3,18,16.7,15,21,4,17,7,19,17,0
479,Etienne Vaessen,sr SUR,GK,Groningen,,29.77534247,1995,30,4,2,4,0,0,4,5,80,1,0,0,0,0,4,12,4
480,Luciano Valente,it ITA,"MF,FW",Groningen,,21.58356164,2003,27,18,12,4,9,5,8,20,40,12,28,3,25,8,26,16,0
481,Cherrion Valerius,cw CUW,DF,NAC Breda,,19.61643836,2005,10.4,32,28,15,12,5,15,23,65.2,8,18,3,15,17,49,26,0
482,Dave Van Den Berg,nl NED,MF,Zwolle,,25.24657534,2000,22.7,33,24,16,8,9,13,33,39.4,20,27,6,21,19,52,48,1
483,Jan Van den Bergh,be BEL,DF,NAC Breda,,30.5890411,1994,29,60,37,33,23,4,30,57,52.6,27,46,34,12,28,88,188,3
484,Dario Van den Buijs,be BEL,DF,RKC Waalwijk,,29.64383562,1995,12.3,24,14,14,10,0,6,14,42.9,8,16,7,9,19,43,75,0
485,Alec Van Hoorenbeeck,be BEL,DF,Twente,,26.34520548,1998,9.9,16,14,9,7,0,10,11,90.9,1,10,8,2,12,28,66,0
486,Syb Van Ottele,nl NED,"DF,MF",Fortuna Sittard,,23.25205479,2002,17.8,42,29,30,12,0,27,48,56.3,21,21,7,14,27,69,95,0
487,Joey Veerman,nl NED,MF,PSV Eindhoven,,26.45753425,1998,17.6,29,18,9,12,8,16,40,40,24,20,6,14,7,36,33,0
488,Odysseus Velanas,nl NED,"FW,MF",Zwolle,,26.91506849,1998,12.2,17,10,7,7,3,11,22,50,11,14,1,13,10,27,20,0
489,Apostolos Vellios,gr GRE,FW,Zwolle,,33.32054795,1992,0.1,0,0,0,0,0,0,0,,0,0,0,0,0,0,0,0
490,Dylan Vente,nl NED,FW,Zwolle,,25.9890411,1999,28,17,9,2,10,5,5,12,41.7,7,14,4,10,5,22,40,0
491,Calvin Verdonk,id IDN,DF,NEC Nijmegen,,28.02465753,1997,28.7,86,54,55,24,7,47,62,75.8,15,40,8,32,38,124,121,0
492,Valentino Vermeulen,nl NED,DF,Willem II,,23.79178082,2001,0.3,1,1,1,0,0,0,0,,0,1,1,0,1,2,4,0
493,Arno Verschueren,be BEL,MF,Sparta R'dam,,28.0739726,1997,18.4,36,18,9,18,9,15,28,53.6,13,21,1,20,14,50,30,0
494,Arno Verschueren,be BEL,"MF,FW",Twente,,28.0739726,1997,3.4,6,4,4,2,0,3,10,30,7,7,0,7,4,10,11,0
495,Dion Versluis,nl NED,FW,NAC Breda,,22.2109589,2003,0.2,0,0,0,0,0,0,0,,0,0,0,0,0,0,0,0
496,Niklas Vesterlund,dk DEN,DF,Utrecht,,25.91232877,1999,4.8,8,4,4,4,0,4,7,57.1,3,5,3,2,3,11,24,0
497,Nick Viergever,nl NED,DF,Utrecht,,35.75342466,1989,29.9,50,30,30,17,3,21,31,67.7,10,37,27,10,27,77,147,2
498,Ricardo Visus,es ESP,DF,Almere City,,24.03013699,2001,19.8,23,18,19,4,0,15,26,57.7,11,26,16,10,44,67,118,1
499,Michel Vlap,nl NED,"MF,FW",Twente,,27.92328767,1997,24.8,42,29,13,26,3,15,33,45.5,18,43,9,34,29,71,31,2
500,Patrick Vroegh,nl NED,"DF,MF",RKC Waalwijk,,25.43013699,1999,0.4,4,3,1,2,1,0,0,,0,0,0,0,1,5,2,0
501,Wout Weghorst,nl NED,FW,Ajax,,32.74246575,1992,10.3,2,2,0,2,0,0,2,0,2,5,1,4,1,3,15,0
502,Daouda Weidmann,ci CIV,MF,RKC Waalwijk,,22.00273973,2003,8.8,11,7,6,4,1,1,7,14.3,6,14,2,12,11,22,6,0
503,Robbin Weijenberg,nl NED,"MF,FW",Go Ahead Eag,,20.48767123,2004,2,14,6,6,6,2,10,17,58.8,7,0,0,0,4,18,9,0
504,Timon Wellenreuther,de GER,GK,Feyenoord,,29.41917808,1995,27,0,0,0,0,0,0,2,0,2,1,0,1,0,0,22,3
505,Jannes Wieckhoff,de GER,DF,Heracles Almelo,,24.75616438,2000,13.6,39,25,27,9,3,22,45,48.9,23,22,8,14,12,51,47,0
506,Owen Wijndal,nl NED,DF,Ajax,,25.43287671,1999,2.9,6,4,1,3,2,3,6,50,3,5,0,5,0,6,6,0
507,Jordy de Wijs,nl NED,DF,Heerenveen,,30.32054795,1995,0.8,0,0,0,0,0,0,1,0,1,0,0,0,2,2,14,0
508,Mees de Wit,nl NED,"DF,FW",AZ Alkmaar,,27.04931507,1998,5.2,12,7,5,6,1,8,12,66.7,4,5,0,5,5,17,12,0
509,Ricky van Wolfswinkel,nl NED,FW,Twente,,36.26849315,1989,15.1,25,19,9,13,3,10,24,41.7,14,24,6,18,6,31,32,0
510,Luuk Wouters,nl NED,DF,RKC Waalwijk,,25.90684932,1999,9,27,19,16,10,1,17,23,73.9,6,16,4,12,11,38,49,1
511,Redouan El Yaakoubi,nl NED,DF,RKC Waalwijk,,29.2739726,1996,4.5,5,2,2,2,1,2,4,50,2,6,3,3,7,12,28,0
512,Marvin Young,nl NED,DF,Sparta R'dam,,19.5890411,2005,21.1,62,36,34,28,0,32,42,76.2,10,36,17,19,29,91,138,1
513,Vasilios Zagaritis,gr GRE,DF,Almere City,,24.00273973,2001,30.9,43,25,28,12,3,29,49,59.2,20,31,5,26,45,88,105,1
514,Jan Žambůrek,cz CZE,MF,Heracles Almelo,,24.22191781,2001,9.5,25,12,13,10,2,8,15,53.3,7,13,1,12,11,36,25,0
515,Oskar Zawada,pl POL,FW,RKC Waalwijk,,29.25479452,1996,20.7,14,8,2,10,2,4,8,50,4,10,2,8,1,15,33,1
516,Gjivai Zechiël,nl NED,MF,Sparta R'dam,,20.9260274,2004,8.5,19,8,8,9,2,6,8,75,2,9,3,6,11,30,29,1
517,Gjivai Zechiël,nl NED,MF,Feyenoord,,20.9260274,2004,2.9,6,4,1,3,2,3,6,50,3,1,0,1,5,11,3,0
518,Lequincio Zeefuik,nl NED,"FW,DF",AZ Alkmaar,,20.43835616,2004,0.4,1,1,0,1,0,1,1,100,0,0,0,0,0,1,0,0
519,Ramiz Zerrouki,dz ALG,MF,Feyenoord,,26.94246575,1998,12,25,15,7,15,3,10,22,45.5,12,13,1,12,17,42,14,1
520,Jeroen Zoet,nl NED,GK,AZ Alkmaar,,34.3260274,1991,6,1,1,1,0,0,1,1,100,0,0,0,0,1,2,3,0
521,Rúnar Þór Sigurgeirsson,is ISL,"DF,FW",Willem II,,25.35068493,1999,21.4,54,28,35,15,4,27,53,50.9,26,37,8,29,20,74,87,0
522,Nökkvi Þórisson,is ISL,"FW,MF",Sparta R'dam,,25.7260274,1999,1.4,1,0,0,0,1,0,2,0,2,0,0,0,1,2,4,0
523,Shiloh ’t Zand,nl NED,"FW,MF",Heracles Almelo,,21.97534247,2003,11.2,20,15,8,10,2,5,9,55.6,4,7,0,7,5,25,5,0
524,Shiloh ’t Zand,nl NED,MF,Feyenoord,,21.97534247,2003,0.5,0,0,0,0,0,0,0,,0,0,0,0,0,0,1,0
1,Lucas Abascia,ar ARG,DF,Cen. Córdoba–SdE,,29.4,1995,5.8,13,10,9,3,1,9,12,75,3,10,5,5,22,35,49,1
2,Luciano Abecasis,ar ARG,DF,Ind. Rivadavia,,34.91780822,1990,1,2,2,1,0,1,1,1,100,0,4,0,4,0,2,4,1
3,Ramón Ábila,ar ARG,FW,Huracán,,35.55616438,1989,1.7,0,0,0,0,0,0,2,0,2,0,0,0,0,0,0,0
4,Ignacio Abraham,sy SYR,DF,Banfield,,27.30958904,1998,4.1,8,6,7,0,1,5,8,62.5,3,3,0,3,2,10,20,0
5,Gonzalo Abrego,ar ARG,MF,Godoy Cruz,,25.32328767,2000,9.3,22,14,5,16,1,11,24,45.8,13,14,6,8,4,26,18,0
6,Jonás Acevedo,ar ARG,"MF,FW",Instituto,,28.24109589,1997,7.1,13,10,5,7,1,4,7,57.1,3,6,0,6,2,15,4,0
7,Juan Achetoni,ar ARG,FW,Aldosivi,,20.15068493,2005,0,1,0,0,1,0,1,2,50,1,0,0,0,0,1,1,0
8,Guillermo Acosta,ar ARG,MF,Atlé Tucumán,,36.50958904,1988,9.9,22,16,7,14,1,9,14,64.3,5,6,4,2,17,39,19,0
9,Lautaro Acosta,ar ARG,FW,Lanús,,37.14246575,1988,0.2,0,0,0,0,0,0,0,,0,1,0,1,0,0,0,0
10,Lucas Acosta,ar ARG,"FW,DF",San Martín de San Juan,,19.96164384,2005,0.1,0,0,0,0,0,0,0,,0,0,0,0,0,0,0,0
11,Lucas Acosta,ar ARG,GK,Sarmiento,,30.14794521,1995,16,2,1,2,0,0,2,2,100,0,0,0,0,0,2,5,0
12,Marcos Acuña,ar ARG,DF,River Plate,,33.51780822,1991,11.2,17,13,8,5,4,6,15,40,9,6,1,5,14,31,18,0
13,Valentino Acuña,ar ARG,"FW,DF",Newell's OB,,19.26849315,2006,1.1,2,1,0,1,1,1,2,50,1,3,0,3,1,3,2,0
14,Tomás Adoryán,ar ARG,MF,Banfield,,23.61643836,2001,5.3,14,8,4,8,2,9,14,64.3,5,11,1,10,2,16,7,0
15,Luis Advíncula,pe PER,DF,Boca Juniors,,35.17534247,1990,8.3,16,12,12,3,1,12,16,75,4,8,3,5,5,21,19,0
16,Alan Aguerre,ar ARG,GK,Cen. Córdoba–SdE,,34.69863014,1990,14,1,0,1,0,0,1,1,100,0,0,0,0,0,1,7,0
17,Emanuel Aguilera,ar ARG,DF,Defensa y Just,,35.89863014,1989,11.1,4,2,2,2,0,2,9,22.2,7,3,2,1,7,11,66,0
18,Brian Aguirre,ar ARG,FW,Boca Juniors,,21.9260274,2003,1.3,0,0,0,0,0,0,1,0,1,2,0,2,0,0,1,0
19,Manuel Agustín Duarte,ar ARG,"MF,FW",Barracas Central,,23.69863014,2001,4.3,4,3,1,2,1,1,8,12.5,7,3,0,3,3,7,4,0
20,Gabriel Alanís,ar ARG,FW,Huracán,,31.1369863,1994,10.3,12,9,5,5,2,3,12,25,9,7,2,5,6,18,14,0
21,Agustín Alaniz,uy URU,"FW,MF",Banfield,,22.96986301,2002,11.1,16,11,3,9,4,3,15,20,12,14,0,14,6,22,5,0
22,Fernando Alarcón,ar ARG,DF,Instituto,,30.88493151,1994,16,13,10,10,3,0,9,14,64.3,5,15,9,6,25,38,107,1
23,William Alarcón,cl CHI,MF,Boca Juniors,,24.45479452,2000,4.9,7,6,4,3,0,4,4,100,0,7,2,5,3,10,6,0
24,Lucas Alario,ar ARG,FW,Estudiantes–LP,,32.57260274,1992,6.7,6,5,2,3,1,1,4,25,3,4,2,2,2,8,7,0
25,Franco Alfonso,ar ARG,"FW,MF",Cen. Córdoba–SdE,,23.00273973,2002,2.2,5,4,1,1,3,3,7,42.9,4,4,1,3,1,6,1,0
26,Rodrigo Aliendro,ar ARG,MF,River Plate,,34.21369863,1991,5.4,17,12,1,14,2,10,22,45.5,12,11,2,9,3,20,11,1
27,Agustín Almendra,ar ARG,MF,Racing Club,,25.22739726,2000,9.2,12,9,5,6,1,5,12,41.7,7,12,4,8,13,25,10,0
28,Antony Alonso,ar ARG,"MF,FW",Deportivo Riestra,,26.98356164,1998,6.3,10,4,4,5,1,5,21,23.8,16,6,3,3,2,12,5,0
29,Facundo Altamira,,"FW,MF",Godoy Cruz,,0,,5.8,7,6,2,4,1,3,4,75,1,2,0,2,2,9,7,0
30,Pablo Altamirano,ar ARG,MF,Newell's OB,,20.26027397,2005,0.2,0,0,0,0,0,0,0,,0,0,0,0,0,0,0,0
31,Francisco Álvarez,ar ARG,DF,Arg Juniors,,25.18630137,2000,15.9,15,11,11,3,1,12,17,70.6,5,18,9,9,30,45,70,3
32,Franco Amarfil,ar ARG,MF,Ind. Rivadavia,,24.15068493,2001,14.5,33,19,12,19,2,14,35,40,21,27,11,16,13,46,38,0
33,Fabricio Amato,ar ARG,MF,Ind. Rivadavia,,20.91780822,2004,0.3,1,1,0,1,0,1,1,100,0,1,0,1,1,2,1,0
34,Santino Andino,ar ARG,"MF,FW",Godoy Cruz,,19.5260274,2005,7,16,10,7,5,4,2,9,22.2,7,9,0,9,4,20,3,0
35,Isaías Andrada,ar ARG,"DF,MF",Vélez Sarsfield,,22.22465753,2003,1.8,6,2,4,2,0,4,4,100,0,3,0,3,0,6,7,0
36,Juan Andrada,ar ARG,MF,Sarmiento,,30.33150685,1995,1.1,1,1,1,0,0,1,4,25,3,1,1,0,1,2,5,0
37,Álvaro Angulo,co COL,DF,Independiente,,27.92054795,1997,8.7,15,13,8,5,2,9,15,60,6,7,2,5,10,25,27,0
38,Luis Angulo,co COL,"FW,MF",Cen. Córdoba–SdE,,21.11780822,2004,11,9,8,2,6,1,6,21,28.6,15,8,0,8,3,12,1,0
39,Federico Anselmo,ar ARG,FW,San Martín de San Juan,,31.04931507,1994,8.9,6,2,0,3,3,1,2,50,1,4,2,2,0,6,11,0
40,Mateo Antoni,uy URU,MF,Arg Juniors,,22.03561644,2003,0,0,0,0,0,0,0,0,,0,0,0,0,0,0,0,0
41,Dylan Aquino,ar ARG,FW,Lanús,,19.91780822,2005,7.1,13,8,5,6,2,8,14,57.1,6,15,1,14,4,17,6,0
42,Ignacio Arce,ar ARG,GK,Deportivo Riestra,,33.0739726,1992,16,1,1,1,0,0,0,1,0,1,0,0,0,0,1,11,1
43,Lucas Arce,ar ARG,DF,Godoy Cruz,,27.72328767,1997,9.7,27,12,18,7,2,15,33,45.5,18,13,1,12,8,35,28,0
44,Joaquín Ardaiz,uy URU,FW,Arg Juniors,,26.31232877,1999,0.1,1,0,0,0,1,1,1,100,0,0,0,0,0,1,0,0
45,Facundo Ardiles,ar ARG,DF,Godoy Cruz,,26.61643836,1998,0.5,3,1,2,1,0,2,3,66.7,1,0,0,0,0,3,1,0
46,Gabriel Arias,cl CHI,GK,Racing Club,,37.64109589,1987,11.3,0,0,0,0,0,0,0,,0,0,0,0,0,0,5,0
47,Ramón Arias,uy URU,DF,Tigre,,32.77260274,1992,2.3,1,1,1,0,0,1,2,50,1,4,2,2,5,6,11,0
48,Franco Armani,ar ARG,GK,River Plate,,38.55068493,1986,16,0,0,0,0,0,0,0,,0,0,0,0,0,0,11,2
49,Blas Armoa,py PAR,FW,Tigre,,25.24931507,2000,3.1,0,0,0,0,0,0,0,,0,1,0,1,0,0,1,0
50,Marcos Arturia,ar ARG,FW,Banfield,,27.23561644,1998,5.2,9,4,0,4,5,3,7,42.9,4,2,0,2,1,10,1,0
51,Santiago Arzamendia,py PAR,DF,Estudiantes–LP,,27,1998,9.8,28,17,19,9,0,15,25,60,10,11,4,7,14,42,37,0
52,Santiago Ascacíbar,ar ARG,MF,Estudiantes–LP,,28.1890411,1997,13,35,25,13,18,4,16,34,47.1,18,7,0,7,9,44,25,0
53,Jorge de Asís,ar ARG,MF,Gimnasia–LP,,19.2630137,2006,0,0,0,0,0,0,0,0,,0,0,0,0,0,0,0,0
54,Agustín Auzmendi,ar ARG,FW,Godoy Cruz,,28.25479452,1997,2.9,2,2,0,2,0,0,3,0,3,2,1,1,0,2,3,0
55,Carlos Auzqui,ar ARG,MF,Atlé Tucumán,,34.1369863,1991,6,18,14,8,8,2,9,18,50,9,10,1,9,8,26,7,0
56,Gabriel Ávalos,py PAR,FW,Independiente,,34.56164384,1990,10.5,9,5,0,5,4,2,4,50,2,7,1,6,0,9,9,0
57,Elías Báez,ar ARG,DF,San Lorenzo,,20.54520548,2004,15.2,38,26,17,15,6,16,33,48.5,17,21,4,17,18,56,69,0
58,Claudio Baeza,cl CHI,MF,Vélez Sarsfield,,31.36438356,1993,3.5,17,11,7,10,0,10,18,55.6,8,1,0,1,5,22,14,0
59,Mateo Bajamich,ar ARG,"FW,MF",Atlé Tucumán,,25.75342466,1999,7.8,6,4,5,0,1,5,9,55.6,4,5,0,5,0,6,8,0
60,Kevin Balanta,co COL,DF,Defensa y Just,,28.01917808,1997,4.7,4,2,3,1,0,3,4,75,1,5,3,2,7,11,45,0
61,Adrián Balboa,uy URU,FW,Racing Club,,31.29041096,1994,6.2,11,8,1,3,7,2,5,40,3,3,1,2,1,12,6,0
62,Franco Baldassarra,ar ARG,MF,Platense,,26.59726027,1998,1.7,6,4,1,4,1,4,4,100,0,3,0,3,1,7,7,0
63,Éver Banega,ar ARG,MF,Newell's OB,,36.84931507,1988,13.8,21,12,10,6,5,10,25,40,15,6,2,4,7,28,6,0
64,Nahuel Banegas,ar ARG,DF,Tigre,,28.57808219,1996,13.4,33,24,22,8,3,20,28,71.4,8,21,4,17,15,48,45,0
65,Juan Barbieri,ar ARG,FW,Ind. Rivadavia,,28.63013699,1996,4.9,8,6,0,6,2,2,7,28.6,5,2,1,1,0,8,4,0
66,David Barbona,ar ARG,"MF,FW",Defensa y Just,,30.19726027,1995,2.6,1,1,0,1,0,0,1,0,1,2,0,2,0,1,1,0
67,Juan Barinaga,ar ARG,DF,Boca Juniors,,24.56712329,2000,2.3,6,4,4,1,1,4,4,100,0,5,1,4,3,9,10,0
68,Williams Barlasina,ar ARG,GK,Aldosivi,,26.84931507,1998,4,0,0,0,0,0,0,0,,0,0,0,0,0,0,1,0
69,Daniel Barrea,ar ARG,"FW,MF",Godoy Cruz,,23.78630137,2001,5,8,4,1,5,2,3,5,60,2,2,0,2,3,11,3,0
70,Diego Barrera,ar ARG,"MF,FW",Cen. Córdoba–SdE,,20.86849315,2004,3.8,6,4,1,2,3,5,8,62.5,3,2,1,1,4,10,2,0
71,Alan Barrionuevo,ar ARG,DF,Tigre,,28.3369863,1997,1.1,0,0,0,0,0,0,1,0,1,1,0,1,2,2,5,0
72,Martín Barrios,uy URU,MF,Racing Club,,26.27671233,1999,4.9,12,7,3,8,1,5,9,55.6,4,2,2,0,10,22,3,0
73,Nahuel Barrios,ar ARG,"MF,FW",Barracas Central,,26.99452055,1998,7.4,7,4,3,1,3,3,8,37.5,5,3,0,3,5,12,2,0
74,Rafael Barrios,ar ARG,DF,Barracas Central,,31.95068493,1993,4,4,2,3,1,0,2,8,25,6,3,2,1,3,7,18,0
75,Bautista Barros Schelotto,ar ARG,DF,Platense,,25.30684932,2000,4.5,9,8,4,5,0,8,17,47.1,9,6,2,4,6,15,14,0
76,Damián Batallini,ar ARG,"MF,FW",Instituto,,28.8630137,1996,8,22,18,7,12,3,10,17,58.8,7,15,1,14,4,26,2,0
77,Rodrigo Battaglia,ar ARG,"DF,MF",Boca Juniors,,33.81369863,1991,10.1,14,8,9,4,1,8,13,61.5,5,10,5,5,6,20,72,0
78,Juan Bautista Cejas,ar ARG,"FW,MF",Godoy Cruz,,27.16438356,1998,0.8,3,2,3,0,0,2,3,66.7,1,1,0,1,0,3,1,0
79,Jonathan Bay,ar ARG,DF,Platense,,32.25479452,1993,5.3,11,7,6,3,2,5,12,41.7,7,5,1,4,5,16,31,0
80,Tomás Belmonte,ar ARG,MF,Boca Juniors,,26.93972603,1998,9.5,40,29,20,14,6,17,29,58.6,12,12,3,9,11,51,21,1
81,Gastón Benavídez,ar ARG,DF,Talleres,,29.53150685,1995,9.8,19,11,2,15,2,10,15,66.7,5,12,2,10,6,25,28,1
82,Gastón Benedetti,ar ARG,DF,Estudiantes–LP,,24.10136986,2001,6,13,10,9,3,1,8,9,88.9,1,5,1,4,1,14,13,0
83,Nicolás Benegas,ar ARG,FW,Deportivo Riestra,,29.17808219,1996,10.1,10,5,1,7,2,4,9,44.4,5,13,6,7,1,11,13,0
84,Rubén Bentancourt,uy URU,FW,Arg Juniors,,32.17534247,1993,1.1,3,2,0,3,0,1,1,100,0,3,0,3,1,4,0,0
85,Lucas Besozzi,ar ARG,FW,Tigre,,22.28219178,2003,0.5,0,0,0,0,0,0,2,0,2,0,0,0,0,0,1,0
86,Juan Bisanz,ar ARG,"FW,MF",Banfield,,23.68493151,2001,5.7,9,8,3,5,1,3,7,42.9,4,3,0,3,2,11,5,0
87,Lautaro Blanco,ar ARG,DF,Boca Juniors,,26.20547945,1999,10.8,23,17,13,8,2,10,18,55.6,8,10,3,7,6,29,25,0
88,Pablo de Blasis,ar ARG,MF,Gimnasia–LP,,37.24657534,1988,7.7,24,12,10,12,2,15,30,50,15,11,2,9,13,37,23,1
89,Lucas Blondel,ch SUI,"DF,MF",Boca Juniors,,28.63835616,1996,6.1,11,6,6,5,0,8,10,80,2,5,0,5,5,16,18,0
90,Roberto Bochi,ar ARG,MF,Aldosivi,,35.38356164,1989,10.5,20,12,8,11,1,10,18,55.6,8,10,4,6,15,35,30,1
91,Luciano Boggio,it ITA,MF,Lanús,,26.15342466,1999,0.1,3,3,0,1,2,2,2,100,0,0,0,0,0,3,1,0
92,Enrique Bologna,ar ARG,GK,Defensa y Just,,43.22191781,1982,16,0,0,0,0,0,0,0,,0,1,0,1,0,0,7,1
93,Matías Borgogno,ar ARG,GK,San Martín de San Juan,,26.70410959,1998,16,1,0,1,0,0,1,1,100,0,0,0,0,1,2,5,1
94,Miguel Borja,co COL,FW,River Plate,,32.27123288,1993,10.2,7,3,0,3,4,5,5,100,0,8,1,7,1,8,13,0
95,Benjamín Bosch,ar ARG,MF,Vélez Sarsfield,,19.88767123,2005,1.2,0,0,0,0,0,0,0,,0,0,0,0,1,1,2,0
96,Sebastián Boselli,uy URU,DF,Estudiantes–LP,,21.41643836,2003,11.6,25,12,16,9,0,11,17,64.7,6,15,9,6,18,43,69,0
97,Rubén Botta,ar ARG,MF,Talleres,,35.25753425,1990,7.1,13,9,1,10,2,0,6,0,6,2,0,2,2,15,3,0
98,Tomás Bottari,ar ARG,MF,Ind. Rivadavia,,24.02465753,2001,8.3,24,16,12,11,1,10,27,37,17,16,4,12,14,38,21,0
99,Walter Bou,ar ARG,FW,Lanús,,31.69315068,1993,11.4,13,12,2,5,6,2,3,66.7,1,15,2,13,1,14,11,1
100,Agustín Bouzat,ar ARG,MF,Vélez Sarsfield,,31.10410959,1994,13.6,46,26,17,25,4,13,29,44.8,16,23,3,20,18,64,26,1
101,Mariano Bracamonte,ar ARG,DF,Deportivo Riestra,,26.03013699,1999,6.5,19,14,13,4,2,12,22,54.5,10,8,1,7,9,28,33,0
102,Malcom Braida,ar ARG,"FW,MF",San Lorenzo,,27.96712329,1997,14.8,31,16,10,10,11,11,20,55,9,22,4,18,11,42,13,0
103,Moisés Brandán,ar ARG,DF,Atlé Tucumán,,25.23561644,2000,3.4,7,6,1,5,1,4,8,50,4,7,1,6,3,10,13,1
104,Agustin Bravo,ar ARG,"DF,FW",Rosario Central,,23.98356164,2001,2.2,1,0,1,0,0,0,0,,0,2,1,1,0,1,20,3
105,Gonzalo Bravo,ar ARG,"FW,MF",Deportivo Riestra,,34.96438356,1990,1.4,2,2,0,1,1,2,4,50,2,0,0,0,2,4,2,0
106,Néstor Breitenbruch,ar ARG,DF,Aldosivi,,29.64109589,1995,14.9,28,13,21,7,0,14,19,73.7,5,29,15,14,9,37,86,0
107,Leandro Brey,ar ARG,GK,Boca Juniors,,22.61917808,2002,2,0,0,0,0,0,0,0,,0,0,0,0,0,0,0,0
108,Norberto Briasco,am ARM,"FW,MF",Gimnasia–LP,,29.17808219,1996,2.6,6,5,2,4,0,3,6,50,3,5,0,5,3,9,4,0
109,Elías Brito,ar ARG,DF,Lanús,,19.74520548,2005,0,0,0,0,0,0,0,0,,0,0,0,0,0,0,0,0
110,Miguel Brizuela,ar ARG,DF,Atlé Tucumán,,28.32876712,1997,11.9,18,9,11,7,0,9,14,64.3,5,7,4,3,14,32,66,0
111,Manuel Brondo,ar ARG,"FW,MF",Arg Juniors,,23.1890411,2002,0.7,0,0,0,0,0,0,0,,0,1,0,1,0,0,3,0
112,Jorge Broun,ar ARG,GK,Rosario Central,,38.94246575,1986,14,0,0,0,0,0,0,0,,0,0,0,0,1,1,2,0
113,Facundo Bruera,ar ARG,"FW,MF",Barracas Central,,26.61369863,1998,7.1,6,3,2,4,0,2,8,25,6,6,0,6,2,8,13,0
114,Valentín Burgoa,ar ARG,"MF,FW",Sarmiento,,25.32054795,2000,6.8,10,7,5,3,2,6,14,42.9,8,8,0,8,6,16,5,0
115,Esteban Burgos,ar ARG,DF,San Martín de San Juan,,33.31780822,1992,8.1,8,3,8,0,0,5,5,100,0,12,7,5,9,17,55,0
116,Joaquín Burgos,ar ARG,"FW,MF",Estudiantes–LP,,20.3890411,2004,5.3,9,6,5,4,0,4,7,57.1,3,10,1,9,2,11,4,0
117,Javier Burrai,ec ECU,GK,Talleres,,34.56986301,1990,1.5,0,0,0,0,0,0,0,,0,0,0,0,0,0,2,0
118,Fabricio Bustos,ar ARG,DF,River Plate,,29.01917808,1996,5.3,13,9,5,5,3,6,10,60,4,10,0,10,3,16,15,1
119,Nahuel Bustos,ar ARG,"FW,MF",Talleres,,26.83561644,1998,8.2,3,0,1,1,1,2,4,50,2,10,2,8,1,4,6,0
120,Favio Cabral,ar ARG,FW,Cen. Córdoba–SdE,,24.24383562,2001,3.8,7,3,0,4,3,3,5,60,2,3,0,3,1,8,3,0
121,Luciano Cabral,cl CHI,MF,Independiente,,30.02465753,1995,8.4,12,6,1,9,2,4,8,50,4,8,0,8,4,16,6,0
122,Rodrigo Cabral,ar ARG,"FW,MF",Huracán,,24.73972603,2000,2.5,8,7,3,5,0,4,7,57.1,3,4,0,4,4,12,3,0
123,Yonathan Cabral,ar ARG,"DF,FW",Aldosivi,,32.98630137,1992,3.4,7,7,7,0,0,5,6,83.3,1,4,3,1,1,8,21,1
124,Bruno Cabrera,ar ARG,FW,Lanús,,21.87123288,2003,2.2,1,0,0,1,0,0,2,0,2,4,0,4,1,2,0,0
125,Elías Cabrera,ar ARG,"MF,FW",Tigre,,22.1890411,2003,10.9,16,7,3,10,3,6,13,46.2,7,7,0,7,10,26,4,0
126,Lisandro Cabrera,ar ARG,"FW,MF",Atlé Tucumán,,27.33150685,1998,4.2,3,3,2,1,0,1,3,33.3,2,3,0,3,0,3,7,0
127,Juan Cáceres,py PAR,DF,Lanús,,24.9260274,2000,3,10,5,5,5,0,5,8,62.5,3,4,2,2,4,14,19,0
128,Brian Calderara,ar ARG,DF,Newell's OB,,26.59452055,1998,0.8,3,2,2,1,0,1,3,33.3,2,2,0,2,0,3,5,0
129,Facundo Cambeses,ar ARG,GK,Racing Club,,28.07123288,1997,4.7,0,0,0,0,0,0,0,,0,0,0,0,0,0,2,1
130,Juan Camilo Portilla,co COL,MF,Talleres,,26.64383562,1998,9.3,18,12,3,14,1,9,17,52.9,8,8,1,7,16,34,19,1
131,Jaminton Campaz,co COL,"FW,MF",Rosario Central,,24.94794521,2000,9.7,24,19,12,8,4,8,17,47.1,9,5,0,5,5,29,3,0
132,Jhonatan Candia,uy URU,"FW,MF",Barracas Central,,30.13972603,1995,10.5,7,4,0,3,4,4,11,36.4,7,6,2,4,2,9,6,0
133,Alexis Canelo,ar ARG,FW,Lanús,,33.24931507,1992,2.5,0,0,0,0,0,0,1,0,1,1,0,1,0,0,2,0
134,Ezequiel Cañete,ar ARG,MF,Unión,,25.88219178,1999,0.3,3,2,0,3,0,0,1,0,1,1,0,1,0,3,0,0
135,Ezequiel Cannavo,ar ARG,DF,Defensa y Just,,22.89589041,2002,12.4,40,29,26,11,3,20,29,69,9,12,4,8,15,55,61,0
136,Víctor Cantillo,co COL,"MF,FW",Huracán,,31.55342466,1993,0.3,2,0,1,1,0,0,0,,0,1,1,0,3,5,3,0
137,Giovanni Cantizano,ar ARG,FW,Rosario Central,,18.12328767,2007,0,0,0,0,0,0,0,0,,0,0,0,0,0,0,0,0
138,Nicolás Capraro,ar ARG,DF,Barracas Central,,27.17260274,1998,1.5,2,2,2,0,0,0,2,0,2,1,1,0,6,8,3,0
139,Gabriel Carabajal,ar ARG,"MF,FW",Sarmiento,,33.40273973,1991,8.4,5,3,3,1,1,3,14,21.4,11,6,0,6,8,13,15,0
140,Mauricio Cardillo,ar ARG,MF,Ind. Rivadavia,,22.15068493,2003,9,24,14,18,6,0,13,21,61.9,8,8,1,7,7,31,11,0
141,Tomás Cardona,ar ARG,DF,Talleres,,29.56712329,1995,2,2,2,0,2,0,1,1,100,0,1,1,0,0,2,12,1
142,Agustín Cardozo,ar ARG,MF,Lanús,,27.93150685,1997,13.4,19,13,8,10,1,12,22,54.5,10,18,2,16,13,32,15,0
143,Juan Cardozo,py PAR,MF,Arg Juniors,,21.19178082,2004,1.3,6,5,1,4,1,1,3,33.3,2,3,0,3,0,6,5,0
144,Leonel Cardozo,ar ARG,DF,Lanús,,21.31780822,2004,1.1,1,1,0,1,0,0,1,0,1,2,0,2,0,1,3,0
145,Thiago Cardozo,uy URU,GK,Unión,,28.76164384,1996,14,0,0,0,0,0,0,0,,0,0,0,0,0,0,3,0
146,Jan Carlos Hurtado,ve VEN,FW,Gimnasia–LP,,25.16712329,2000,4,3,1,0,3,0,0,1,0,1,2,0,2,1,4,4,0
147,Nicolás Caro,ar ARG,DF,Deportivo Riestra,,30.00273973,1995,8.2,6,6,4,2,0,5,8,62.5,3,8,6,2,6,12,61,0
148,Jorge Carranza,ar ARG,GK,Aldosivi,,43.99452055,1981,12,2,2,2,0,0,2,2,100,0,0,0,0,0,2,9,1
149,Ramiro Carrera,ar ARG,"MF,FW",Lanús,,31.52876712,1993,8.5,18,6,9,7,2,11,22,50,11,13,3,10,5,23,14,0
150,Guido Carrillo,ar ARG,FW,Estudiantes–LP,,33.94520548,1991,8.2,2,1,0,1,1,1,2,50,1,2,1,1,2,4,13,0
151,Maher Carrizo,ar ARG,"FW,MF",Vélez Sarsfield,,19.20547945,2006,8,9,5,4,5,0,1,6,16.7,5,5,0,5,2,11,1,0
152,Maximiliano Casa,ar ARG,MF,San Martín de San Juan,,32.20821918,1993,0.6,0,0,0,0,0,0,0,,0,0,0,0,1,1,0,0
153,Milton Casco,ar ARG,DF,River Plate,,37.06575342,1988,5.1,8,5,2,5,1,7,13,53.8,6,4,1,3,4,12,19,0
154,Rodrigo Cáseres,ar ARG,DF,San Martín de San Juan,,27.68219178,1997,13.1,12,7,8,3,1,6,9,66.7,3,18,10,8,23,35,105,0
155,Yuri Casermeiro,ar ARG,DF,Cen. Córdoba–SdE,,23.14794521,2002,5,8,4,5,2,1,3,5,60,2,10,5,5,9,17,40,0
156,Kevin Castaño,co COL,MF,River Plate,,24.59726027,2000,4.5,5,1,2,3,0,1,6,16.7,5,4,0,4,2,7,3,0
157,Rodrigo Castillo,ar ARG,FW,Gimnasia–LP,,26.18630137,1999,15.4,12,8,2,8,2,5,7,71.4,2,19,4,15,1,13,27,0
158,Alexis Castro,ar ARG,"FW,MF",Estudiantes–LP,,30.54520548,1994,3.4,5,4,3,1,1,3,8,37.5,5,6,0,6,6,11,2,0
159,Lucas Castro,ar ARG,MF,Gimnasia–LP,,36.07123288,1989,11.7,20,10,7,9,4,9,15,60,6,5,2,3,5,25,26,2
160,Nicolás Castro,ar ARG,MF,Atlé Tucumán,,34.72054795,1990,2.9,15,8,5,9,1,7,12,58.3,5,2,2,0,0,15,4,0
161,Juan Cavallaro,ar ARG,"MF,FW",San Martín de San Juan,,30.85205479,1994,4.9,9,7,4,5,0,5,9,55.6,4,4,0,4,2,11,4,0
162,Tomás Cavanagh,ar ARG,DF,Vélez Sarsfield,,24.32876712,2001,1.8,5,4,2,3,0,4,7,57.1,3,1,0,1,2,7,4,0
163,Edinson Cavani,uy URU,FW,Boca Juniors,,38.21917808,1987,9.2,7,6,3,1,3,3,5,60,2,5,1,4,2,9,8,0
164,Emanuel Cecchini,ar ARG,MF,San Lorenzo,,28.36164384,1996,6.5,14,6,5,7,2,4,18,22.2,14,8,2,6,3,17,12,0
165,Milton Céliz,ar ARG,MF,Deportivo Riestra,,32.77808219,1992,14.8,35,23,17,16,2,12,38,31.6,26,25,5,20,20,55,33,0
166,Ezequiel Centurión,ar ARG,GK,Ind. Rivadavia,,27.95890411,1997,16,0,0,0,0,0,0,1,0,1,0,0,0,0,0,6,1
167,Giuliano Cerato,ar ARG,"MF,DF",Aldosivi,,26.90136986,1998,10.4,29,14,14,11,4,13,24,54.2,11,13,3,10,11,40,41,0
168,Ezequiel Cerutti,ar ARG,FW,San Lorenzo,,33.29589041,1992,7.3,10,9,4,4,2,6,9,66.7,3,9,0,9,3,13,10,1
169,Tobías Cervera,sy SYR,"FW,MF",Platense,,22.74520548,2002,0.5,1,1,0,1,0,0,0,,0,1,0,1,0,1,1,0
170,Edwuin Cetré,co COL,"FW,MF",Estudiantes–LP,,27.33972603,1998,5.6,5,4,1,2,2,3,6,50,3,4,0,4,4,9,4,0
171,Jeremías Chavero,ar ARG,FW,Lanús,,18.93150685,2006,0,0,0,0,0,0,0,0,,0,0,0,0,0,0,1,0
172,Lautaro Chávez,ar ARG,"FW,MF",Aldosivi,,24.29589041,2001,4.1,9,5,6,3,0,5,11,45.5,6,7,1,6,1,10,3,0
173,Giovani Chiaverano,ar ARG,"FW,MF",Newell's OB,,19.95616438,2005,1.9,4,3,2,2,0,2,5,40,3,3,0,3,0,4,2,0
174,Agustín Colazo,ar ARG,FW,Unión,,24.46849315,2000,5,0,0,0,0,0,0,2,0,2,4,0,4,0,0,2,0
175,Facundo Colidio,ar ARG,FW,River Plate,,25.33150685,2000,9.9,14,9,1,8,5,3,8,37.5,5,12,0,12,2,16,5,0
176,Nazareno Colombo,ar ARG,DF,Racing Club,,26.1260274,1999,11.5,17,12,11,6,0,9,20,45,11,13,7,6,22,39,67,0
177,Gabriel Compagnucci,ar ARG,DF,Belgrano,,33.68219178,1991,8.9,13,8,6,5,2,6,10,60,4,8,1,7,10,23,18,0
178,Germán Conti,ar ARG,DF,Racing Club,,30.92054795,1994,2.8,4,3,3,1,0,1,3,33.3,2,6,5,1,6,10,23,0
179,Enzo Copetti,ar ARG,FW,Rosario Central,,29.29863014,1996,12.5,16,8,3,12,1,5,11,45.5,6,6,0,6,4,20,17,0
180,Fabricio Corbalan,ar ARG,"DF,FW",Gimnasia–LP,,21.59726027,2003,3.1,8,6,2,3,3,6,8,75,2,4,1,3,3,11,4,1
181,Nicolás Cordero,ar ARG,FW,Arg Juniors,,26.06575342,1999,0.2,1,1,1,0,0,0,0,,0,1,0,1,0,1,0,0
182,Nicolás Cordero,ar ARG,FW,Instituto,,26.06575342,1999,4.9,9,5,1,3,5,2,6,33.3,4,5,0,5,2,11,4,0
183,Emanuel Coronel,ar ARG,DF,Rosario Central,,28.25479452,1997,12.9,37,26,18,19,0,16,28,57.1,12,11,1,10,17,54,51,0
184,Kevin Coronel,ar ARG,DF,Arg Juniors,,20.73150685,2004,0.3,0,0,0,0,0,0,0,,0,1,0,1,0,0,2,0
185,Mateo Coronel,ar ARG,FW,Atlé Tucumán,,26.52876712,1998,9.4,2,1,0,1,1,1,1,100,0,6,0,6,1,3,1,0
186,Claudio Corvalán,ar ARG,DF,Unión,,36.11780822,1989,11,25,11,17,6,2,12,17,70.6,5,11,5,6,21,46,57,0
187,Ayrton Costa,ar ARG,DF,Boca Juniors,,25.81369863,1999,7.1,20,15,17,3,0,12,14,85.7,2,13,6,7,10,30,55,0
188,Leonard Costa,uy URU,DF,Ind. Rivadavia,,27.01917808,1998,4.1,6,5,5,1,0,5,7,71.4,2,7,6,1,5,11,35,0
189,Giorgio Costantini,br BRA,FW,River Plate,,19.05205479,2006,0,1,0,1,0,0,1,1,100,0,0,0,0,0,1,1,0
190,Juan Cozzani,ar ARG,GK,Platense,,26.56986301,1998,16,0,0,0,0,0,0,0,,0,0,0,0,1,1,10,1
191,Thiago Cravero,ar ARG,MF,Belgrano,,22.58630137,2002,2,6,3,2,3,1,4,7,57.1,3,2,1,1,3,9,6,0
192,Sebastián Cristóforo,uy URU,"MF,FW",Cen. Córdoba–SdE,,31.69863014,1993,3.4,7,6,2,5,0,4,10,40,6,3,1,2,5,12,5,0
193,Juan Cruz Komar,ar ARG,DF,Rosario Central,,28.7260274,1996,7.7,11,10,7,4,0,5,9,55.6,4,7,5,2,6,17,74,0
194,Alexis Cuello,ar ARG,"FW,MF",San Lorenzo,,25.20821918,2000,9.9,11,6,1,4,6,8,17,47.1,9,15,2,13,2,13,11,0
195,Víctor Cuesta,ar ARG,DF,Newell's OB,,36.45753425,1988,9.9,14,5,8,5,1,11,13,84.6,2,14,7,7,22,36,75,0
196,Braian Cufré,ar ARG,DF,Cen. Córdoba–SdE,,28.38630137,1996,8.5,8,4,4,2,2,6,7,85.7,1,8,1,7,9,17,17,1
197,Santiago Dalmasso,ar ARG,MF,Boca Juniors,,20.87945205,2004,0.1,1,1,0,1,0,0,0,,0,0,0,0,0,1,0,0
198,Leonel Dante Álvarez,ar ARG,DF,San Martín de San Juan,,29.11232877,1996,9,20,12,12,7,1,11,19,57.9,8,14,3,11,7,27,35,0
199,Agustín Dáttola,ar ARG,DF,Belgrano,,26.04109589,1999,4,3,2,2,1,0,2,3,66.7,1,3,1,2,3,6,20,0
200,Fernando David Cardozo,py PAR,"MF,FW",Newell's OB,,24.23561644,2001,5.4,8,8,6,2,0,6,14,42.9,8,8,2,6,4,12,11,0
201,Jonathan David Gómez,ar ARG,MF,Rosario Central,,35.36986301,1989,0.8,0,0,0,0,0,0,2,0,2,1,0,1,0,0,2,0
202,Hernán De La Fuente,ar ARG,DF,Huracán,,28.32328767,1997,5,5,1,3,2,0,3,5,60,2,5,2,3,7,12,11,0
203,Matías De los Santos,uy URU,DF,Atlé Tucumán,,32.44931507,1992,10,10,5,8,2,0,6,8,75,2,10,7,3,12,22,65,0
204,Mathías De Ritis,uy URU,DF,Banfield,,22.25753425,2003,11.8,37,23,21,14,2,22,40,55,18,10,2,8,16,53,45,1
205,Ramiro Degregorio,ar ARG,"FW,MF",Racing Club,,22.23287671,2003,0.7,4,3,1,0,3,0,1,0,1,0,0,0,1,5,0,0
206,Ronaldo Dejesús,py PAR,DF,Lanús,,0,,11,8,5,5,3,0,3,4,75,1,15,3,12,14,22,124,2
207,Mateo Del Blanco,ar ARG,"DF,MF",Unión,,21.50958904,2003,11.7,17,12,7,6,4,7,16,43.8,9,7,1,6,15,32,28,0
208,Milton Delgado,ar ARG,MF,Boca Juniors,,19.88493151,2005,9.4,28,18,6,20,2,12,22,54.5,10,8,1,7,18,46,11,2
209,Jonathan Dellarossa,ar ARG,FW,Instituto,,25.29315068,2000,1.9,1,0,0,0,1,0,2,0,2,1,0,1,0,1,1,0
210,Nicolás Demartini,ar ARG,DF,Barracas Central,,25.49863014,1999,10.4,29,16,19,10,0,15,26,57.7,11,16,5,11,20,49,54,1
211,Valentín Depietri,ar ARG,FW,Talleres,,24.50958904,2000,7.2,5,4,1,3,1,1,4,25,3,5,0,5,3,8,10,0
212,Facundo Di Biasi,ar ARG,"MF,FW",Gimnasia–LP,,19.86849315,2005,9.7,16,11,5,7,4,9,19,47.4,10,9,2,7,12,28,23,1
213,Marco Di Cesare,ar ARG,DF,Racing Club,,23.26027397,2002,11.1,15,7,10,3,2,9,16,56.3,7,18,13,5,9,24,69,3
214,Lautaro Di Lollo,ar ARG,DF,Boca Juniors,,21.15342466,2004,8,20,13,17,2,1,12,16,75,4,13,3,10,8,28,43,0
215,Ramiro Di Luciano,ar ARG,DF,Banfield,,21.28493151,2004,12.4,19,10,10,7,2,12,18,66.7,6,21,5,16,23,42,50,0
216,Lucas Diarte,ar ARG,DF,San Martín de San Juan,,31.91780822,1993,6.6,16,9,8,6,2,11,13,84.6,2,9,1,8,5,21,18,1
217,Alexander Díaz,ar ARG,"FW,MF",Deportivo Riestra,,25.28219178,2000,4.3,4,4,3,1,0,2,8,25,6,1,0,1,1,5,7,0
218,Damián Díaz,ec ECU,"MF,FW",Banfield,,39.0109589,1986,2.1,3,3,1,2,0,0,1,0,1,1,0,1,0,3,0,0
219,Diego Díaz,ar ARG,FW,Unión,,23.31506849,2002,1.4,2,2,0,0,2,1,2,50,1,1,0,1,0,2,2,0
220,Franco Díaz,ar ARG,MF,Instituto,,24.68493151,2000,2.9,2,1,1,0,1,1,5,20,4,2,0,2,4,6,1,0
221,Gabriel Díaz,ar ARG,"DF,FW",Sarmiento,,25.04383562,2000,8.5,19,12,7,9,3,12,20,60,8,8,1,7,20,39,26,0
222,Leandro Díaz,ar ARG,FW,Atlé Tucumán,,32.91232877,1992,9.2,6,5,2,1,3,0,4,0,4,2,2,0,2,8,4,0
223,Paulo Díaz,cl CHI,DF,River Plate,,30.69315068,1994,8.1,11,7,7,4,0,7,9,77.8,2,11,9,2,6,17,63,0
224,Jerónimo Domina,ar ARG,"FW,MF",Unión,,19.54794521,2005,7.3,4,1,0,3,1,2,4,50,2,1,0,1,0,4,5,0
225,Alexis Dominguez,ar ARG,"FW,MF",Aldosivi,,28.51232877,1996,2.5,2,2,1,1,0,1,1,100,0,3,0,3,0,2,0,0
226,Nery Domínguez,ar ARG,"MF,DF",San Lorenzo,,35.07123288,1990,2.5,6,6,2,4,0,4,6,66.7,2,5,1,4,3,9,19,0
227,Sebastián Driussi,ar ARG,"FW,MF",River Plate,,29.23287671,1996,7.7,10,8,1,7,2,5,8,62.5,3,9,0,9,0,10,4,0
228,Gaspar Duarte,ar ARG,"FW,MF",Rosario Central,,22.3260274,2003,8.2,16,7,8,5,3,8,16,50,8,8,1,7,2,18,21,0
229,Tomás Durso,ar ARG,GK,Atlé Tucumán,,26.18630137,1999,11,1,1,1,0,0,1,3,33.3,2,0,0,0,0,1,10,1
230,Edgar Elizalde,uy URU,DF,Platense,,25.18356164,2000,0.9,3,2,3,0,0,2,2,100,0,1,1,0,2,5,9,0
231,Gastón Emanuel Moreyra,ar ARG,MF,San Martín de San Juan,,25.38630137,1999,0.8,3,1,2,1,0,2,4,50,2,1,0,1,1,4,1,0
232,José Enrique Angulo,ec ECU,FW,Unión,,30.24931507,1995,0.6,1,1,0,1,0,0,1,0,1,0,0,0,0,1,3,0
233,Lautaro Escalante,ar ARG,MF,San Martín de San Juan,,25.84109589,1999,1.6,5,2,3,2,0,2,4,50,2,4,0,4,1,6,2,0
234,Valentín Escalante,ar ARG,FW,San Lorenzo,,20.84109589,2004,0,0,0,0,0,0,0,0,,0,0,0,0,0,0,0,0
235,Gonzalo Escudero,ar ARG,DF,Racing Club,,18.09315068,2007,1,4,2,4,0,0,4,5,80,1,0,0,0,1,5,4,0
236,Juan Espínola,py PAR,GK,Belgrano,,30.50410959,1994,11,2,0,2,0,0,1,1,100,0,0,0,0,0,2,6,0
237,Marcelo Esponda,ar ARG,MF,Aldosivi,,22.30410959,2003,9.4,21,12,4,15,2,11,16,68.8,5,17,1,16,12,33,14,1
238,Santiago Esquivel,ar ARG,"MF,FW",Banfield,,21.3369863,2004,2.2,7,3,4,2,1,6,7,85.7,1,3,0,3,4,11,0,0
239,Marcelo Estigarribia,ar ARG,FW,Atlé Tucumán,,29.98630137,1995,1,1,0,0,0,1,1,2,50,1,4,1,3,1,2,1,0
240,Marcelo Estigarribia,ar ARG,FW,Unión,,29.98630137,1995,9.6,4,2,1,3,0,0,4,0,4,6,2,4,3,7,13,0
241,Yair Ezequiel Arismendi,ar ARG,"DF,MF",Sarmiento,,27.08219178,1998,1.4,2,2,1,1,0,1,1,100,0,0,0,0,3,5,7,1
242,Frank Fabra,co COL,DF,Boca Juniors,,34.19726027,1991,1.2,2,2,1,0,1,1,2,50,1,0,0,0,7,9,2,0
243,Kevin Facundo Gutiérrez,ar ARG,MF,Defensa y Just,,27.92054795,1997,13.6,17,5,5,10,2,7,15,46.7,8,8,1,7,18,35,46,2
244,Franco Fagundez,uy URU,FW,Deportivo Riestra,,26.3890411,1998,0.4,3,3,1,0,2,3,3,100,0,0,0,0,0,3,0,0
245,Lucio Falasco,ar ARG,"MF,FW",Aldosivi,,21.20547945,2004,0,0,0,0,0,0,0,1,0,1,0,0,0,0,0,0,0
246,Facundo Farías,ar ARG,"MF,FW",Estudiantes–LP,,22.68493151,2002,1.9,1,0,0,0,1,0,1,0,1,0,0,0,0,1,3,0
247,Valentín Fascendini,ar ARG,DF,Unión,,22.14520548,2003,3.8,3,3,2,1,0,3,6,50,3,2,1,1,2,5,17,1
248,Federico Fattori,ar ARG,MF,Arg Juniors,,32.78630137,1992,13.2,29,15,15,12,2,12,31,38.7,19,9,1,8,20,49,37,0
249,Adrián Fernández,ar ARG,"FW,MF",Racing Club,,23.95890411,2001,2.6,3,3,1,2,0,0,3,0,3,2,0,2,2,5,1,0
250,Damián Fernández,ar ARG,DF,Vélez Sarsfield,,24.3369863,2001,10.5,22,12,15,7,0,14,17,82.4,3,8,3,5,19,41,70,2
251,Gustavo Fernández,ar ARG,FW,Deportivo Riestra,,34.75068493,1990,0.8,0,0,0,0,0,0,0,,0,1,1,0,0,0,0,0
252,Ignacio Fernández,ar ARG,MF,River Plate,,35.30958904,1990,2.4,7,4,3,4,0,3,8,37.5,5,4,2,2,2,9,2,0
253,Manuel Fernández,ar ARG,FW,Vélez Sarsfield,,20.57260274,2004,0.5,0,0,0,0,0,0,1,0,1,0,0,0,0,0,1,0
254,Martín Fernández,uy URU,MF,Gimnasia–LP,,23.99178082,2001,7.5,12,8,5,7,0,2,6,33.3,4,6,3,3,5,17,9,1
255,Matías Fernández,ar ARG,MF,Ind. Rivadavia,,23.86575342,2001,5.6,9,7,2,6,1,6,11,54.5,5,8,2,6,7,16,4,0
256,Nicolás Fernández,ar ARG,"FW,MF",Belgrano,,29.23561644,1996,12.2,9,6,3,5,1,1,7,14.3,6,4,0,4,2,11,7,0
257,Rodrigo Fernández,uy URU,MF,Independiente,,29.33424658,1996,2.7,3,1,1,2,0,2,3,66.7,1,4,0,4,3,6,12,0
258,Santiago Fernández,ar ARG,DF,Talleres,,20.09863014,2005,5,12,10,10,2,0,4,5,80,1,6,5,1,8,20,36,0
259,Tomás Fernández,ar ARG,"MF,FW",San Martín de San Juan,,26.73972603,1998,6.1,8,4,4,3,1,1,10,10,9,5,0,5,2,10,1,0
260,Gianluca Ferrari,ar ARG,DF,Atlé Tucumán,,27.84657534,1997,12,15,11,9,5,1,7,8,87.5,1,17,11,6,14,29,90,2
261,Cristian Ferreira,ar ARG,"FW,MF",Arg Juniors,,25.64383562,1999,0.5,0,0,0,0,0,0,0,,0,0,0,0,0,0,0,0
262,Lucas Ferreira,uy URU,DF,Defensa y Just,,24.88493151,2000,11.5,23,15,17,6,0,11,21,52.4,10,22,13,9,21,44,114,1
263,Sebastián Ferreira,py PAR,FW,Rosario Central,,27.22191781,1998,3.4,2,2,1,0,1,1,2,50,1,2,1,1,0,2,5,0
264,Héctor Fértoli,ar ARG,"MF,FW",Tigre,,30.41917808,1994,4.9,3,3,0,3,0,0,8,0,8,1,0,1,5,8,1,0
265,Jose Florentín,py PAR,MF,Cen. Córdoba–SdE,,28.83287671,1996,13.6,21,10,5,14,2,10,22,45.5,12,18,4,14,11,32,18,0
266,Santiago Flores,ar ARG,DF,Ind. Rivadavia,,24.11232877,2001,0.9,1,1,1,0,0,0,0,,0,2,1,1,0,1,7,1
267,Franco Fragapane,ar ARG,"MF,DF",Unión,,32.24109589,1993,6.8,6,5,2,2,2,3,10,30,7,8,0,8,7,13,3,0
268,Juan Franco Arrellaga,py PAR,DF,Instituto,,33.23013699,1992,16,26,17,14,11,1,14,27,51.9,13,21,5,16,21,47,40,1
269,Franco Pardo,ar ARG,DF,Unión,,28.08219178,1997,13.7,18,11,8,9,1,8,17,47.1,9,12,10,2,27,45,94,2
270,Nicolás Freire,ar ARG,DF,Independiente,,31.20821918,1994,1,0,0,0,0,0,0,0,,0,1,0,1,0,0,2,0
271,Franco Frías,ar ARG,"FW,MF",Sarmiento,,23.13424658,2002,5.7,4,3,1,1,2,0,3,0,3,3,0,3,1,5,0,0
272,Ramiro Funes Mori,ar ARG,DF,Estudiantes–LP,,34.16712329,1991,4,7,6,3,3,1,4,6,66.7,2,4,2,2,10,17,32,0
273,Nazareno Funez,ar ARG,FW,Cen. Córdoba–SdE,,23.92328767,2001,2.9,3,2,0,2,1,2,3,66.7,1,1,0,1,0,3,6,0
274,Nazareno Funez,ar ARG,"FW,DF",Newell's OB,,23.92328767,2001,2.6,1,1,0,0,1,0,0,,0,2,0,2,2,3,7,0
275,Matías Galarza,py PAR,"FW,MF",Talleres,,23.22739726,2002,9.6,20,12,11,6,3,9,22,40.9,13,14,0,14,3,23,14,0
276,Matías Galarza,ar ARG,MF,Talleres,,23.16986301,2002,6.8,17,14,4,13,0,5,10,50,5,4,1,3,6,23,6,0
277,Pablo Galdames Millán,cl CHI,"MF,FW",Independiente,,28.34520548,1996,4.9,17,9,6,10,1,9,11,81.8,2,4,2,2,4,21,10,0
278,Hernán Galíndez,ec ECU,GK,Huracán,,38.09863014,1987,16,0,0,0,0,0,0,0,,0,0,0,0,0,0,4,0
279,Matías Gallardo,ar ARG,"FW,MF",Instituto,,21.44657534,2003,0.2,3,2,1,2,0,2,2,100,0,1,0,1,0,3,1,0
280,Baltasar Gallego,ar ARG,MF,Racing Club,,21.82191781,2003,1.1,3,1,1,0,2,1,4,25,3,1,0,1,2,5,0,0
281,Rodrigo Gallo,ar ARG,DF,Deportivo Riestra,,24.49863014,2000,4,7,5,6,1,0,4,4,100,0,2,0,2,7,14,28,0
282,Giuliano Galoppo,ar ARG,MF,River Plate,,25.87945205,1999,6.3,17,10,4,9,4,8,13,61.5,5,9,0,9,4,21,1,0
283,Jonathan Galván,ar ARG,"DF,MF",Cen. Córdoba–SdE,,32.86027397,1992,10,15,9,8,7,0,9,10,90,1,7,4,3,21,36,50,0
284,Tomás Galván,ar ARG,"MF,FW",Vélez Sarsfield,,25.06575342,2000,5,6,4,2,3,1,1,2,50,1,3,0,3,4,10,2,0
285,Ariel Gamarra,py PAR,"DF,MF",Arg Juniors,,22.18630137,2003,0.3,2,1,1,1,0,0,0,,0,1,0,1,1,3,6,1
286,Lucas Gamba,ar ARG,"FW,MF",Unión,,37.8630137,1987,10.3,3,1,0,1,2,2,4,50,2,10,0,10,1,4,1,1
287,Martín Garay,ar ARG,"DF,MF",Tigre,,25.89589041,1999,7.5,17,11,6,11,0,9,19,47.4,10,11,1,10,5,22,13,0
288,Nicolás Garayalde,ar ARG,MF,Gimnasia–LP,,25.7890411,1999,3.1,18,8,9,9,0,8,14,57.1,6,3,0,3,6,24,6,0
289,Agustín García Basso,ar ARG,DF,Racing Club,,33.10958904,1992,3.9,3,1,2,1,0,2,2,100,0,1,1,0,1,4,17,0
290,Joaquín García,ar ARG,DF,Vélez Sarsfield,,23.70684932,2001,0.4,0,0,0,0,0,0,0,,0,0,0,0,0,0,0,0
291,Manuel García,ar ARG,MF,Sarmiento,,25.89863014,1999,6.4,24,19,8,14,2,11,18,61.1,7,8,2,6,8,32,17,0
292,Matías García,ar ARG,FW,Aldosivi,,33.53424658,1991,0.6,4,4,0,4,0,0,0,,0,0,0,0,0,4,1,0
293,Mariano Gerez,ar ARG,MF,Lanús,,19.29041096,2006,0.1,2,1,0,1,1,2,2,100,0,1,0,1,0,2,0,0
294,Francisco Gerometta,ar ARG,DF,Unión,,25.6739726,1999,7.6,19,13,7,10,2,10,21,47.6,11,7,0,7,8,27,19,0
295,Joaquín Gho,ar ARG,"MF,FW",Sarmiento,,21.97534247,2003,12.2,38,26,17,17,4,14,19,73.7,5,16,2,14,6,44,25,0
296,Laurtaro Giaccone,ar ARG,"FW,MF",Rosario Central,,24.25479452,2001,5.8,5,4,0,5,0,3,6,50,3,4,0,4,5,10,5,0
297,Renzo Giampaoli,ar ARG,DF,Gimnasia–LP,,25.32328767,2000,3.4,8,4,6,2,0,1,2,50,1,4,3,1,2,10,30,0
298,Justo Giani,ar ARG,"MF,FW",Aldosivi,,26.07671233,1999,9.4,24,13,3,15,6,15,27,55.6,12,7,2,5,7,31,15,0
299,Thiago Gigena,ar ARG,"FW,MF",Newell's OB,,19.59452055,2005,0.2,0,0,0,0,0,0,0,,0,1,0,1,0,0,1,0
300,Leonardo Gil,ar ARG,MF,Huracán,,33.92876712,1991,15,31,15,11,17,3,13,44,29.5,31,13,2,11,16,47,15,1
301,Orlando Gil,py PAR,GK,San Lorenzo,,24.89863014,2000,16,0,0,0,0,0,0,0,,0,0,0,0,0,0,5,0
302,Elián Giménez,ar ARG,MF,Sarmiento,,21.11780822,2004,8.2,26,19,15,9,2,14,29,48.3,15,11,1,10,15,41,15,0
303,Enzo Giménez,py PAR,"DF,MF",Rosario Central,,27.2109589,1998,3.9,13,8,7,5,1,5,11,45.5,6,9,2,7,5,18,24,1
304,Juan Giménez,ar ARG,DF,Rosario Central,,19.02191781,2006,2.7,2,2,1,1,0,0,0,,0,5,3,2,1,3,11,0
305,Luciano Giménez,ar ARG,"FW,MF",Estudiantes–LP,,25.20821918,2000,2.3,2,2,0,1,1,1,3,33.3,2,4,0,4,1,3,6,0
306,Matías Giménez,ar ARG,FW,Independiente,,26.16438356,1999,5.1,3,2,2,1,0,1,1,100,0,3,1,2,2,5,6,0
307,Milton Giménez,ar ARG,FW,Boca Juniors,,28.72876712,1996,8.4,7,5,0,3,4,1,7,14.3,6,8,0,8,2,9,11,0
308,Federico Girotti,ar ARG,FW,Talleres,,25.92328767,1999,8.4,1,0,0,1,0,0,4,0,4,2,0,2,1,2,10,0
309,Dylan Glaby,ar ARG,MF,Cen. Córdoba–SdE,,29.07671233,1996,6.7,6,5,2,4,0,4,10,40,6,6,0,6,9,15,13,0
310,Erik Godoy,ar ARG,DF,Arg Juniors,,31.71780822,1993,14.3,16,9,9,7,0,8,10,80,2,18,10,8,12,28,93,0
311,Joel Godoy,ar ARG,DF,Sarmiento,,20.20273973,2005,6.7,13,6,8,5,0,9,16,56.3,7,7,3,4,8,21,33,0
312,Lautaro Godoy,py PAR,"MF,DF",Atlé Tucumán,,22.13972603,2003,0.9,2,1,1,1,0,2,3,66.7,1,0,0,0,3,5,0,0
313,Matías Godoy,ar ARG,"MF,FW",Instituto,,23.31506849,2002,4.5,9,6,3,3,3,5,9,55.6,4,0,0,0,0,9,2,1
314,Jonatan Goitía,ar ARG,"MF,DF",Deportivo Riestra,,30.75616438,1994,12.5,27,14,11,13,3,16,28,57.1,12,13,1,12,18,45,32,0
315,Elías Gómez,ar ARG,DF,Vélez Sarsfield,,30.90410959,1994,13.1,30,19,21,6,3,13,29,44.8,16,12,4,8,11,41,42,2
316,Iván Gómez,ar ARG,MF,Cen. Córdoba–SdE,,28.18082192,1997,9.7,23,15,9,12,2,10,18,55.6,8,16,1,15,8,31,8,0
317,Lucas Gómez,ar ARG,MF,Arg Juniors,,20.88219178,2004,2.6,5,4,1,4,0,1,3,33.3,2,4,1,3,2,7,5,0
318,Luciano Gómez,ar ARG,"DF,MF",Ind. Rivadavia,,29.12054795,1996,10.7,22,14,13,8,1,15,22,68.2,7,16,4,12,8,30,30,0
319,Matias Gomez,ar ARG,MF,Talleres,,19.44657534,2005,0.1,2,2,1,1,0,0,0,,0,0,0,0,0,2,0,0
320,Román Gómez,ar ARG,DF,Estudiantes–LP,,20.80821918,2004,1,1,1,1,0,0,0,0,,0,2,0,2,4,5,7,0
321,Valentín Gómez,ar ARG,DF,Vélez Sarsfield,,21.85753425,2003,7.6,14,6,9,5,0,9,13,69.2,4,7,6,1,6,20,56,0
322,Gonzalo Goñi,ar ARG,FW,Platense,,26.71780822,1998,0.1,0,0,0,0,0,0,0,,0,0,0,0,0,0,0,0
323,Diego González,ar ARG,MF,San Martín de San Juan,,37.23287671,1988,4.3,6,4,3,2,1,5,8,62.5,3,6,4,2,8,14,13,0
324,Carlos González Espínola,py PAR,FW,Newell's OB,,32.24657534,1993,9.1,11,8,5,5,1,1,5,20,4,0,0,0,6,17,11,0
325,Federico González,ar ARG,"FW,MF",San Martín de San Juan,,38.3260274,1987,1.9,4,3,1,1,2,0,1,0,1,3,2,1,1,5,4,0
326,Francisco González,ar ARG,"MF,FW",Belgrano,,28.10136986,1997,9.9,25,18,11,13,1,11,21,52.4,10,13,1,12,8,33,12,1
327,Francisco González,ar ARG,"FW,MF",Newell's OB,,24.07945205,2001,0.7,0,0,0,0,0,0,0,,0,0,0,0,0,0,0,0
328,Francisco González,ar ARG,"FW,MF",Defensa y Just,,24.07945205,2001,7.1,7,2,3,4,0,3,8,37.5,5,6,0,6,2,9,11,0
329,Gaston Gonzalez,ar ARG,"FW,MF",Defensa y Just,,23.85479452,2001,1.9,1,1,0,0,1,0,0,,0,4,0,4,2,3,0,0
330,Juan González,uy URU,GK,Atlé Tucumán,,31.81917808,1993,5,0,0,0,0,0,0,0,,0,0,0,0,1,1,2,0
331,Lucas González,ar ARG,"FW,MF",Defensa y Just,,24.92054795,2000,5.8,4,3,1,2,1,1,3,33.3,2,6,0,6,2,6,2,0
332,Matías González,ar ARG,FW,Banfield,,23.18082192,2002,0.1,1,1,1,0,0,1,2,50,1,0,0,0,0,1,0,0
333,Matías González,ar ARG,FW,Godoy Cruz,,26.16164384,1999,3.2,,6,,,,,,,,,,,3,,,
334,Maxi González,ar ARG,MF,Defensa y Just,,21.00273973,2004,3.9,13,10,6,7,0,6,7,85.7,1,5,0,5,6,19,18,0
335,Leandro González Pirez,ar ARG,DF,River Plate,,33.18630137,1992,2,3,2,1,2,0,1,1,100,0,1,1,0,2,5,14,0
336,Rodrigo González,ar ARG,DF,Aldosivi,,25.05753425,2000,11.6,46,27,29,13,4,15,23,65.2,8,13,4,9,18,64,50,0
337,Santiago González,ar ARG,MF,Tigre,,22.00547945,2003,12.8,36,20,14,17,5,9,16,56.3,7,24,3,21,17,53,12,0
338,Sebastián González,ar ARG,"FW,MF",San Martín de San Juan,,33.16986301,1992,6,10,9,1,7,2,3,12,25,9,4,0,4,4,14,1,0
339,Jano Gordon,ar ARG,DF,Vélez Sarsfield,,20.88493151,2004,8.2,21,11,7,10,4,16,24,66.7,8,12,5,7,19,40,46,0
340,Fausto Grillo,ar ARG,DF,Belgrano,,32.20273973,1993,9.3,26,17,14,10,2,18,28,64.3,10,16,4,12,9,35,40,1
341,Ignacio Guerrico,ar ARG,DF,Aldosivi,,26.82191781,1998,15.8,54,38,27,21,6,28,43,65.1,15,17,3,14,23,77,86,0
342,Tomas Guiacobini,ar ARG,MF,Sarmiento,,20.96164384,2004,2.1,8,5,3,5,0,3,4,75,1,3,1,2,0,8,2,0
343,Tomás Guidara,ar ARG,DF,Huracán,,29.14520548,1996,11,38,27,24,12,2,23,29,79.3,6,7,2,5,14,52,39,0
344,Braian Guille,ar ARG,"MF,FW",Deportivo Riestra,,27.76164384,1997,1,4,1,1,3,0,1,2,50,1,1,0,1,1,5,1,0
345,Adrián Guillermo Sánchez,ar ARG,MF,Atlé Tucumán,,25.97534247,1999,15.4,52,34,22,28,2,21,41,51.2,20,20,3,17,14,66,23,1
346,Natanael Guzmán,ar ARG,"MF,FW",Aldosivi,,25.73150685,1999,3.5,5,3,1,4,0,1,6,16.7,5,4,0,4,1,6,3,0
347,Ezequiel Ham,sy SYR,MF,Unión,,31.15342466,1994,8.9,8,8,1,7,0,4,15,26.7,11,8,1,7,6,14,8,0
348,Agustin Hausch,ar ARG,FW,Defensa y Just,,21.95616438,2003,0.2,0,0,0,0,0,0,0,,0,0,0,0,0,0,0,0
349,Gerónimo Heredia,ar ARG,"DF,MF",Belgrano,,20.23287671,2005,6.6,9,4,3,5,1,5,9,55.6,4,6,3,3,4,13,21,0
350,Leonardo Heredia,ar ARG,FW,Cen. Córdoba–SdE,,29.31232877,1996,11.6,4,2,1,2,1,1,5,20,4,5,0,5,1,5,6,0
351,Ramiro Hernandes,ar ARG,MF,Belgrano,,20.47671233,2004,1.7,8,5,2,3,3,4,5,80,1,3,0,3,1,9,1,0
352,Gastón Hernández,ar ARG,DF,San Lorenzo,,27.29041096,1998,6,7,4,4,3,0,2,5,40,3,7,3,4,11,18,30,0
353,Ander Herrera,es ESP,MF,Boca Juniors,,35.72328767,1989,2.8,8,5,3,4,1,3,7,42.9,4,3,1,2,6,14,7,0
354,Daniel Herrera,ar ARG,DF,San Lorenzo,,21.24109589,2004,10.5,17,11,13,4,0,9,14,64.3,5,18,6,12,15,32,84,1
355,Ezequiel Herrera,ar ARG,DF,San Lorenzo,,22.28219178,2003,15,27,21,17,9,1,17,23,73.9,6,20,1,19,17,44,50,1
356,Guido Herrera,ar ARG,GK,Talleres,,33.17808219,1992,14.5,1,0,1,0,0,1,2,50,1,0,0,0,0,1,6,1
357,Jonathan Herrera,ar ARG,FW,Deportivo Riestra,,33.63287671,1991,12.8,5,3,1,2,2,1,2,50,1,5,1,4,4,9,9,0
358,José Herrera,ar ARG,"MF,FW",Arg Juniors,,20.19726027,2005,10.5,13,9,3,4,6,6,12,50,6,12,1,11,8,21,11,0
359,Rodrigo Herrera,ar ARG,MF,Platense,,24.75616438,2000,10.1,45,26,16,22,7,16,29,55.2,13,12,1,11,18,63,21,0
360,Santiago Hidalgo,ar ARG,"FW,MF",Independiente,,20.2109589,2005,5.3,11,5,3,3,5,8,18,44.4,10,7,0,7,2,13,4,0
361,Marco Iacobellis,ar ARG,"MF,FW",San Martín de San Juan,,24.35342466,2000,8.6,18,11,6,7,5,7,20,35,13,14,1,13,8,26,5,0
362,César Ibáñez,ar ARG,DF,Huracán,,25.88219178,1999,13.1,37,30,23,12,2,25,44,56.8,19,20,3,17,15,52,47,0
363,Franco Ibarra,ar ARG,MF,Rosario Central,,24.01917808,2001,13.5,60,41,28,27,5,28,54,51.9,26,28,9,19,13,73,34,0
364,Marcos Ignacio Ledesma,ar ARG,GK,Barracas Central,,28.63561644,1996,16,2,1,2,0,0,2,2,100,0,0,0,0,0,2,7,0
365,Juan Ignacio Méndez,ar ARG,"MF,DF",Newell's OB,,28.01917808,1997,1.9,8,6,4,4,0,3,4,75,1,4,0,4,4,12,7,0
366,Rodrigo Iñaki Melo,ar ARG,MF,Atlé Tucumán,,29.6109589,1995,1.3,2,1,2,0,0,1,3,33.3,2,2,0,2,1,3,2,0
367,Juan Infante,ar ARG,DF,Atlé Tucumán,,29.32328767,1996,9.1,27,19,11,13,3,12,15,80,3,15,4,11,11,38,26,0
368,Luis Ingolotti,ar ARG,GK,Gimnasia–LP,,25.30410959,2000,3,0,0,0,0,0,0,0,,0,0,0,0,0,0,2,1
369,Manuel Insaurralde,ar ARG,MF,San Lorenzo,,26.25753425,1999,0.7,4,1,2,1,1,3,5,60,2,1,0,1,0,4,0,0
370,Nelson Insfrán,ar ARG,GK,Gimnasia–LP,,29.94794521,1995,13,0,0,0,0,0,0,0,,0,0,0,0,0,0,2,1
371,Rodrigo Insúa,ar ARG,"DF,MF",Barracas Central,,27.38356164,1997,16,21,16,12,7,2,12,21,57.1,9,12,2,10,7,28,40,0
372,Elian Irala,ar ARG,MF,San Lorenzo,,20.83013699,2004,12.5,25,12,10,15,0,13,30,43.3,17,23,2,21,32,57,25,1
373,Juan Iribarren,ar ARG,DF,Banfield,,22.28219178,2003,2.7,6,5,5,1,0,3,5,60,2,7,4,3,8,14,19,0
374,Carlos Izquierdoz,ar ARG,DF,Lanús,,36.50136986,1988,14.5,21,9,16,5,0,8,13,61.5,5,14,11,3,20,41,112,2
375,Tomás Jacob,ar ARG,"DF,MF",Newell's OB,,21.04109589,2004,11.6,35,16,24,10,1,20,28,71.4,8,22,13,9,12,47,58,1
376,Lucas Janson,ar ARG,FW,Boca Juniors,,30.71780822,1994,1.2,3,2,1,0,2,2,3,66.7,1,0,0,0,0,3,0,0
377,Kevin Jappert,ar ARG,DF,Barracas Central,,21.1890411,2004,15,20,13,14,6,0,13,16,81.3,3,17,8,9,34,54,82,0
378,Franco Jara,ar ARG,FW,Belgrano,,36.80547945,1988,12.8,10,7,1,6,3,0,6,0,6,5,0,5,1,11,12,0
379,Leonardo Jara,ar ARG,DF,Godoy Cruz,,33.95890411,1991,5.7,13,10,7,6,0,8,11,72.7,3,5,1,4,11,24,30,0
380,Sebastián Jaurena,ar ARG,"MF,FW",San Martín de San Juan,,25.78630137,1999,9.7,29,16,13,13,3,17,25,68,8,7,1,6,4,33,11,0
381,Eric Joel Tovo,ar ARG,DF,Deportivo Riestra,,33.16438356,1992,2.2,1,1,0,0,1,0,1,0,1,0,0,0,4,5,19,0
382,Jony,ar ARG,"MF,FW",San Martín de San Juan,,31.16712329,1994,2.1,2,1,0,2,0,0,2,0,2,5,0,5,1,3,0,0
383,Maximiano Juambeltz,uy URU,FW,Ind. Rivadavia,,22.90410959,2002,0.3,0,0,0,0,0,0,0,,0,1,1,0,0,0,1,0
384,Fernando Juárez,ar ARG,MF,Platense,,26.69863014,1998,5.8,17,7,8,8,1,5,9,55.6,4,6,1,5,12,29,17,0
385,Luca Klimowicz,ar ARG,"FW,MF",Instituto,,20.96164384,2004,5.1,8,6,1,1,6,2,4,50,2,1,0,1,0,8,4,0
386,Bautista Kociubinski,ar ARG,"MF,FW",Estudiantes–LP,,24.02465753,2001,2,10,7,3,5,2,6,9,66.7,3,2,0,2,6,16,5,0
387,Matías Kranevitter,ar ARG,MF,River Plate,,31.95616438,1993,2.2,7,2,4,3,0,3,5,60,2,3,1,2,2,9,4,0
388,Tomás Kummer,ar ARG,MF,Aldosivi,,20.48219178,2004,0.3,3,2,2,1,0,0,0,,0,1,0,1,2,5,0,0
389,Agustín Ladstatter,ar ARG,"FW,MF",San Lorenzo,,19.91506849,2005,0.3,0,0,0,0,0,0,0,,0,0,0,0,0,0,0,0
390,Agustín Lagos,ar ARG,DF,Vélez Sarsfield,,23.56986301,2001,4.3,16,13,5,10,1,10,17,58.8,7,7,1,6,7,23,13,1
391,Nicolás Laméndola,ar ARG,MF,Atlé Tucumán,,26.39452055,1998,4.6,11,6,4,6,1,5,10,50,5,4,1,3,3,14,3,0
392,Manuel Lanzini,ar ARG,"MF,FW",River Plate,,32.21643836,1993,4.4,5,3,1,3,1,3,8,37.5,5,2,0,2,3,8,2,0
393,Santiago Laquidaín,ar ARG,DF,Aldosivi,,23.76986301,2001,1,2,1,1,1,0,1,2,50,1,0,0,0,1,3,5,0
394,Valentín Larralde,ar ARG,MF,Defensa y Just,,24.46849315,2000,1.1,0,0,0,0,0,0,0,,0,1,1,0,1,1,0,0
395,Joaquín Laso,ar ARG,DF,Tigre,,34.83561644,1990,13,22,15,16,5,1,11,16,68.8,5,19,9,10,12,34,89,0
396,Jeremías Lázaro,ar ARG,"MF,FW",Instituto,,20.85205479,2004,4.7,8,6,4,3,1,3,9,33.3,6,8,0,8,1,9,1,0
397,Lucas Lazarte,ar ARG,MF,Aldosivi,,19.76712329,2005,0.2,0,0,0,0,0,0,0,,0,0,0,0,0,0,0,0
398,Tomás Lecanda,ar ARG,DF,San Martín de San Juan,,23.2630137,2002,6,15,8,8,6,1,6,8,75,2,9,5,4,8,23,46,0
399,Anibal Leguizamón,ar ARG,DF,Belgrano,,33.31506849,1992,9,9,1,5,4,0,5,6,83.3,1,8,5,3,11,20,56,2
400,Tobías Leiva,ar ARG,MF,Aldosivi,,21.23287671,2004,10.5,23,15,8,15,0,8,22,36.4,14,11,1,10,8,31,8,1
401,Santiago Lencina,ar ARG,FW,River Plate,,19.66575342,2005,0.7,2,0,0,0,2,1,1,100,0,0,0,0,0,2,0,0
402,Alan Lescano,ar ARG,"MF,FW",Arg Juniors,,23.47945205,2001,14.9,24,13,6,13,5,11,23,47.8,12,12,2,10,5,29,11,0
403,Leandro Lescano,ar ARG,DF,Huracán,,22.17260274,2003,2.9,8,6,5,3,0,5,6,83.3,1,3,0,3,5,13,8,0
404,Bruno Leyes,ar ARG,MF,Godoy Cruz,,23.51232877,2001,10.6,19,14,11,8,0,10,32,31.3,22,25,6,19,16,35,37,0
405,Francesco Lo Celso,ar ARG,MF,Instituto,,25.16712329,2000,0.4,1,1,0,1,0,1,3,33.3,2,0,0,0,0,1,0,0
406,Gastón Lodico,ar ARG,MF,Instituto,,26.9369863,1998,12.2,29,13,12,15,2,19,35,54.3,16,11,1,10,16,45,13,0
407,Luciano Lollo,ar ARG,DF,Newell's OB,,38.10136986,1987,11.2,11,8,9,2,0,9,17,52.9,8,16,11,5,12,23,73,0
408,Kevin Lomónaco,ar ARG,DF,Independiente,,23.32054795,2002,14.9,25,19,17,8,0,15,20,75,5,14,10,4,14,39,55,1
409,Santiago Longo,ar ARG,MF,Belgrano,,27.0630137,1998,9.7,26,17,15,9,2,12,25,48,13,15,3,12,20,46,15,0
410,Hernán Lopes,ar ARG,DF,San Martín de San Juan,,34.10410959,1991,3.6,8,6,6,2,0,3,4,75,1,3,2,1,2,10,33,0
411,Elías López,ar ARG,DF,Belgrano,,24.82465753,2000,3.5,8,8,7,1,0,6,6,100,0,4,1,3,1,9,17,0
412,Fabricio López,ar ARG,DF,San Lorenzo,,22.45205479,2002,1,2,1,1,1,0,2,3,66.7,1,2,1,1,0,2,9,0
413,Julián López,ar ARG,MF,Tigre,,25.32054795,2000,5.2,14,8,7,6,1,7,15,46.7,8,6,1,5,1,15,8,0
414,Kevin Lopez,ar ARG,MF,Atlé Tucumán,,23.35068493,2001,4.8,13,7,3,9,1,6,14,42.9,8,8,1,7,5,18,10,0
415,Santiago López,ar ARG,MF,Banfield,,27.41643836,1997,7.9,18,13,10,7,1,14,24,58.3,10,10,1,9,7,25,13,0
416,Santiago López,ar ARG,"FW,MF",Rosario Central,,19.23287671,2006,5.8,13,7,6,5,2,2,9,22.2,7,8,0,8,4,17,6,0
417,Nahuel Losada,ar ARG,GK,Lanús,,32.04931507,1993,15,1,1,1,0,0,1,2,50,1,1,0,1,0,1,7,1
418,Augusto Lotti,it ITA,FW,Platense,,28.90136986,1996,10.3,2,1,0,2,0,0,3,0,3,6,0,6,1,3,7,0
419,Maximiliano Lovera,ar ARG,"MF,FW",Rosario Central,,26.15616438,1999,3.8,7,2,2,4,1,1,2,50,1,2,0,2,2,9,6,0
420,Felipe Loyola,cl CHI,"MF,DF",Independiente,,24.48493151,2000,13.9,29,20,11,12,6,16,31,51.6,15,15,1,14,7,36,25,0
421,Leandro Lozano,uy URU,DF,Arg Juniors,,26.37534247,1998,15.5,47,31,23,19,5,26,45,57.8,19,29,4,25,20,67,67,0
422,Raúl Lozano,ar ARG,DF,Platense,,27.67123288,1997,0.8,1,0,0,1,0,0,0,,0,0,0,0,0,1,3,0
423,Jeremías Lucco,ar ARG,MF,Belgrano,,19.4,2005,0.6,0,0,0,0,0,0,2,0,2,1,0,1,0,0,3,0
424,Martín Luciano,ar ARG,DF,Newell's OB,,21.40547945,2003,1.8,1,0,1,0,0,1,4,25,3,3,1,2,1,2,9,0
425,Juan Ludueña,ar ARG,DF,Unión,,22.22739726,2003,4,7,5,5,1,1,5,11,45.5,6,5,3,2,6,13,17,0
426,Alex Luna,ar ARG,"FW,MF",Instituto,,21.09589041,2004,14.7,21,16,3,11,7,11,20,55,9,20,1,19,11,32,1,0
427,Francis Mac Allister,ar ARG,MF,Instituto,,29.51232877,1995,12.4,51,31,29,19,3,28,45,62.2,17,22,5,17,18,69,29,0
428,Imanol Machuca,ar ARG,"MF,FW",Vélez Sarsfield,,25.30136986,2000,3.3,3,1,1,2,0,2,2,100,0,3,0,3,2,5,0,0
429,Ignacio Maestro Puch,ar ARG,"FW,MF",Independiente,,21.7260274,2003,1.6,3,3,0,2,1,2,2,100,0,1,0,1,0,3,1,0
430,Pablo Magnín,ar ARG,FW,Sarmiento,,35.02739726,1990,6.2,8,3,3,5,0,3,4,75,1,4,1,3,1,9,4,0
431,Guido Mainero,ar ARG,"FW,MF",Platense,,30.11780822,1995,13.8,18,10,6,10,2,9,27,33.3,18,15,1,14,5,23,21,0
432,Víctor Malcorra,ar ARG,"MF,FW",Rosario Central,,37.78082192,1987,11.8,10,6,3,5,2,4,9,44.4,5,10,0,10,5,15,10,1
433,Alexis Maldonado,ar ARG,DF,Banfield,,27.67123288,1997,13.5,21,13,15,4,2,6,8,75,2,14,11,3,12,33,101,0
434,Facundo Mallo,uy URU,DF,Rosario Central,,30.29863014,1995,8.1,11,7,6,5,0,1,4,25,3,2,1,1,20,31,62,1
435,Emanuel Mammana,ar ARG,DF,Vélez Sarsfield,,29.23013699,1996,5.5,8,5,5,3,0,5,8,62.5,3,8,5,3,13,21,33,0
436,Ivo Mammini,ar ARG,"FW,MF",Gimnasia–LP,,22.05479452,2003,1.4,3,2,2,0,1,1,2,50,1,1,0,1,0,3,1,0
437,Leandro Mamut,ar ARG,"MF,FW",Gimnasia–LP,,21.34246575,2003,2.1,9,5,3,6,0,7,8,87.5,1,2,1,1,2,11,3,0
438,Federico Mancuello,ar ARG,"MF,FW",Independiente,,36.10958904,1989,2.9,5,4,2,2,1,2,4,50,2,3,0,3,0,5,2,0
439,Facundo Mansilla,ar ARG,DF,Cen. Córdoba–SdE,,26.18356164,1999,2,0,0,0,0,0,0,1,0,1,0,0,0,3,3,16,0
440,Matías Mansilla,ar ARG,GK,Estudiantes–LP,,29.21643836,1996,16,0,0,0,0,0,0,1,0,1,1,0,1,0,0,9,2
441,Juan Manuel Elordi,ar ARG,DF,Rosario Central,,30.70410959,1994,1.6,4,4,2,1,1,3,4,75,1,2,0,2,0,4,8,0
442,Juan Manuel García,ar ARG,"FW,MF",Newell's OB,,32.47123288,1992,4.9,3,3,1,2,0,2,2,100,0,5,1,4,0,3,7,0
443,Juan Manuel Insaurralde,ar ARG,DF,Sarmiento,,40.58630137,1984,13,10,3,7,3,0,6,11,54.5,5,21,15,6,15,25,109,0
444,Alexis Manyoma,co COL,"MF,FW",Estudiantes–LP,,22.33424658,2003,4.2,16,10,8,5,3,6,12,50,6,8,2,6,4,20,4,0
445,Rafael Marcelo Delgado,ar ARG,DF,Defensa y Just,,35.30684932,1990,4.3,8,4,4,4,0,7,9,77.8,2,13,8,5,8,16,24,0
446,Agustín Marchesín,ar ARG,GK,Boca Juniors,,37.1369863,1988,14,0,0,0,0,0,0,0,,0,0,0,0,0,0,3,1
447,Leonardo Marchi,ar ARG,"DF,MF",Cen. Córdoba–SdE,,28.63013699,1996,4.7,11,9,4,4,3,8,9,88.9,1,4,0,4,3,14,12,0
448,Tomás Marchiori,ar ARG,GK,Vélez Sarsfield,,29.8739726,1995,15,0,0,0,0,0,0,0,,0,0,0,0,0,0,10,0
449,Sasha Marcich,ar ARG,DF,Lanús,,26.93424658,1998,15.2,47,31,22,17,8,20,33,60.6,13,12,2,10,20,67,70,0
450,Iván Marcone,ar ARG,MF,Independiente,,34.92054795,1990,13.3,32,16,13,17,2,15,29,51.7,14,13,5,8,13,45,30,0
451,Gonzalo Maroni,ar ARG,"MF,FW",Newell's OB,,26.13150685,1999,10,11,10,2,6,3,5,5,100,0,5,1,4,8,19,5,0
452,Rodrigo Márquez,ar ARG,FW,Platense,,23.21643836,2002,0.3,1,1,1,0,0,0,0,,0,1,0,1,1,2,0,0
453,Agustín Martegani,ar ARG,MF,Boca Juniors,,24.95890411,2000,0.6,1,0,0,1,0,1,1,100,0,0,0,0,0,1,0,0
454,Enzo Martín Roldán,ar ARG,MF,Platense,,24.40547945,2000,0.8,3,2,1,2,0,2,3,66.7,1,1,0,1,1,4,2,0
455,Adrián Martínez,ar ARG,FW,Racing Club,,32.82739726,1992,10.3,3,2,1,1,1,1,5,20,4,4,1,3,4,7,5,0
456,Damián Martínez,ar ARG,DF,Atlé Tucumán,,35.25753425,1990,10.6,36,17,19,14,3,18,29,62.1,11,11,4,7,5,41,26,0
457,Fernando Martínez,ar ARG,"DF,MF",Cen. Córdoba–SdE,,24.77260274,2000,4,9,5,5,2,2,7,9,77.8,2,5,1,4,4,13,15,0
458,Luca Martínez,mx MEX,FW,Rosario Central,,24.29589041,2001,0.1,0,0,0,0,0,0,0,,0,0,0,0,0,0,0,0
459,Luca Martínez,mx MEX,FW,Godoy Cruz,,24.29589041,2001,8,3,3,1,1,1,0,3,0,3,2,0,2,0,3,8,0
460,Mauricio Martínez,ar ARG,"MF,DF",Unión,,32.20273973,1993,9.5,13,8,5,7,1,7,13,53.8,6,8,6,2,8,21,25,0
461,Lucas Martínez Quarta,ar ARG,DF,River Plate,,28.98630137,1996,10.7,22,13,17,4,1,13,15,86.7,2,10,4,6,13,35,57,2
462,Ronaldo Martínez,py PAR,"MF,FW",Platense,,29.02739726,1996,7.2,6,2,1,2,3,3,8,37.5,5,5,0,5,2,8,16,0
463,Rubén Martínez,ar ARG,DF,Independiente,,20.89041096,2004,0.1,0,0,0,0,0,0,0,,0,0,0,0,0,0,0,0
464,Ángelo Martino,ar ARG,"DF,MF",Newell's OB,,26.91506849,1998,5.6,7,6,5,1,1,3,5,60,2,5,2,3,7,14,24,0
465,Gastón Martirena,uy URU,"DF,MF",Racing Club,,25.32876712,2000,11.4,17,10,13,2,2,10,17,58.8,7,14,2,12,17,34,31,1
466,Franco Mastantuono,ar ARG,"FW,MF",River Plate,,17.72328767,2007,8.3,7,3,0,4,3,3,9,33.3,6,11,1,10,1,8,3,0
467,Diego Mastrángelo,ar ARG,MF,Gimnasia–LP,,22.49041096,2002,0.7,1,1,1,0,0,1,1,100,0,1,0,1,0,1,6,0
468,Facundo Mater,sy SYR,"DF,MF",Barracas Central,,26.78356164,1998,11.3,23,11,13,5,5,12,31,38.7,19,15,0,15,22,45,44,0
469,Diego Matías Rodríguez,ar ARG,GK,Arg Juniors,,35.86027397,1989,16,0,0,0,0,0,0,0,,0,0,0,0,0,0,6,1
470,Julián Mavilla,ar ARG,MF,Belgrano,,25.02191781,2000,0.8,1,1,1,0,0,1,2,50,1,2,0,2,1,2,8,0
471,Augusto Max,ar ARG,"FW,MF",Gimnasia–LP,,32.73424658,1992,0.6,4,0,1,3,0,2,3,66.7,1,0,0,0,0,4,3,0
472,Walter Mazzantti,ar ARG,FW,Huracán,,28.6630137,1996,12.2,25,17,7,14,4,9,21,42.9,12,15,1,14,1,26,10,0
473,Agustín Medina,,MF,Lanús,,0,,6,21,12,6,11,4,10,16,62.5,6,11,0,11,10,31,7,1
474,Cristian Medina,ar ARG,MF,Estudiantes–LP,,22.9260274,2002,7.3,18,9,10,4,4,10,21,47.6,11,6,1,5,10,28,8,0
475,Joel Medina,ar ARG,MF,Independiente,,17.82739726,2007,1,4,3,1,3,0,2,2,100,0,1,0,1,1,5,1,0
476,Sebastián Medina,ar ARG,"MF,FW",Tigre,,25.13972603,2000,7.4,23,14,12,8,3,10,20,50,10,13,1,12,6,29,8,0
477,Juan Meli,ar ARG,DF,Godoy Cruz,,24.6739726,2000,11,26,16,13,11,2,17,33,51.5,16,13,0,13,18,44,44,0
478,Matías Melluso,ar ARG,"DF,MF",Gimnasia–LP,,26.90410959,1998,1.2,1,1,0,1,0,0,2,0,2,2,0,2,4,5,3,0
479,Armando Méndez,uy URU,DF,Lanús,,29.09589041,1996,4.2,12,7,8,4,0,7,11,63.6,4,4,2,2,6,18,11,0
480,Mateo Mendía,ar ARG,DF,Boca Juniors,,21.24931507,2004,1,2,2,0,2,0,1,1,100,0,1,1,0,1,3,3,0
481,Mateo Mendoza,ar ARG,DF,Godoy Cruz,,20.45205479,2004,14,22,15,19,2,1,12,22,54.5,10,21,14,7,14,36,87,0
482,Lucas Menossi,ar ARG,MF,Belgrano,,32.81643836,1992,10,22,13,7,13,2,8,23,34.8,15,6,0,6,7,29,15,0
483,Miguel Merentiel,uy URU,FW,Boca Juniors,,29.19178082,1996,7.2,4,4,2,2,0,3,5,60,2,3,0,3,1,5,2,0
484,Nicolás Meriano,ar ARG,DF,Belgrano,,24.48493151,2000,5.1,4,3,2,1,1,2,4,50,2,7,5,2,7,11,45,0
485,Bautista Merlini,ar ARG,"MF,FW",Gimnasia–LP,,29.83561644,1995,5.2,9,7,5,4,0,3,9,33.3,6,11,1,10,2,11,7,0
486,Jeremias Merlo,,FW,Gimnasia–LP,,0,,0.1,0,0,0,0,0,0,0,,0,0,0,0,0,0,0,0
487,Eric Meza,ar ARG,DF,Estudiantes–LP,,26.0739726,1999,14.3,24,14,17,5,2,12,25,48,13,13,1,12,10,34,41,1
488,Maximiliano Meza,ar ARG,"MF,FW",River Plate,,32.38630137,1992,7.8,24,16,11,10,3,12,18,66.7,6,15,3,12,1,25,3,0
489,Luis Miguel Rodríguez,ar ARG,"MF,FW",Atlé Tucumán,,40.33972603,1985,3.5,1,1,0,0,1,1,1,100,0,1,0,1,0,1,0,0
490,Matko Miljevic,us USA,MF,Huracán,,23.9890411,2001,11.7,15,10,4,8,3,6,17,35.3,11,12,1,11,7,22,3,0
491,Lautaro Millán,ar ARG,"FW,MF",Independiente,,19.71780822,2005,8.2,10,5,1,7,2,1,9,11.1,8,4,0,4,2,12,2,0
492,Dardo Miloc,ar ARG,MF,Barracas Central,,34.55068493,1990,14.3,37,22,13,19,5,18,24,75,6,10,4,6,29,66,21,1
493,Franco Minerva,ar ARG,"MF,FW",Platense,,18.92876712,2006,1.3,5,3,1,3,1,2,4,50,2,0,0,0,2,7,8,0
494,Facundo Miño,ar ARG,DF,Deportivo Riestra,,25.55068493,1999,7.5,15,11,10,5,0,8,13,61.5,5,8,4,4,9,24,46,0
495,Ignacio Miramon,ar ARG,"MF,FW",Boca Juniors,,21.89589041,2003,1.1,7,5,2,5,0,4,6,66.7,2,2,0,2,1,8,3,0
496,Leonel Miranda,ar ARG,MF,Banfield,,31.32328767,1994,1.3,6,3,3,2,1,2,6,33.3,4,1,0,1,1,7,1,0
497,Matías Miranda,ar ARG,FW,Defensa y Just,,25,2000,2.9,8,4,1,7,0,4,4,100,0,4,0,4,1,9,7,0
498,Juan Miritello,ar ARG,FW,Defensa y Just,,26.23561644,1999,6,4,2,1,2,1,0,1,0,1,1,1,0,0,4,7,0
499,Agustín Molina,ar ARG,FW,Sarmiento,,18.82191781,2006,0.4,0,0,0,0,0,0,1,0,1,1,0,1,0,0,0,0
500,Alejandro Molina,ar ARG,DF,San Martín de San Juan,,27.73424658,1997,11.3,29,21,13,14,2,16,29,55.2,13,16,5,11,6,35,42,0
501,Tomás Molina,ar ARG,FW,Arg Juniors,,30.0630137,1995,12.9,23,16,3,15,5,5,15,33.3,10,9,1,8,0,23,5,0
502,Manuel Mónaco,ar ARG,MF,Sarmiento,,22.98356164,2002,0.1,0,0,0,0,0,0,0,,0,0,0,0,0,0,0,0
503,Pablo Monje,ar ARG,MF,Deportivo Riestra,,28.24109589,1997,6.6,17,12,7,10,0,12,20,60,8,4,0,4,11,28,10,0
504,Ezequiel Montagna,ar ARG,"MF,FW",San Martín de San Juan,,30.90684932,1994,1.9,1,0,1,0,0,0,3,0,3,0,0,0,1,2,4,0
505,Alejo Montero,ar ARG,DF,Newell's OB,,27,1998,12.1,32,21,18,9,5,15,27,55.6,12,13,4,9,20,52,54,1
506,Gonzalo Montiel,ar ARG,DF,River Plate,,28.33972603,1997,10.6,18,14,13,4,1,10,14,71.4,4,6,2,4,11,29,24,0
507,Santiago Montiel,ar ARG,FW,Independiente,,24.44931507,2000,5.8,9,7,4,3,2,4,10,40,6,4,0,4,2,11,8,0
508,Álvaro Montoro,ar ARG,"FW,MF",Vélez Sarsfield,,18.04931507,2007,7.7,9,5,3,2,4,5,10,50,5,13,1,12,7,16,4,0
509,Iván Morales Bravo,cl CHI,FW,Sarmiento,,25.76712329,1999,11.6,3,1,2,1,0,1,7,14.3,6,6,1,5,1,4,3,0
510,Gonzalo Morales,ar ARG,"FW,MF",Barracas Central,,22.16986301,2003,6.2,3,2,0,2,1,1,3,33.3,2,5,0,5,0,3,1,0
511,Lautaro Morales,ar ARG,GK,Lanús,,25.38356164,1999,1,0,0,0,0,0,0,0,,0,0,0,0,0,0,0,0
512,Leonardo Morales,ar ARG,DF,Gimnasia–LP,,34.06575342,1991,15.8,22,13,16,6,0,15,25,60,10,17,11,6,24,46,132,1
513,Santiago Morales,,DF,Sarmiento,,0,,6.5,14,6,8,6,0,11,12,91.7,1,13,5,8,11,25,50,0
514,Juan Morán,ar ARG,DF,Godoy Cruz,,18.81917808,2006,4.2,16,8,8,6,2,8,10,80,2,6,2,4,3,19,22,0
515,Junior Moreno,ve VEN,MF,Gimnasia–LP,,31.79178082,1993,1.1,1,1,0,1,0,1,2,50,1,1,0,1,0,1,2,0
516,Marcelino Moreno,ar ARG,MF,Lanús,,30.86027397,1994,14.9,14,10,4,6,4,5,15,33.3,10,5,0,5,7,21,1,0
517,Valentín Moreno,ar ARG,DF,Tigre,,22.20547945,2003,1,2,2,1,1,0,1,3,33.3,2,0,0,0,3,5,0,0
518,Stéfano Moreyra,ar ARG,MF,Instituto,,23.62465753,2001,4.6,14,11,7,7,0,7,16,43.8,9,5,3,2,7,21,15,0
519,Joaquín Mosqueira,ar ARG,MF,Talleres,,20.50684932,2004,4.8,12,7,3,9,0,6,10,60,4,5,1,4,9,21,14,0
520,Gonzalo Mottes,ar ARG,DF,Aldosivi,,27.32328767,1998,15,9,6,7,2,0,5,8,62.5,3,13,6,7,13,22,98,0
521,Santiago Moyano,ar ARG,"DF,MF",Cen. Córdoba–SdE,,27.61369863,1997,8.5,20,15,8,10,2,14,19,73.7,5,15,4,11,10,30,14,0
522,Iker Muniain,es ESP,MF,San Lorenzo,,32.37534247,1992,5.7,4,4,0,4,0,2,4,50,2,3,0,3,2,6,0,0
523,Ezequiel Muñoz,ar ARG,DF,Lanús,,34.57260274,1990,7,8,2,5,3,0,3,6,50,3,9,5,4,16,24,58,0
524,Facundo Mura,ar ARG,DF,Racing Club,,26.11780822,1999,4.9,5,5,3,1,1,2,6,33.3,4,7,2,5,4,9,9,0
525,Yaison Murillo,co COL,MF,Deportivo Riestra,,31.46849315,1993,0.1,1,1,1,0,0,1,1,100,0,0,0,0,0,1,1,0
526,Juan Nardoni,ar ARG,MF,Racing Club,,22.80821918,2002,11.1,23,12,10,12,1,8,13,61.5,5,14,1,13,20,43,19,0
527,Tomás Nasif,ar ARG,FW,Banfield,,21.3369863,2004,6.1,1,0,0,1,0,0,3,0,3,4,0,4,1,2,4,0
528,Federico Navarro,ar ARG,MF,Rosario Central,,25.15616438,2000,11.2,33,17,14,18,1,11,21,52.4,10,9,3,6,10,43,26,0
529,Miguel Navarro,ve VEN,DF,Talleres,,26.18630137,1999,11.9,11,8,8,3,0,4,6,66.7,2,8,5,3,11,22,50,0
530,Keylor Navas,cr CRC,GK,Newell's OB,,38.38630137,1986,14,0,0,0,0,0,0,0,,0,0,0,0,0,0,7,0
531,Ignacio Neira,uy URU,MF,Tigre,,27.24109589,1998,0.1,0,0,0,0,0,0,0,,0,0,0,0,0,0,0,0
532,Gabriel Neves,uy URU,MF,Estudiantes–LP,,27.73150685,1997,11.5,28,15,9,18,1,19,38,50,19,15,4,11,15,43,23,1
533,Franco Nicola,uy URU,MF,Atlé Tucumán,,23.04657534,2002,6.5,5,3,2,2,1,1,4,25,3,2,0,2,5,10,5,0
534,Roberto Nicolás Fernández,uy URU,MF,Godoy Cruz,,27.17534247,1998,11.9,27,21,9,16,2,10,21,47.6,11,14,1,13,8,35,26,1
535,Gonzalo Nicolás Martínez,ar ARG,"MF,FW",River Plate,,31.89315068,1993,2.8,0,0,0,0,0,0,2,0,2,3,0,3,3,3,0,0
536,Aaron Nicolás Molinas,ar ARG,MF,Defensa y Just,,24.75616438,2000,10.4,15,9,5,8,2,9,12,75,3,14,0,14,3,18,6,0
537,Santiago Núñez,ar ARG,DF,Estudiantes–LP,,25.01643836,2000,12.1,24,17,19,5,0,14,20,70,6,22,18,4,33,57,92,2
538,Tomás O'Connor,ar ARG,MF,Rosario Central,,21.11232877,2004,2.4,8,6,2,6,0,3,6,50,3,4,1,3,1,9,3,0
539,Agustín Obando,ar ARG,MF,Banfield,,25.15068493,2000,0.8,0,0,0,0,0,0,0,,0,1,0,1,0,0,1,0
540,Gabriel Obredor,ar ARG,"MF,FW",Deportivo Riestra,,28.3260274,1997,1.6,2,2,1,1,0,0,1,0,1,2,0,2,0,2,7,0
541,Pedro Ojeda,ar ARG,MF,Huracán,,27.49589041,1997,4.5,9,4,3,6,0,5,11,45.5,6,8,2,6,13,22,3,0
542,Gino Olguín,ar ARG,MF,San Martín de San Juan,,25.14520548,2000,1.8,9,3,5,4,0,2,6,33.3,4,4,0,4,1,10,2,0
543,Nicolás Omar Goitea,ar ARG,DF,Huracán,,27.89863014,1997,1.3,2,1,1,1,0,0,0,,0,0,0,0,1,3,4,1
544,Óctavio Ontivero,ar ARG,DF,Lanús,,19.31506849,2006,0.8,1,1,1,0,0,0,1,0,1,0,0,0,3,4,2,0
545,Christian Ordoñez,ar ARG,MF,Vélez Sarsfield,,20.78082192,2004,12.6,38,19,14,20,4,20,32,62.5,12,14,2,12,13,51,19,0
546,Matías Orihuela,ar ARG,DF,Atlé Tucumán,,33.2109589,1992,5.4,15,6,9,6,0,10,13,76.9,3,3,1,2,8,23,21,0
547,Renzo Orihuela,uy URU,DF,Sarmiento,,24.08493151,2001,11.6,17,8,9,5,3,6,17,35.3,11,19,8,11,18,35,59,0
548,Nicolás Oróz,ar ARG,MF,Arg Juniors,,31.09315068,1994,12.9,25,15,9,15,1,13,27,48.1,14,12,1,11,12,37,13,0
549,Franco Orozco,ar ARG,FW,Lanús,,23.31780822,2002,2.3,5,5,2,3,0,3,9,33.3,6,3,0,3,3,8,3,0
550,Nicolás Orsini,ar ARG,FW,Platense,,30.64383562,1994,2.4,2,2,1,0,1,0,0,,0,0,0,0,0,2,1,0
551,Martín Ortega,ar ARG,DF,Tigre,,25.70684932,1999,9.8,17,9,8,8,1,7,13,53.8,6,3,0,3,6,23,27,0
552,Thomas Ortega,ar ARG,"MF,DF",Ind. Rivadavia,,24.4109589,2000,4.1,7,5,3,2,2,3,8,37.5,5,10,0,10,3,10,8,0
553,Diego Ortegoza,cl CHI,MF,Talleres,,28.04383562,1997,9,28,16,13,12,3,9,21,42.9,12,10,3,7,3,31,20,0
554,Kevin Ortíz,ar ARG,MF,Rosario Central,,24.62739726,2000,0.8,3,3,1,2,0,2,2,100,0,2,0,2,2,5,2,0
555,Marcelo Ortiz,ar ARG,DF,Atlé Tucumán,,31.30684932,1994,1.6,0,0,0,0,0,0,0,,0,0,0,0,2,2,8,0
556,Sergio Ortíz,ar ARG,MF,Deportivo Riestra,,24.19452055,2001,0.1,1,0,0,1,0,1,1,100,0,1,1,0,0,1,0,0
557,Alejo Osella,ar ARG,DF,Ind. Rivadavia,,24.59452055,2000,4.9,9,4,3,6,0,5,9,55.6,4,6,0,6,6,15,25,0
558,Abiel Osorio,ar ARG,FW,Defensa y Just,,22.89315068,2002,9.4,2,2,0,1,1,1,1,100,0,8,2,6,1,3,16,0
559,Tobías Ostchega,ar ARG,DF,Belgrano,,26.69315068,1998,6.3,10,6,6,4,0,8,12,66.7,4,2,1,1,4,14,34,0
560,Alfio Oviedo,py PAR,FW,Tigre,,29.37808219,1995,2.5,4,2,0,2,2,1,1,100,0,4,0,4,0,4,3,0
561,Brandon Oviedo,ar ARG,DF,Banfield,,20.2739726,2005,1,2,1,1,0,1,1,1,100,0,0,0,0,3,5,3,0
562,Tobías Palacio,ar ARG,DF,Arg Juniors,,18.47945205,2006,1.3,1,0,0,1,0,1,1,100,0,3,2,1,3,4,7,0
563,Carlos Palacios,cl CHI,MF,Boca Juniors,,24.79178082,2000,10.8,10,7,5,2,3,6,13,46.2,7,8,2,6,2,12,12,1
564,Julián Palacios,ar ARG,"MF,FW",Unión,,26.24657534,1999,6.3,6,4,0,4,2,3,12,25,9,9,0,9,4,10,4,0
565,Sebastián Palacios,ar ARG,FW,Talleres,,33.28767123,1992,4.9,4,2,1,3,0,1,3,33.3,2,2,0,2,1,5,0,0
566,Tiago Palacios,uy URU,"FW,MF",Estudiantes–LP,,24.10410959,2001,13.1,19,12,1,12,6,5,20,25,15,17,1,16,7,26,7,0
567,Agustín Palavecino,ar ARG,"FW,MF",Aldosivi,,22.15616438,2003,6.6,24,11,7,11,6,9,13,69.2,4,11,0,11,2,26,10,0
568,Nicolás Palavecino,ar ARG,"MF,FW",Defensa y Just,,22.10136986,2003,1.2,6,6,3,3,0,3,4,75,1,1,1,0,0,6,0,0
569,Manuel Panaro Miramon,ar ARG,FW,Gimnasia–LP,,23.18082192,2002,5.8,8,6,1,4,3,6,7,85.7,1,3,0,3,5,13,9,0
570,Federico Paradela,ar ARG,MF,Sarmiento,,25.85479452,1999,3.6,5,3,1,3,1,2,4,50,2,0,0,0,1,6,2,0
571,Franco Paredes,ar ARG,DF,Independiente,,26.13150685,1999,2.1,2,2,0,2,0,1,1,100,0,0,0,0,3,5,11,0
572,Gabriel Paredes,ar ARG,DF,Aldosivi,,21.39452055,2003,0.1,2,2,1,1,0,1,2,50,1,1,0,1,0,2,0,0
573,Kevin Parzajuk,py PAR,FW,Godoy Cruz,,22.65205479,2002,6.3,5,1,0,3,2,2,3,66.7,1,2,0,2,2,7,4,0
574,Luciano Pascual,,"FW,MF",Godoy Cruz,,0,,2.2,1,1,0,1,0,0,1,0,1,1,0,1,1,2,1,0
575,Lucas Passerini,ar ARG,"FW,MF",Belgrano,,30.80273973,1994,6.7,5,3,0,4,1,1,2,50,1,3,2,1,0,5,11,0
576,Cristian Paz,ar ARG,DF,Deportivo Riestra,,30.03013699,1995,16,30,18,21,7,2,20,30,66.7,10,24,13,11,11,41,136,0
577,Nehuén Paz,ar ARG,DF,Tigre,,32.01917808,1993,16,13,8,8,5,0,7,9,77.8,2,15,10,5,14,27,115,1
578,Nicolás Paz,ar ARG,DF,Unión,,22.55068493,2002,3.7,8,6,5,3,0,2,6,33.3,4,6,4,2,5,13,23,0
579,Mauro Peinipil,ar ARG,DF,Ind. Rivadavia,,26.08767123,1999,7.3,11,8,8,2,1,8,13,61.5,5,5,2,3,8,19,26,2
580,Nicolás Pelaitay,ar ARG,MF,San Martín de San Juan,,32.35342466,1992,9.2,20,10,10,9,1,11,19,57.9,8,8,3,5,7,27,14,0
581,Matías Pellegrini,ar ARG,"FW,MF",Vélez Sarsfield,,24.98356164,2000,4.6,7,4,1,5,1,3,9,33.3,6,2,0,2,2,9,2,0
582,Marco Pellegrino,ar ARG,DF,Huracán,,22.79726027,2002,14.2,20,14,14,6,0,10,19,52.6,9,22,16,6,14,34,108,0
583,Mateo Pellegrino,ar ARG,FW,Vélez Sarsfield,,24.17808219,2001,0.4,0,0,0,0,0,0,0,,0,0,0,0,0,0,0,0
584,Felipe Peña,ar ARG,MF,Lanús,,24.08219178,2001,4.1,5,2,0,4,1,3,6,50,3,9,3,6,6,11,10,0
585,Jaime Peralta,co COL,"FW,MF",San Lorenzo,,20.25753425,2005,1.1,2,1,0,0,2,0,1,0,1,1,0,1,0,2,1,0
586,Matías Perelló,ar ARG,"FW,MF",Cen. Córdoba–SdE,,23.4630137,2001,6.6,11,7,3,5,3,6,11,54.5,5,8,0,8,1,12,4,0
587,Elías Pereyra,ar ARG,DF,Instituto,,26.21643836,1999,6.1,8,6,5,2,1,4,9,44.4,5,15,5,10,4,12,23,0
588,Fabio Pereyra,ar ARG,DF,Huracán,,35.25753425,1990,15.3,7,4,4,3,0,4,12,33.3,8,19,12,7,14,21,117,0
589,César Pérez,cl CHI,MF,Defensa y Just,,22.43013699,2002,9.6,14,9,5,7,2,7,23,30.4,16,14,2,12,8,22,14,0
590,Damián Pérez,ar ARG,DF,Defensa y Just,,36.36712329,1988,2.5,4,1,3,1,0,1,3,33.3,2,3,0,3,6,10,8,1
591,Enzo Pérez,ar ARG,MF,River Plate,,39.19726027,1986,11,31,23,8,21,2,12,20,60,8,6,1,5,31,62,23,1
592,Fabricio Pérez,ar ARG,"MF,FW",Estudiantes–LP,,19.40821918,2005,0.7,3,1,1,2,0,2,3,66.7,1,1,0,1,1,4,0,0
593,Gonzalo Pérez,uy URU,DF,Lanús,,24.33150685,2001,7.5,14,13,11,2,1,10,23,43.5,13,11,1,10,10,24,33,0
594,Juan Pérez,co COL,"MF,FW",Godoy Cruz,,20.77808219,2004,2.4,2,2,0,1,1,0,0,,0,3,0,3,2,4,2,0
595,Leonel Pérez,ar ARG,MF,Huracán,,20.7369863,2004,13.6,35,25,15,20,0,17,22,77.3,5,16,1,15,23,58,38,0
596,Edwuin Pernía,ve VEN,"FW,MF",San Martín de San Juan,,30.22465753,1995,1.9,0,0,0,0,0,0,0,,0,1,0,1,0,0,0,0
597,Patricio Pernicone,ar ARG,DF,Vélez Sarsfield,,23.83561644,2001,2.5,3,1,2,1,0,3,4,75,1,3,1,2,2,5,9,0
598,Ignacio Perruzzi,ar ARG,MF,San Lorenzo,,20.08219178,2005,1,4,4,0,4,0,3,5,60,2,0,0,0,1,5,0,0
599,Franco Petroli,ar ARG,GK,Godoy Cruz,,26.89863014,1998,16,0,0,0,0,0,0,0,,0,0,0,0,0,0,14,1
600,Germán Pezzella,ar ARG,DF,River Plate,,33.85479452,1991,11.9,11,7,6,4,1,7,8,87.5,1,9,5,4,14,25,73,0
601,Leonel Picco,ar ARG,MF,Platense,,25.53424658,1999,14.3,52,29,25,21,6,25,36,69.4,11,16,3,13,17,69,19,0
602,Alejandro Piedrahita,co COL,"FW,MF",Gimnasia–LP,,22.66849315,2002,6.6,10,8,5,3,2,3,13,23.1,10,3,0,3,4,14,8,0
603,Juan Pignani,ar ARG,DF,Platense,,23.84109589,2001,1,2,1,2,0,0,0,1,0,1,2,1,1,0,2,8,0
604,Iván Pillud,ar ARG,"DF,MF",Cen. Córdoba–SdE,,39.03013699,1986,4,8,5,4,4,0,6,8,75,2,4,1,3,5,13,11,1
605,Gonzalo Piñeiro,ar ARG,MF,Tigre,,24.58630137,2000,0,0,0,0,0,0,0,0,,0,0,0,0,0,0,0,0
606,Lisandro Piñero,ar ARG,"MF,DF",Banfield,,17.80547945,2007,0.7,3,1,2,1,0,2,2,100,0,1,0,1,0,3,0,0
607,Martín Pino,ar ARG,FW,Godoy Cruz,,27.1369863,1998,0.6,0,0,0,0,0,0,0,,0,0,0,0,0,0,0,0
608,Juan Pintado,uy URU,DF,Gimnasia–LP,,30.76986301,1994,14.2,33,19,18,10,5,11,21,52.4,10,14,3,11,12,45,40,2
609,Lucas Piovi,ar ARG,MF,Estudiantes–LP,,32.70684932,1992,3.9,7,5,1,6,0,5,8,62.5,3,1,0,1,6,13,9,1
610,Bruno Pittón,ar ARG,DF,Unión,,32.25479452,1993,6.9,13,10,8,2,3,5,7,71.4,2,10,1,9,4,17,19,0
611,Mauro Pittón,ar ARG,MF,Unión,,30.73972603,1994,9.2,19,8,6,10,3,7,16,43.8,9,13,2,11,10,29,14,0
612,Francisco Pizzini,ar ARG,"FW,MF",Vélez Sarsfield,,31.62465753,1993,7.6,10,8,3,3,4,6,13,46.2,7,12,1,11,4,14,5,0
613,Joaquín Plaza,ar ARG,"FW,MF",Newell's OB,,20.78356164,2004,0.8,0,0,0,0,0,0,0,,0,0,0,0,0,0,0,0
614,Vicente Poggi,uy URU,MF,Godoy Cruz,,22.81643836,2002,8.4,39,23,10,25,4,15,26,57.7,11,17,3,14,13,52,9,0
615,Joaquín Pombo,ar ARG,DF,Banfield,,24.13150685,2001,12.7,15,10,12,3,0,9,10,90,1,8,4,4,10,25,91,0
616,Diego Porcel,ar ARG,FW,Arg Juniors,,20.28493151,2005,0.3,1,0,0,0,1,0,1,0,1,1,1,0,1,2,2,0
617,Maximiliano Porcel,ar ARG,MF,Vélez Sarsfield,,19.3369863,2006,2.8,6,2,3,3,0,3,6,50,3,1,0,1,0,6,1,0
618,Tomás Porra,ar ARG,"MF,FW",Barracas Central,,21.31780822,2004,2.9,2,2,1,0,1,1,4,25,3,3,0,3,1,3,6,0
619,Ayrton Portillo,ar ARG,"MF,DF",San Martín de San Juan,,24.71232877,2000,10.4,13,6,1,7,5,6,11,54.5,5,10,2,8,7,20,23,1
620,Juan Portillo,ar ARG,DF,Talleres,,24.96438356,2000,13,30,25,23,7,0,14,15,93.3,1,22,10,12,16,46,64,2
621,Marcos Portillo,ar ARG,MF,Talleres,,25.25753425,2000,1.8,6,5,2,3,1,3,4,75,1,1,0,1,1,7,3,0
622,Tomás Pozzo,ar ARG,MF,Godoy Cruz,,24.60273973,2000,2.5,4,1,3,0,1,2,4,50,2,4,0,4,0,4,2,0
623,Ayrton Preciado,ec ECU,"FW,MF",Aldosivi,,30.8,1994,6.2,9,6,2,5,2,2,3,66.7,1,6,1,5,3,12,3,0
624,Sebastián Prieto,ar ARG,DF,Arg Juniors,,32.07123288,1993,10.6,25,17,15,8,2,14,32,43.8,18,17,4,13,11,36,39,0
625,Rafael Profini,ar ARG,MF,Unión,,21.65205479,2003,8.5,23,17,10,11,2,11,16,68.8,5,11,1,10,9,32,16,0
626,Damián Puebla,ar ARG,"MF,FW",Instituto,,22.63561644,2002,6.7,14,8,4,7,3,8,13,61.5,5,14,1,13,2,16,6,1
627,Maximiliano Puig,ar ARG,FW,Barracas Central,,24.62739726,2000,0.2,2,2,0,0,2,2,2,100,0,0,0,0,1,3,0,0
628,Nicolás Quagliata,uy URU,"MF,FW",Cen. Córdoba–SdE,,25.91506849,1999,4.8,8,4,0,5,3,3,6,50,3,6,0,6,4,12,1,0
629,Facundo Quignon,ar ARG,MF,Belgrano,,32.00821918,1993,7.9,26,9,10,14,2,12,21,57.1,9,8,3,5,12,38,19,0
630,Carlos Quintana,ar ARG,DF,Rosario Central,,37.22739726,1988,12.2,16,11,12,4,0,9,13,69.2,4,19,15,4,14,30,79,0
631,Aaron Quirós,ar ARG,DF,Vélez Sarsfield,,23.50958904,2001,6.6,13,8,8,4,1,10,14,71.4,4,1,1,0,12,25,39,0
632,Santiago Quiros,ar ARG,DF,Racing Club,,22.16986301,2003,6.7,5,2,5,0,0,4,8,50,4,5,2,3,11,16,31,1
633,Leandro Quiroz,ar ARG,DF,Godoy Cruz,,21.29863014,2004,1,0,0,0,0,0,0,1,0,1,1,1,0,0,0,3,0
634,Yonatthan Rak,uy URU,DF,Barracas Central,,31.71232877,1993,8,15,10,7,7,1,9,10,90,1,18,10,8,8,23,38,1
635,Franco Rami,ar ARG,FW,Aldosivi,,22.09589041,2003,4,5,5,0,5,0,0,0,,0,5,0,5,1,6,5,0
636,Eric Ramírez,ve VEN,FW,Tigre,,26.45479452,1998,1.6,0,0,0,0,0,0,1,0,1,2,0,2,1,1,1,0
637,Eric Ramírez,ar ARG,FW,Huracán,,28.61917808,1996,9.3,6,2,0,3,3,1,9,11.1,8,8,1,7,1,7,8,0
638,Juan Ramírez,ar ARG,"MF,FW",Lanús,,31.94520548,1993,3.4,4,3,2,1,1,2,5,40,3,2,0,2,3,7,2,0
639,Mateo Ramírez,ar ARG,"MF,DF",Deportivo Riestra,,30.29315068,1995,0.3,1,1,0,1,0,1,3,33.3,2,1,1,0,1,2,2,0
640,Matías Ramírez,ar ARG,FW,Defensa y Just,,26.14246575,1999,4.1,10,6,5,5,0,6,12,50,6,5,0,5,2,12,8,0
641,Pedro Ramírez,ar ARG,DF,Deportivo Riestra,,25.08493151,2000,10.2,34,20,23,11,0,17,26,65.4,9,13,1,12,19,53,50,0
642,Victorio Ramis,ar ARG,FW,Ind. Rivadavia,,30.82739726,1994,5.6,8,3,1,2,5,2,3,66.7,1,4,1,3,1,9,7,0
643,Luciano Ramón Herrera,ar ARG,"FW,MF",Newell's OB,,28.92876712,1996,8.7,17,8,10,2,5,10,18,55.6,8,8,1,7,12,29,13,0
644,Luciano Ramón Herrera,ar ARG,FW,Defensa y Just,,28.92876712,1996,0.2,1,0,0,1,0,0,0,,0,0,0,0,0,1,0,0
645,Juan Randazzo,ar ARG,DF,Deportivo Riestra,,30.56438356,1994,5.2,5,2,3,2,0,3,4,75,1,7,5,2,1,6,35,0
646,Federico Rasmussen,ar ARG,DF,Godoy Cruz,,33.16986301,1992,13.7,22,15,14,7,1,10,15,66.7,5,24,9,15,21,43,104,1
647,Matías Reali,ar ARG,"MF,FW",San Lorenzo,,27.47123288,1997,11.4,14,4,5,3,6,9,24,37.5,15,15,0,15,10,24,6,0
648,Luciano Recalde,ar ARG,DF,San Martín de San Juan,,29.72876712,1995,4.6,9,5,4,5,0,5,10,50,5,5,4,1,5,14,25,1
649,Luca Regiardo,ar ARG,MF,Newell's OB,,18.53150685,2006,7.8,18,10,10,8,0,13,22,59.1,9,6,2,4,11,29,17,0
650,Josue Reinatti,ar ARG,GK,Newell's OB,,21.92328767,2003,2,0,0,0,0,0,0,0,,0,0,0,0,0,0,0,1
651,Jhon Rentería,co COL,MF,Sarmiento,,19.52876712,2005,0.5,1,1,0,1,0,1,4,25,3,0,0,0,0,1,0,0
652,Gonzalo Requena,ar ARG,DF,Instituto,,22.16986301,2003,8.3,9,7,5,4,0,4,10,40,6,4,3,1,13,22,55,1
653,Kevin Retamar,ar ARG,"MF,FW",Ind. Rivadavia,,26.24109589,1999,5.4,10,9,4,5,1,7,13,53.8,6,9,1,8,5,15,9,1
654,Camilo Rey,ar ARG,MF,Boca Juniors,,19.15342466,2006,3.4,9,4,4,4,1,6,9,66.7,3,3,1,2,7,16,5,0
655,Rodrigo Rey,ar ARG,GK,Independiente,,34.15890411,1991,16,0,0,0,0,0,0,0,,0,0,0,0,0,0,5,0
656,Bryan Reyna,pe PER,"MF,FW",Belgrano,,26.69863014,1998,5.3,6,2,2,1,3,3,11,27.3,8,6,0,6,5,11,7,0
657,Emanuel Reynoso,ar ARG,MF,Talleres,,29.46575342,1995,6.6,15,10,4,8,3,6,12,50,6,10,0,10,6,21,4,0
658,Rick,br BRA,FW,Talleres,,25.67123288,1999,5.7,4,0,1,2,1,4,6,66.7,2,6,0,6,2,6,3,0
659,Martín Río,ar ARG,MF,Banfield,,24.14246575,2001,14.5,28,15,10,17,1,14,32,43.8,18,19,9,10,24,52,48,1
660,Gonzalo Ríos,ar ARG,MF,Banfield,,26.26849315,1999,9.3,13,8,4,9,0,4,14,28.6,10,9,0,9,10,23,8,0
661,Gonzalo Ríos,ar ARG,"MF,FW",Ind. Rivadavia,,26.26849315,1999,0.8,0,0,0,0,0,0,1,0,1,0,0,0,1,1,2,0
662,Lautaro Ríos,ar ARG,MF,Banfield,,24.56986301,2000,8.7,23,15,8,12,3,15,24,62.5,9,7,1,6,13,36,27,0
663,Geronimo Rivera,ar ARG,"MF,FW",Banfield,,21.71232877,2003,9.4,15,10,8,3,4,5,16,31.3,11,9,1,8,8,23,6,0
664,Lautaro Rivero,ar ARG,DF,Cen. Córdoba–SdE,,21.50684932,2003,14,28,15,21,5,2,15,21,71.4,6,19,9,10,13,41,85,0
665,Blas Riveros,py PAR,DF,Talleres,,27.24931507,1998,7.5,16,9,11,5,0,8,20,40,12,6,2,4,4,20,21,0
666,Paul Riveros,py PAR,DF,Banfield,,27.82465753,1997,5.3,6,2,5,1,0,1,1,100,0,6,4,2,7,13,51,0
667,Agustín Rodríguez,ar ARG,"MF,FW",Lanús,,21.00821918,2004,0.9,1,1,0,1,0,1,1,100,0,1,1,0,0,1,0,0
668,Alan Rodríguez,uy URU,"MF,FW",Arg Juniors,,25.2739726,2000,12.9,24,16,12,8,4,13,23,56.5,10,7,0,7,5,29,6,0
669,Facundo Rodríguez,ar ARG,DF,Estudiantes–LP,,25.18630137,2000,5.9,6,3,4,2,0,2,5,40,3,6,6,0,8,14,32,0
670,Ignacio Rodríguez,ar ARG,"DF,MF",Racing Club,,23.19726027,2002,6,5,2,3,0,2,2,11,18.2,9,6,2,4,1,6,14,0
671,Juan Rodríguez,ar ARG,DF,Talleres,,31.18082192,1994,9.5,10,7,8,2,0,5,6,83.3,1,11,6,5,9,19,68,0
672,Lucas Rodríguez,ar ARG,DF,Instituto,,31.60273973,1993,9.9,13,9,5,5,3,8,13,61.5,5,14,5,9,7,20,26,1
673,Maximiliano Rodríguez,cl CHI,"FW,MF",Platense,,24.92876712,2000,1.8,1,0,0,0,1,0,2,0,2,0,0,0,0,1,3,0
674,Randall Rodríguez,uy URU,GK,Vélez Sarsfield,,21.43013699,2003,1,0,0,0,0,0,0,0,,0,0,0,0,0,0,0,2
675,Santiago Rodriguez,ar ARG,"MF,FW",Arg Juniors,,27.69863014,1997,1.9,8,5,4,1,3,2,5,40,3,6,0,6,1,9,1,0
676,Teo Rodríguez,ar ARG,DF,San Lorenzo,,19.56164384,2005,0,1,1,1,0,0,1,1,100,0,1,0,1,0,1,1,0
677,Manuel Roffo,ar ARG,GK,Instituto,,25.08493151,2000,16,1,0,1,0,0,1,2,50,1,0,0,0,0,1,7,0
678,Gabriel Rojas,ar ARG,DF,Racing Club,,27.86849315,1997,11,16,6,8,7,1,8,16,50,8,10,3,7,12,28,33,1
679,Matías Rojas,py PAR,"FW,MF",River Plate,,29.50136986,1995,1.2,1,0,0,1,0,0,1,0,1,0,0,0,0,1,0,0
680,Marcos Rojo,ar ARG,DF,Boca Juniors,,35.1260274,1990,9.5,14,9,7,7,0,4,5,80,1,7,4,3,12,26,61,0
681,Leonel Roldán,ar ARG,MF,Vélez Sarsfield,,20.56712329,2004,2.9,6,5,0,6,0,3,7,42.9,4,9,0,9,7,13,4,0
682,Mauricio Roldán,ar ARG,"MF,FW",Banfield,,20.23013699,2005,0.5,0,0,0,0,0,0,0,,0,0,0,0,0,0,0,0
683,Pocho Román,it ITA,FW,Independiente,,21.23013699,2004,0.4,1,1,0,0,1,1,1,100,0,0,0,0,0,1,0,0
684,Jhohan Romaña,co COL,DF,San Lorenzo,,26.64109589,1998,14.5,33,22,25,7,1,18,21,85.7,3,12,7,5,14,47,99,2
685,Braian Romero,ar ARG,FW,Vélez Sarsfield,,33.88767123,1991,13,19,10,7,9,3,5,8,62.5,3,10,2,8,3,22,12,0
686,José Romero,ar ARG,"FW,MF",Tigre,,22.11232877,2003,3.1,0,0,0,0,0,0,1,0,1,1,0,1,1,1,0,0
687,Silvio Romero,ar ARG,FW,Instituto,,36.78630137,1988,1.2,3,2,1,1,1,1,2,50,1,0,0,0,0,3,2,0
688,Facundo Roncaglia,ar ARG,DF,Sarmiento,,38.23013699,1987,11,9,8,5,3,1,4,9,44.4,5,12,10,2,14,23,72,0
689,Siro Rosane,ar ARG,MF,Barracas Central,,24.90958904,2000,7.5,16,10,7,9,0,8,16,50,8,8,4,4,7,23,16,0
690,Tomás Rossi,ar ARG,DF,Godoy Cruz,,26.04657534,1999,3.7,2,1,2,0,0,2,6,33.3,4,1,1,0,4,6,23,0
691,Tobías Rubio,ar ARG,DF,Defensa y Just,,20.77260274,2004,3,10,9,6,4,0,7,8,87.5,1,2,0,2,4,14,13,0
692,Javier Ruiz,ar ARG,"MF,FW",Barracas Central,,20.6109589,2004,8.3,9,5,4,3,2,3,10,30,7,4,0,4,1,10,0,0
693,Joaquín Ruíz,ar ARG,"MF,FW",Boca Juniors,,18.7890411,2006,0.3,1,1,1,0,0,1,1,100,0,1,0,1,1,2,1,0
694,Ramiro Ruiz,ar ARG,"MF,FW",Atlé Tucumán,,25.12328767,2000,6.7,6,2,2,3,1,2,9,22.2,7,7,1,6,4,10,13,0
695,Ignacio Russo,ar ARG,FW,Tigre,,24.39178082,2000,13.6,9,3,0,6,3,3,8,37.5,5,14,2,12,2,11,9,0
696,Juan Saborido,ar ARG,DF,Platense,,27.02739726,1998,11.5,35,23,18,10,7,18,32,56.3,14,23,6,17,11,46,42,0
697,Maximiliano Salas,ar ARG,"MF,FW",Racing Club,,27.42465753,1997,11.3,18,12,7,6,5,8,9,88.9,1,10,1,9,1,19,14,0
698,Saúl Salcedo,py PAR,DF,Newell's OB,,27.68219178,1997,10.3,17,10,13,4,0,8,8,100,0,17,9,8,14,31,81,0
699,Santiago Salle,ar ARG,"FW,MF",Independiente,,20.91780822,2004,1.5,3,2,1,2,0,2,2,100,0,1,0,1,1,4,3,0
700,Oscar Salomón,ar ARG,DF,Platense,,26.12054795,1999,15,40,25,21,18,1,25,29,86.2,4,22,13,9,32,72,124,1
701,Eduardo Salvio,ar ARG,FW,Lanús,,34.8109589,1990,12.3,17,13,7,7,3,11,22,50,11,10,1,9,13,30,13,0
702,Mario Sanabria,ar ARG,MF,Deportivo Riestra,,22.77808219,2002,4.4,7,4,2,4,1,4,9,44.4,5,5,0,5,1,8,6,0
703,Brían Sánchez,ar ARG,MF,Deportivo Riestra,,31.89863014,1993,5.5,16,11,13,2,1,10,21,47.6,11,8,0,8,8,24,4,0
704,Facundo Sánchez,ar ARG,MF,Lanús,,19.74246575,2005,0.2,0,0,0,0,0,0,0,,0,0,0,0,1,1,1,0
705,Richard Sánchez,py PAR,MF,Racing Club,,29.10136986,1996,1,1,1,0,1,0,0,0,,0,4,1,3,0,1,1,0
706,Ulises Sánchez,ar ARG,"MF,FW",Belgrano,,26.85753425,1998,3.3,6,4,2,3,1,6,9,66.7,3,6,1,5,3,9,4,0
707,Agustín Sández,py PAR,DF,Rosario Central,,24.29863014,2001,14.5,25,17,16,7,2,12,20,60,8,17,4,13,25,50,70,0
708,Facundo Sanguinetti,ar ARG,GK,Banfield,,24.17808219,2001,16,0,0,0,0,0,0,2,0,2,1,0,1,0,0,4,0
709,Nicolás Sansotre,ar ARG,DF,Deportivo Riestra,,31.65479452,1993,12.8,21,13,11,8,2,14,20,70,6,12,4,8,6,27,46,0
710,Michael Santos,uy URU,FW,Vélez Sarsfield,,32.14520548,1993,5.4,3,2,1,1,1,0,6,0,6,4,1,3,0,3,3,0
711,Marcelo Saracchi,uy URU,"DF,MF",Boca Juniors,,27.03287671,1998,4,6,5,2,3,1,4,4,100,0,3,1,2,8,14,21,0
712,Jabes Saralegui,ar ARG,"MF,FW",Tigre,,22.33972603,2003,11.1,12,8,3,6,3,3,11,27.3,8,8,0,8,9,21,11,0
713,Darío Sarmiento,ar ARG,MF,Tigre,,22.10136986,2003,0.2,0,0,0,0,0,0,0,,0,2,0,2,0,0,0,0
714,Fabrizio Sartori,ar ARG,"FW,MF",Ind. Rivadavia,,22.80547945,2002,4.5,4,2,1,1,2,1,9,11.1,8,6,0,6,0,4,3,0
715,Rodrigo Sayavedra,ar ARG,"DF,MF",Deportivo Riestra,,29.7890411,1995,4,9,8,5,3,1,5,13,38.5,8,7,1,6,3,12,26,0
716,Benjamín Schamine,ar ARG,MF,Defensa y Just,,21.52876712,2003,4.8,14,6,2,9,3,7,16,43.8,9,6,0,6,4,18,19,1
717,Ignacio Schor,ar ARG,"FW,MF",Platense,,24.75068493,2000,3.5,9,6,2,4,3,6,9,66.7,3,5,0,5,2,11,6,0
718,Augusto Schott,ar ARG,DF,Talleres,,25.29589041,2000,6.5,14,12,11,2,1,8,12,66.7,4,5,1,4,6,20,30,0
719,Lorenzo Scipioni,ar ARG,MF,Tigre,,20.44383562,2004,14.8,56,33,18,37,1,22,37,59.5,15,21,8,13,33,89,51,0
720,Alexis Segovia,ar ARG,FW,Lanús,,20.88767123,2004,6.1,8,5,2,6,0,3,7,42.9,4,8,0,8,2,10,8,0
721,Santiago Segovia,ar ARG,MF,Rosario Central,,18.10958904,2007,2.3,6,4,2,2,2,4,5,80,1,0,0,0,0,6,0,0
722,Bruno Sepúlveda,ar ARG,FW,Banfield,,32.63013699,1992,2.7,1,1,0,1,0,0,1,0,1,1,1,0,0,1,1,0
723,Leonardo Sequeira,ar ARG,FW,Huracán,,30.02465753,1995,4.4,5,4,2,3,0,2,6,33.3,4,3,0,3,1,6,5,0
724,Luis Sequeira,ar ARG,MF,Ind. Rivadavia,,22.32054795,2003,11.8,26,16,11,11,4,12,22,54.5,10,13,2,11,3,29,7,0
725,Tiago Serrago,ar ARG,"FW,MF",Aldosivi,,21.24383562,2004,4.9,6,3,2,2,2,5,8,62.5,3,6,0,6,0,6,4,0
726,Agustín Seyral,ar ARG,MF,Sarmiento,,20.25753425,2005,0.1,0,0,0,0,0,0,0,,0,1,0,1,0,0,4,0
727,Agustín Sienra,ar ARG,DF,Defensa y Just,,25.80821918,1999,1,5,2,5,0,0,3,5,60,2,2,1,1,2,7,13,0
728,Tomás Silva,ar ARG,DF,Platense,,22.15890411,2003,8.8,25,7,17,4,4,12,23,52.2,11,11,5,6,14,39,33,0
729,Pedro Silva Torrejón,ar ARG,DF,Gimnasia–LP,,28.2739726,1997,14,26,14,13,10,3,13,22,59.1,9,24,6,18,24,50,66,0
730,Thiago Silvero,ar ARG,DF,Vélez Sarsfield,,19.04657534,2006,1.5,3,2,2,1,0,2,4,50,2,4,4,0,3,6,8,0
731,Mateo Silvetti,ar ARG,"FW,MF",Newell's OB,,19.30410959,2006,12.1,12,7,3,8,1,7,19,36.8,12,9,0,9,6,18,15,0
732,Santiago Simón,ar ARG,MF,River Plate,,22.89315068,2002,5.4,22,13,2,15,5,4,12,33.3,8,3,0,3,3,25,8,0
733,Augusto Solari,ar ARG,"MF,FW",Rosario Central,,33.33424658,1992,2.3,12,7,5,6,1,7,11,63.6,4,3,1,2,0,12,6,0
734,Pablo Solari,ar ARG,MF,River Plate,,24.12054795,2001,0.2,1,0,0,0,1,1,1,100,0,1,0,1,0,1,0,0
735,Santiago Solari,ar ARG,"MF,FW",Racing Club,,27.29041096,1998,6.5,12,6,1,11,0,3,6,50,3,1,0,1,0,12,3,1
736,Alan Sosa,ar ARG,"FW,MF",Gimnasia–LP,,22,2003,7.5,22,14,13,4,5,7,18,38.9,11,8,0,8,7,29,10,0
737,Diego Sosa,ar ARG,DF,Tigre,,27.76986301,1997,2.6,8,6,4,3,1,4,9,44.4,5,0,0,0,3,11,21,0
738,Ismael Sosa,ar ARG,"FW,MF",Arg Juniors,,38.29315068,1987,2.5,6,2,0,3,3,2,4,50,2,2,0,2,2,8,0,0
739,José Sosa,ar ARG,"MF,FW",Estudiantes–LP,,39.87671233,1985,5.7,9,6,2,6,1,5,11,45.5,6,7,0,7,2,11,2,0
740,Luca Sosa,ar ARG,DF,Newell's OB,,30.89863014,1994,2.7,3,3,1,2,0,2,2,100,0,3,0,3,5,8,16,0
741,Santiago Sosa,ar ARG,"DF,MF",Racing Club,,26.00547945,1999,10,26,16,13,11,2,14,20,70,6,10,5,5,32,58,57,1
742,Santiago Sosa,ar ARG,MF,Defensa y Just,,20.26027397,2005,0.5,1,1,1,0,0,0,2,0,2,0,0,0,0,1,2,0
743,David Sotelo,ar ARG,MF,Newell's OB,,21.76438356,2003,5,16,10,7,9,0,9,15,60,6,10,3,7,6,22,10,2
744,Alexis Soto,ar ARG,DF,Defensa y Just,,31.53972603,1993,13.5,34,25,23,8,3,19,41,46.3,22,23,9,14,24,58,38,2
745,Pedro Souto,ar ARG,DF,Ind. Rivadavia,,25,2000,3.7,9,7,7,2,0,3,5,60,2,3,1,2,1,10,17,0
746,Adrián Sporle,ar ARG,DF,Independiente,,29.8109589,1995,8,16,6,8,7,1,9,15,60,6,10,2,8,14,30,20,0
747,Sheyko Studer,ar ARG,DF,Ind. Rivadavia,,22.47671233,2002,14.6,18,13,15,1,2,11,13,84.6,2,22,18,4,18,36,114,0
748,Facundo Suárez,ar ARG,FW,Instituto,,30.84383562,1994,3.8,1,0,0,1,0,0,3,0,3,1,0,1,4,5,5,0
749,Ian Subiabre,ar ARG,FW,River Plate,,18.33972603,2007,2.5,2,2,1,1,0,2,4,50,2,5,0,5,0,2,2,0
750,Leandro Suhr,uy URU,"MF,FW",Sarmiento,,27.6109589,1997,8.4,11,5,3,5,3,3,7,42.9,4,7,0,7,6,17,8,0
751,Gastón Suso,ar ARG,DF,Gimnasia–LP,,34.14794521,1991,13.2,20,14,16,4,0,9,17,52.9,8,16,10,6,19,39,132,0
752,Alejo Tabares,ar ARG,"DF,MF",Newell's OB,,23.8739726,2001,6.9,8,3,5,2,1,6,8,75,2,7,4,3,8,16,23,1
753,Enzo Taborda,ar ARG,FW,Independiente,,19.95890411,2005,1,1,1,0,1,0,1,2,50,1,3,0,3,1,2,0,0
754,Vicente Taborda,ar ARG,"FW,MF",Platense,,23.88493151,2001,13.2,23,10,6,14,3,8,19,42.1,11,14,0,14,5,28,4,0
755,Matías Tagliamonte,ar ARG,GK,Unión,,27.20547945,1998,2,0,0,0,0,0,0,0,,0,0,0,0,0,0,0,0
756,Gonzalo Tapia,cl CHI,"FW,MF",River Plate,,23.20821918,2002,1.8,0,0,0,0,0,0,1,0,1,2,0,2,0,0,3,0
757,Ignacio Tapia,ar ARG,FW,Barracas Central,,20.6739726,2004,0.1,0,0,0,0,0,0,0,,0,0,0,0,0,0,0,0
758,Iván Tapia,ar ARG,MF,Barracas Central,,26.44657534,1998,10.8,5,0,2,3,0,4,11,36.4,7,6,1,5,7,12,4,0
759,Cristian Tarragona,ar ARG,"FW,MF",Talleres,,34.07123288,1991,2.8,3,2,0,3,0,1,3,33.3,2,1,0,1,0,3,3,0
760,Diego Tarzia,ar ARG,"FW,MF",Independiente,,22.02465753,2003,10.7,23,16,8,9,6,10,16,62.5,6,13,2,11,4,27,11,1
761,Renzo Tesuri,ar ARG,MF,Atlé Tucumán,,28.90958904,1996,2,2,1,1,1,0,2,2,100,0,4,1,3,0,2,2,0
762,Horacio Tijanovich,ar ARG,"MF,FW",San Martín de San Juan,,29.18082192,1996,3.1,5,5,4,1,0,3,4,75,1,3,0,3,1,6,3,0
763,Fabricio Tirado,ar ARG,"MF,DF",Newell's OB,,20.62739726,2004,0.7,1,1,0,1,0,0,0,,0,2,0,2,2,3,0,0
764,Matías Tissera,ar ARG,FW,Huracán,,28.66027397,1996,3.7,2,2,1,0,1,0,4,0,4,2,0,2,0,2,2,0
765,Fernando Tobio,ar ARG,DF,Barracas Central,,35.54520548,1989,14,10,9,9,1,0,6,7,85.7,1,11,8,3,9,19,109,1
766,Gastón Togni,ar ARG,FW,Defensa y Just,,27.62191781,1997,9.8,5,2,1,2,2,0,3,0,3,4,2,2,4,9,12,0
767,Franco Toloza,ar ARG,FW,San Martín de San Juan,,30.9890411,1994,5.9,4,3,0,2,2,2,4,50,2,4,0,4,1,5,7,0
768,Santiago Toloza,ar ARG,"FW,MF",Platense,,22.51780822,2002,0.6,0,0,0,0,0,0,1,0,1,1,0,1,0,0,0,0
769,Diego Tonetto,ar ARG,MF,Ind. Rivadavia,,36.41369863,1988,3.2,6,3,2,3,1,5,6,83.3,1,3,2,1,4,10,4,0
770,Elías Torres,ar ARG,FW,Aldosivi,,24.10684932,2001,14.5,23,18,0,13,10,8,14,57.1,6,15,0,15,3,26,17,0
771,Gonzalo Trindade,ar ARG,"DF,MF",Cen. Córdoba–SdE,,20.97534247,2004,1.8,2,1,2,0,0,2,3,66.7,1,2,0,2,2,4,10,0
772,Nicolás Tripichio,ar ARG,MF,San Lorenzo,,29.32876712,1996,10.7,30,15,12,18,0,15,27,55.6,12,19,2,17,10,40,16,0
773,Mariano Troilo,ar ARG,DF,Belgrano,,21.86849315,2003,12.8,21,14,13,6,2,10,15,66.7,5,13,6,7,9,30,101,1
774,Agustín Urzi,ar ARG,"FW,MF",Huracán,,25.00273973,2000,4.5,8,3,4,2,2,4,6,66.7,2,2,0,2,1,9,3,0
775,Sebastián Valdez,ar ARG,DF,Independiente,,29.49315068,1995,14.3,20,14,13,7,0,12,24,50,12,17,5,12,17,37,73,1
776,Matías Valenti,ar ARG,DF,Ind. Rivadavia,,22.66849315,2002,4.5,13,10,10,3,0,8,12,66.7,4,7,2,5,2,15,25,0
777,Jeremías Vallejos,ar ARG,DF,Sarmiento,,22.05753425,2003,2.8,9,8,6,3,0,6,9,66.7,3,3,1,2,2,11,16,0
778,Lautaro Vargas,ar ARG,DF,Unión,,20.25479452,2005,8.4,21,14,13,7,1,14,27,51.9,13,6,2,4,10,31,26,0
779,Ignacio Vázquez,ar ARG,DF,Platense,,27.88767123,1997,16,36,24,23,13,0,22,35,62.9,13,24,13,11,23,59,101,0
780,Kevin Vázquez,ar ARG,MF,Vélez Sarsfield,,24.12876712,2001,3.4,12,8,2,9,1,6,8,75,2,4,0,4,2,14,3,0
781,Cristian Vega,ar ARG,"MF,FW",Cen. Córdoba–SdE,,31.63013699,1993,1.3,5,4,4,1,0,1,4,25,3,1,0,1,4,9,2,0
782,Gabriel Vega,ar ARG,MF,Banfield,,23.04657534,2002,2.9,8,2,4,3,1,4,10,40,6,8,0,8,3,11,0,0
783,Román Vega,ar ARG,"DF,MF",Arg Juniors,,21.33972603,2004,7.9,11,8,7,3,1,5,13,38.5,8,9,0,9,4,15,20,0
784,Alan Velasco,ar ARG,"MF,FW",Boca Juniors,,22.77260274,2002,5.6,11,5,6,3,2,8,11,72.7,3,9,0,9,2,13,6,0
785,Juan Velazquez,ar ARG,"DF,MF",Belgrano,,20.45753425,2004,2.3,2,1,1,1,0,1,1,100,0,3,2,1,6,8,6,0
786,Federico Vera,ar ARG,DF,Independiente,,27.11506849,1998,13.5,21,14,14,5,2,10,19,52.6,9,12,3,9,16,37,28,1
787,Lionel Verde,ar ARG,MF,Unión,,20.54520548,2004,4.9,12,7,1,8,3,5,7,71.4,2,4,0,4,2,14,4,0
788,Gastón Verón,ar ARG,"FW,MF",Cen. Córdoba–SdE,,24.03287671,2001,7.7,6,3,0,4,2,3,7,42.9,4,3,0,3,2,8,2,0
789,Manuel Vicentini,ar ARG,GK,Belgrano,,35.04383562,1990,5,0,0,0,0,0,0,0,,0,0,0,0,0,0,6,0
790,Luciano Vietto,ar ARG,"MF,FW",Racing Club,,31.41369863,1993,6.8,7,1,2,3,2,1,11,9.1,10,5,0,5,5,12,0,0
791,Alex Vigo,ar ARG,"DF,FW",Sarmiento,,26.01917808,1999,7.1,21,12,13,7,1,15,20,75,5,11,1,10,8,29,26,1
792,Sebastián Villa,co COL,FW,Ind. Rivadavia,,28.96164384,1996,15.9,8,4,2,3,3,3,8,37.5,5,10,0,10,4,12,4,0
793,Carlos Villalba,ar ARG,MF,Sarmiento,,26.79452055,1998,9.4,19,9,10,8,1,8,25,32,17,8,3,5,18,37,30,0
794,Iván Villalba,py PAR,DF,Ind. Rivadavia,,30.29041096,1995,13.1,14,8,11,3,0,11,15,73.3,4,19,14,5,11,25,58,0
795,Juan Villalba,ar ARG,DF,Gimnasia–LP,,19.13972603,2006,0.5,2,1,1,0,1,0,0,,0,1,1,0,0,2,3,0
796,Santiago Villarreal,ar ARG,"FW,MF",Gimnasia–LP,,19.45479452,2005,0.6,1,1,0,1,0,0,2,0,2,1,0,1,0,1,1,0
797,Emiliano Viveros,ar ARG,"FW,MF",Arg Juniors,,22.59452055,2002,4.7,11,6,3,5,3,4,10,40,6,4,0,4,4,15,3,0
798,Andrés Vombergar,si SVN,FW,San Lorenzo,,30.45479452,1994,13.4,9,6,0,8,1,0,4,0,4,11,0,11,1,10,21,0
799,Franco Watson,ar ARG,MF,Huracán,,25.33972603,2000,2.2,2,1,0,1,1,1,8,12.5,7,4,0,4,3,5,1,0
800,Nicólas Watson,ar ARG,MF,San Martín de San Juan,,26.95342466,1998,7.5,25,17,12,10,3,11,25,44,14,11,2,9,5,30,13,0
801,Axel Werner,ar ARG,GK,Rosario Central,,29.18082192,1996,2,0,0,0,0,0,0,0,,0,0,0,0,0,0,1,0
802,Bastián Yañez,cl CHI,"MF,FW",Godoy Cruz,,23.87123288,2001,7.8,18,12,9,8,1,14,18,77.8,4,9,0,9,7,25,6,0
803,Daniel Zabala,ar ARG,DF,Huracán,,22.29589041,2003,1.1,1,1,1,0,0,0,1,0,1,2,2,0,0,1,3,0
804,David Zalazar,ar ARG,"MF,FW",Cen. Córdoba–SdE,,22.9890411,2002,1.5,3,1,1,2,0,0,1,0,1,1,1,0,1,4,1,0
805,Maximiliano Zalazar,ar ARG,"FW,MF",Tigre,,24.15890411,2001,1.5,3,1,3,0,0,0,2,0,2,3,0,3,1,4,0,0
806,Nicolás Zalazar,ar ARG,DF,Instituto,,28.2630137,1997,7.7,12,7,11,1,0,8,12,66.7,4,4,1,3,13,25,50,0
807,Franco Zapiola,ar ARG,"FW,MF",Platense,,24.20547945,2001,8.1,16,11,4,9,3,7,17,41.2,10,12,0,12,12,28,9,0
808,Federico Zaracho,ar ARG,MF,Racing Club,,27.15342466,1998,4.7,12,7,3,7,2,7,14,50,7,6,0,6,8,20,6,0
809,Exequiel Zeballos,ar ARG,"FW,MF",Boca Juniors,,23.03013699,2002,6.4,7,4,2,2,3,3,8,37.5,5,4,0,4,1,8,1,0
810,Gonzalo Zelarayán,ar ARG,MF,Belgrano,,21.01917808,2004,0.1,0,0,0,0,0,0,0,,0,1,0,1,0,0,0,0
811,Lucas Zelarayán,am ARM,MF,Belgrano,,32.8739726,1992,9,11,8,2,5,4,4,7,57.1,3,6,1,5,2,13,4,0
812,Felipe Zenobio,ar ARG,GK,Tigre,,24.95342466,2000,16,0,0,0,0,0,0,0,,0,0,0,0,0,0,8,0
813,Kevin Zenon,ar ARG,"MF,FW",Boca Juniors,,23.76438356,2001,9.2,14,10,6,6,2,6,8,75,2,8,2,6,3,17,9,0
814,Juan Zozaya,ar ARG,GK,Cen. Córdoba–SdE,,23.89863014,2001,2,0,0,0,0,0,0,0,,0,0,0,0,0,0,1,0
815,Bruno Zuculini,ar ARG,MF,Racing Club,,32.09041096,1993,2.3,6,3,2,3,1,1,5,20,4,2,1,1,3,9,4,0
1,Abner,br BRA,DF,Juventude,,21.04383562,2004,5.5,5,2,4,1,0,1,9,11.1,8,10,7,3,8,13,31,0
2,Nicolás Acevedo,uy URU,MF,Bahia,,26.05753425,1999,1.7,3,3,2,0,1,1,3,33.3,2,1,1,0,2,5,0,0
3,Adson,br BRA,"FW,MF",Vasco da Gama,,24.57808219,2000,1.5,1,0,0,0,1,0,0,,0,1,0,1,0,1,2,0
4,Braian Aguirre,ar ARG,DF,Internacional,,24.76986301,2000,5.9,20,10,8,8,4,14,17,82.4,3,8,1,7,6,26,22,0
5,Carlos Alberto,br BRA,"FW,DF",Sport Recife,,23.05753425,2002,2.2,2,2,1,1,0,0,0,,0,2,0,2,7,9,6,0
6,Yuri Alberto,br BRA,FW,Corinthians,,24.13150685,2001,6.5,2,1,0,0,2,2,4,50,2,1,0,1,1,3,3,0
7,José Aldo,br BRA,MF,Mirassol,,26.77808219,1998,2.9,6,6,3,3,0,4,5,80,1,3,0,3,6,12,6,0
8,Caio Alexandre,br BRA,MF,Bahia,,26.19178082,1999,4.9,13,8,4,9,0,6,16,37.5,10,8,2,6,8,21,11,0
9,Matheus Alexandre,br BRA,DF,Sport Recife,,26.07671233,1999,1.5,5,3,4,1,0,1,4,25,3,3,1,2,1,6,6,0
10,Alisson,br BRA,MF,São Paulo,,31.86027397,1993,6.3,9,4,2,6,1,5,15,33.3,10,5,5,0,5,14,7,0
11,Allan,br BRA,MF,Flamengo,,28.17260274,1997,1.2,0,0,0,0,0,0,0,,0,0,0,0,1,1,1,0
12,Allan,br BRA,MF,Palmeiras,,21.04383562,2004,0.7,6,6,4,2,0,2,2,100,0,1,0,1,1,7,5,0
13,Allan,br BRA,MF,Botafogo (RJ),,34.32054795,1991,0.1,0,0,0,0,0,0,1,0,1,1,0,1,0,0,0,0
14,Allanzinho,br BRA,"MF,FW",Fortaleza,,25.08493151,2000,1.2,1,1,1,0,0,1,1,100,0,1,1,0,2,3,0,0
15,Júnior Alonso,py PAR,DF,Atlético Mineiro,,32.23287671,1993,5.7,6,3,1,5,0,4,8,50,4,2,2,0,7,13,27,0
16,Matheus Alves,br BRA,"MF,FW",São Paulo,,20.16712329,2005,3.2,6,2,3,3,0,3,5,60,2,2,0,2,3,9,3,0
17,Francis Amuzu,be BEL,FW,Grêmio,,25.69863014,1999,3.1,4,2,2,0,2,2,2,100,0,1,0,1,0,4,1,0
18,Felipe Anderson,br BRA,"DF,MF",Palmeiras,,32.05479452,1993,4.6,10,4,7,2,1,6,11,54.5,5,6,0,6,5,15,5,1
19,Kervin Andrade,ve VEN,"FW,MF",Fortaleza,,20.06027397,2005,0.7,2,2,1,0,1,1,1,100,0,2,0,2,1,3,0,0
20,José Andrés Martínez,ve VEN,MF,Corinthians,,30.74246575,1994,2.4,4,3,2,0,2,4,6,66.7,2,2,0,2,1,5,3,1
21,Wilker Ángel,ve VEN,DF,Juventude,,32.13150685,1993,1,2,1,0,2,0,1,2,50,1,6,6,0,0,2,7,2
22,Fabrizio Angileri,ar ARG,DF,Corinthians,,31.13972603,1994,3.3,8,6,7,0,1,4,4,100,0,2,0,2,2,10,12,0
23,Anthoni,br BRA,GK,Internacional,,23.27945205,2002,6.5,0,0,0,0,0,0,0,,0,0,0,0,0,0,8,1
24,Marcos Antônio,br BRA,MF,São Paulo,,24.89315068,2000,4.9,5,2,1,4,0,3,5,60,2,3,2,1,5,10,13,0
25,Guilherme Arana,br BRA,DF,Atlético Mineiro,,28.05753425,1997,2.8,4,4,2,2,0,2,2,100,0,1,0,1,2,6,6,0
26,Luiz Araújo,br BRA,"FW,MF",Flamengo,,28.92328767,1996,1.8,7,5,2,4,1,1,1,100,0,0,0,0,0,7,1,0
27,Matheus Araújo,br BRA,"MF,FW",Ceará,,22.95342466,2002,1.8,2,0,1,1,0,0,2,0,2,1,0,1,0,2,1,0
28,Michel Araujo,uy URU,DF,Bahia,,28.6,1996,0.1,0,0,0,0,0,0,1,0,1,0,0,0,0,0,1,0
29,Alexander Aravena,cl CHI,"FW,MF",Grêmio,,22.66027397,2002,0.6,1,1,0,1,0,0,0,,0,0,0,0,0,1,1,0
30,Robert Arboleda,ec ECU,DF,São Paulo,,33.53424658,1991,3,2,1,1,1,0,1,2,50,1,8,8,0,3,5,25,0
31,Lucas Arcanjo,br BRA,GK,Vitória,,26.73972603,1998,6,0,0,0,0,0,0,0,,0,0,0,0,0,0,2,0
32,Matias Arezo,uy URU,FW,Grêmio,,22.45205479,2002,2,0,0,0,0,0,0,1,0,1,4,1,3,0,0,2,0
33,Jhon Arias,co COL,FW,Fluminense,,27.61917808,1997,7,8,6,2,1,5,3,8,37.5,5,10,0,10,2,10,2,0
34,Santiago Arias,co COL,DF,Bahia,,33.30684932,1992,0.9,1,1,1,0,0,0,1,0,1,0,0,0,1,2,2,0
35,Arthur,br BRA,FW,Sport Recife,,22.14794521,2003,2.2,0,0,0,0,0,0,0,,0,0,0,0,1,1,0,1
36,Artur,br BRA,"FW,MF",Botafogo (RJ),,27.21643836,1998,5.6,6,5,1,3,2,2,6,33.3,4,6,0,6,4,10,2,0
37,Rodrigo Atencio,ar ARG,FW,Sport Recife,,22.84657534,2002,1.5,2,0,2,0,0,2,3,66.7,1,2,0,2,0,2,1,1
38,Loide Augusto,ao ANG,"FW,MF",Vasco da Gama,,25.18630137,2000,1.6,2,2,1,1,0,0,0,,0,2,0,2,1,3,1,0
39,Leo Augusto Pereira,br BRA,"FW,MF",Vitória,,24.84931507,2000,1.4,2,2,0,2,0,0,2,0,2,0,0,0,0,2,0,0
40,Aylon,br BRA,FW,Ceará,,33.07671233,1992,2.4,6,4,1,4,1,2,6,33.3,4,6,0,6,1,7,1,0
41,Matheus Babi,br BRA,FW,Juventude,,27.79726027,1997,1,1,0,0,1,0,0,0,,0,3,0,3,1,2,3,0
42,Matheus Bahia,br BRA,DF,Ceará,,25.73150685,1999,4.9,14,7,7,5,2,10,15,66.7,5,4,2,2,5,19,23,0
43,Gabriel Baralhas,br BRA,MF,Vitória,,26.56712329,1998,4.2,3,3,1,2,0,1,4,25,3,5,2,3,5,8,11,0
44,Danilo Barbosa,br BRA,DF,Botafogo (RJ),,29.18082192,1996,0.2,0,0,0,0,0,0,0,,0,0,0,0,1,1,2,0
45,Diogo Barbosa,br BRA,"DF,FW",Fortaleza,,32.71506849,1992,2.9,6,2,4,2,0,4,10,40,6,1,0,1,1,7,10,0
46,Gabriel Barbosa,br BRA,FW,Cruzeiro,,28.67945205,1996,2.2,0,0,0,0,0,0,1,0,1,2,0,2,0,0,1,0
47,Lucas Barbosa,br BRA,FW,RB Bragantino,,24.19726027,2001,3.4,5,4,2,1,2,1,3,33.3,2,7,2,5,4,9,8,0
48,Alexander Barboza,ar ARG,DF,Botafogo (RJ),,30.1369863,1995,5,11,10,10,1,0,7,11,63.6,4,6,3,3,8,19,31,0
49,Chrystian Barletta,br BRA,FW,Sport Recife,,23.83287671,2001,5.4,5,3,1,3,1,2,5,40,3,5,1,4,4,9,3,0
50,Álvaro Barreal,ar ARG,"FW,MF",Santos,,24.71506849,2000,2.9,4,0,0,3,1,2,9,22.2,7,7,1,6,4,8,3,0
51,Enmerson Batalla,co COL,"MF,FW",Juventude,,23.84657534,2001,4.6,5,4,3,2,0,3,7,42.9,4,3,1,2,1,6,1,1
52,Paulo Baya,br BRA,MF,Fluminense,,25.77534247,1999,0.1,0,0,0,0,0,0,0,,0,0,0,0,0,0,0,1
53,José Luis Rodríguez Bebanz,uy URU,DF,Vasco da Gama,,28.14246575,1997,1.1,2,2,0,1,1,1,1,100,0,0,0,0,0,2,2,0
54,Luis Benedetti,br BRA,DF,Palmeiras,,18.90958904,2006,1,1,1,1,0,0,1,1,100,0,0,0,0,0,1,2,0
55,Alexandro Bernabei,ar ARG,DF,Internacional,,24.6109589,2000,5.9,19,13,11,5,3,10,23,43.5,13,10,1,9,9,28,18,1
56,Facundo Bernal,uy URU,MF,Fluminense,,21.70410959,2003,2.4,2,2,0,2,0,2,6,33.3,4,1,0,1,2,4,5,0
57,Bernard,br BRA,"MF,FW",Atlético Mineiro,,32.65479452,1992,1.4,2,2,0,1,1,2,3,66.7,1,2,0,2,0,2,1,0
58,Matheus Bidu,br BRA,"DF,MF",Corinthians,,26.00273973,1999,2,4,3,3,1,0,1,2,50,1,3,0,3,3,7,4,0
59,Damián Bobadilla,py PAR,MF,São Paulo,,23.81643836,2001,2.7,6,2,0,5,1,3,7,42.9,4,3,1,2,1,7,5,0
60,Yannick Bolasie,cd COD,FW,Cruzeiro,,35.94794521,1989,0,0,0,0,0,0,0,0,,0,0,0,0,0,0,2,0
61,Gabriel Bontempo,br BRA,MF,Santos,,20.29863014,2005,3.9,9,9,7,2,0,4,8,50,4,7,1,6,6,15,7,0
62,Thiago Borbas,uy URU,"MF,FW",RB Bragantino,,23.07671233,2002,0.4,0,0,0,0,0,0,0,,0,0,0,0,0,0,0,0
63,Daniel Borges,br BRA,DF,Mirassol,,32.11780822,1993,2.4,4,2,3,0,1,2,8,25,6,3,1,2,4,8,6,1
64,Marllon Borges,br BRA,DF,Ceará,,33.05205479,1992,7,5,2,4,0,1,1,2,50,1,7,7,0,5,10,41,2
65,Rafael Borré,co COL,"FW,MF",Internacional,,29.63561644,1995,2.4,6,4,0,3,3,0,1,0,1,2,0,2,0,6,2,0
66,Lucas Braga,br BRA,FW,Vitória,,28.48219178,1996,0.9,1,1,1,0,0,1,4,25,3,3,0,3,0,1,1,0
67,Martin Braithwaite,dk DEN,FW,Grêmio,,33.91506849,1991,4.8,4,3,2,1,1,2,2,100,0,3,1,2,2,6,3,0
68,Gabriel Brazão,br BRA,GK,Santos,,24.58082192,2000,7,1,1,1,0,0,1,2,50,1,0,0,0,0,1,5,0
69,Breno,br BRA,FW,Fortaleza,,29.27671233,1996,1.3,0,0,0,0,0,0,1,0,1,1,0,1,0,0,0,0
70,Breno,br BRA,MF,Corinthians,,20.20273973,2005,5.6,10,6,3,5,2,6,10,60,4,7,1,6,2,12,5,0
71,Bruninho,br BRA,MF,Fortaleza,,19.89863014,2005,0.8,2,2,0,1,1,2,3,66.7,1,5,1,4,2,4,0,0
72,Fabrício Bruno,br BRA,DF,Cruzeiro,,29.22465753,1996,6,8,7,2,5,1,4,7,57.1,3,14,9,5,6,14,42,0
73,Cacá,br BRA,DF,Corinthians,,26.02739726,1999,2.7,4,4,2,2,0,3,4,75,1,2,1,1,1,5,13,0
74,Raúl Cáceres,py PAR,DF,Vitória,,33.62739726,1991,1,5,4,5,0,0,4,8,50,4,0,0,0,0,5,7,0
75,Calebe,br BRA,MF,Fortaleza,,25.01369863,2000,1.8,3,1,0,2,1,1,2,50,1,3,1,2,2,5,1,0
76,Jonathan Calleri,ar ARG,FW,São Paulo,,31.61369863,1993,1.3,2,1,0,1,1,0,0,,0,0,0,0,0,2,0,0
77,Camilo,br BRA,MF,Grêmio,,26.19452055,1999,3.2,10,7,5,4,1,5,7,71.4,2,5,2,3,7,17,12,0
78,Germán Cano,ar ARG,FW,Fluminense,,37.25205479,1988,5.3,1,1,1,0,0,0,1,0,1,4,0,4,0,1,2,0
79,Agustín Canobbio,uy URU,FW,Fluminense,,26.59178082,1998,4.8,15,7,6,9,0,5,15,33.3,10,4,0,4,4,19,4,0
80,Juninho Capixaba,br BRA,DF,RB Bragantino,,27.83013699,1997,6,20,16,10,8,2,9,15,60,6,12,4,8,8,28,27,0
81,Johan Carbonero,co COL,FW,Internacional,,25.79178082,1999,1.7,3,1,0,3,0,2,2,100,0,1,0,1,0,3,1,0
82,Edson Carioca,br BRA,FW,Mirassol,,27.83561644,1997,2.5,3,1,2,1,0,1,4,25,3,5,1,4,1,4,3,0
83,Igor Cariús,br BRA,DF,Sport Recife,,32.0109589,1993,3.9,13,8,7,6,0,8,12,66.7,4,1,0,1,3,16,17,0
84,Carlinhos,br BRA,FW,Vitória,,28.22465753,1997,1.1,1,0,0,0,1,0,0,,0,0,0,0,1,2,1,0
85,Jean Carlos Vicente,br BRA,"MF,FW",Juventude,,33.21643836,1992,1.2,3,3,1,2,0,1,1,100,0,1,0,1,0,3,0,0
86,André Carrillo,pe PER,MF,Corinthians,,33.89041096,1991,4.8,7,3,4,2,1,2,7,28.6,5,3,0,3,5,12,3,0
87,Gabriel Carvalho,br BRA,FW,Internacional,,17.71506849,2007,0.7,2,1,0,2,0,1,1,100,0,1,1,0,0,2,1,0
88,Cássio,br BRA,GK,Cruzeiro,,37.91232877,1987,7,0,0,0,0,0,0,1,0,1,0,0,0,0,0,2,0
89,Iury de Castilho,br BRA,FW,Mirassol,,29.66027397,1995,3.5,3,3,1,2,0,0,2,0,2,2,0,2,2,5,2,0
90,Murilo Cerqueira,br BRA,DF,Palmeiras,,28.10684932,1997,1.7,2,1,0,1,1,0,2,0,2,3,1,2,1,3,12,1
91,Kayky Chagas,br BRA,"FW,DF",Bahia,,21.89863014,2003,0.7,0,0,0,0,0,0,1,0,1,1,0,1,0,0,0,0
92,Chico,br BRA,MF,Mirassol,,33.96712329,1991,0.8,2,2,1,1,0,2,4,50,2,2,0,2,1,3,0,0
93,Chico,br BRA,DF,Sport Recife,,26.63835616,1998,7,13,8,9,4,0,10,14,71.4,4,8,6,2,8,21,58,1
94,Christian,br BRA,FW,Cruzeiro,,24.37534247,2000,4.1,8,3,2,5,1,6,10,60,4,6,0,6,4,12,2,0
95,Claudinho,br BRA,DF,Vitória,,24.6109589,2000,6,13,5,9,4,0,9,14,64.3,5,6,3,3,5,18,11,0
96,Clayson,br BRA,FW,Mirassol,,30.12876712,1995,2.6,2,1,1,1,0,1,4,25,3,3,0,3,1,3,0,0
97,Mateus Cocão,br BRA,MF,Vasco da Gama,,23.13150685,2002,1.9,6,4,2,4,0,4,6,66.7,2,1,1,0,5,11,6,0
98,Igor Coronado,br BRA,MF,Corinthians,,32.71232877,1992,1.9,6,1,1,2,3,3,6,50,3,2,1,1,2,8,1,0
99,Philippe Coutinho,br BRA,MF,Vasco da Gama,,32.89589041,1992,3.3,4,1,1,1,2,3,4,75,1,2,0,2,0,4,1,0
100,Franco Cristaldo,ar ARG,"MF,FW",Grêmio,,28.72054795,1996,3.3,5,4,2,2,1,3,5,60,2,1,1,0,1,6,1,0
101,Gustavo Cuellar,co COL,MF,Grêmio,,32.55616438,1992,0.9,5,4,2,2,1,4,6,66.7,2,1,0,1,0,5,5,1
102,Tomás Cuello,ar ARG,"FW,MF",Atlético Mineiro,,25.16712329,2000,5.5,4,2,1,2,1,3,7,42.9,4,3,1,2,4,8,3,0
103,Cuiabano,br BRA,DF,Botafogo (RJ),,22.21369863,2003,4.5,5,4,3,2,0,1,4,25,3,3,1,2,5,10,4,0
104,Lucas Cunha,br BRA,DF,Sport Recife,,28.27945205,1997,1.9,0,0,0,0,0,0,3,0,3,3,3,0,2,2,8,0
105,Danielzinho,br BRA,"MF,FW",Mirassol,,30.49863014,1994,6,17,11,7,8,2,1,5,20,4,5,1,4,4,21,4,1
106,Danilo,br BRA,DF,Flamengo,,33.80547945,1991,1,3,3,2,1,0,0,0,,0,1,1,0,2,5,2,0
107,Matheus Davó,br BRA,"FW,MF",Mirassol,,25.71780822,1999,0.4,1,1,0,1,0,0,0,,0,0,0,0,0,1,0,0
108,Giorgian De Arrascaeta,uy URU,MF,Flamengo,,30.9260274,1994,5.1,8,7,4,2,2,1,3,33.3,2,1,1,0,1,9,0,0
109,Nicolás De La Cruz,uy URU,MF,Flamengo,,27.9260274,1997,5.5,9,7,5,4,0,4,6,66.7,2,2,1,1,7,16,4,0
110,Deyverson,br BRA,FW,Fortaleza,,33.99178082,1991,3.5,2,2,1,0,1,1,3,33.3,2,1,0,1,1,3,3,0
111,Enzo Díaz,ar ARG,DF,São Paulo,,29.40821918,1995,3.9,15,10,11,4,0,8,11,72.7,3,8,5,3,4,19,13,0
112,Lautaro Díaz,ar ARG,FW,Cruzeiro,,26.95616438,1998,0.7,0,0,0,0,0,0,1,0,1,0,0,0,0,0,0,0
113,Dieguinho,br BRA,MF,Ceará,,29.50958904,1995,6.9,16,7,8,8,0,8,13,61.5,5,8,3,5,11,27,15,0
114,Dieguinho,br BRA,FW,Corinthians,,17.80273973,2007,0.1,0,0,0,0,0,0,0,,0,1,0,1,0,0,1,0
115,Dodi,br BRA,MF,Grêmio,,29.04931507,1996,3.7,4,1,0,4,0,1,2,50,1,4,2,2,6,10,5,0
116,Fabricio Domínguez,uy URU,MF,Sport Recife,,26.8630137,1998,1.1,2,1,2,0,0,1,3,33.3,2,1,0,1,1,3,0,0
117,Matheus Donelli,br BRA,GK,Corinthians,,22.96712329,2002,5,0,0,0,0,0,0,0,,0,0,0,0,0,0,2,0
118,Thiago dos Santos,br BRA,MF,Fluminense,,35.6630137,1989,0.1,1,0,1,0,0,0,1,0,1,1,0,1,0,1,1,0
119,David Duarte,br BRA,DF,Bahia,,30.27671233,1995,4.9,2,0,0,2,0,0,1,0,1,7,5,2,4,6,38,0
120,Dudu,br BRA,"FW,MF",Cruzeiro,,33.32328767,1992,2.4,2,1,0,1,1,1,3,33.3,2,3,0,3,1,3,0,0
121,Edenílson,br BRA,"MF,FW",Grêmio,,35.37808219,1989,5,3,2,1,2,0,2,4,50,2,6,3,3,3,6,2,1
122,Eder,br BRA,DF,Ceará,,30.08219178,1995,1,0,0,0,0,0,0,0,,0,1,1,0,0,0,5,0
123,EDU,br BRA,DF,Vitória,,24.88493151,2000,0.1,0,0,0,0,0,0,0,,0,0,0,0,0,0,0,0
124,Carlos Eduardo,br BRA,"MF,FW",Cruzeiro,,35.54794521,1989,0.8,0,0,0,0,0,0,1,0,1,1,0,1,0,0,2,0
125,Carlos Eduardo,br BRA,FW,Vitória,,28.56712329,1996,0.4,0,0,0,0,0,0,0,,0,3,2,1,0,0,0,0
126,Alysson Edward,br BRA,FW,Grêmio,,19,2006,1.1,6,3,2,1,3,2,2,100,0,1,0,1,2,8,0,0
127,Rodrigo Ely,br BRA,DF,Grêmio,,31.50136986,1993,0.4,1,1,1,0,0,0,0,,0,1,1,0,1,2,0,0
128,Leandro Emmanuel Martínez,ar ARG,MF,Fortaleza,,30.91780822,1994,4,8,5,3,4,1,4,8,50,4,4,1,3,3,11,6,1
129,Ênio,br BRA,"MF,FW",Juventude,,24.17260274,2001,3.4,2,2,1,1,0,0,3,0,3,2,0,2,1,3,3,0
130,Erick,br BRA,"MF,DF",Bahia,,27.47123288,1997,4.2,8,4,4,3,1,1,6,16.7,5,8,2,6,6,14,13,0
131,Erick,br BRA,"FW,MF",Vitória,,27.4,1997,4.4,3,3,0,2,1,1,2,50,1,2,0,2,4,7,3,0
132,Gonzalo Escobar,ar ARG,DF,Santos,,28.1369863,1997,6.8,38,28,25,12,1,21,27,77.8,6,7,2,5,16,54,34,0
133,Lucas Esteves,br BRA,DF,Grêmio,,24.8630137,2000,3.7,5,5,2,2,1,1,1,100,0,4,0,4,2,7,7,0
134,Lucas Evangelista,br BRA,MF,Palmeiras,,29.99726027,1995,2,3,1,3,0,0,2,3,66.7,1,0,0,0,0,3,1,0
135,Éverson,br BRA,GK,Atlético Mineiro,,34.78630137,1990,6,0,0,0,0,0,0,0,,0,0,0,0,0,0,2,0
136,Evertton,br BRA,MF,Flamengo,,22.18082192,2003,0,0,0,0,0,0,0,0,,0,0,0,0,0,0,0,0
137,Ewerton,br BRA,DF,Juventude,,24.48219178,2000,5.6,9,4,5,2,2,2,11,18.2,9,5,1,4,12,21,23,0
138,Fabinho,br BRA,"MF,FW",RB Bragantino,,23.07123288,2002,1.2,2,1,2,0,0,1,5,20,4,2,1,1,3,5,6,0
139,Fábio,br BRA,GK,Fluminense,,44.59452055,1980,7,0,0,0,0,0,0,0,,0,0,0,0,0,0,4,0
140,Fabrício,br BRA,"FW,MF",Mirassol,,28.11780822,1997,1.9,1,0,1,0,0,0,3,0,3,4,1,3,0,1,1,0
141,Fabrício,br BRA,"FW,MF",Vitória,,24.57260274,2000,1.6,6,3,5,0,1,2,5,40,3,4,0,4,0,6,1,0
142,Fagner,br BRA,DF,Cruzeiro,,35.89863014,1989,3.5,11,5,7,4,0,8,11,72.7,3,6,0,6,5,16,12,0
143,Marcos Felipe,br BRA,GK,Bahia,,29.06027397,1996,3.8,0,0,0,0,0,0,0,,0,0,0,0,1,1,4,0
144,Matheus Fernandes,br BRA,MF,RB Bragantino,,26.84657534,1998,2.5,6,5,3,3,0,1,7,14.3,6,3,0,3,3,9,7,0
145,Nathan Fernandes,br BRA,MF,Botafogo (RJ),,20.21369863,2005,0.2,1,1,1,0,0,0,1,0,1,0,0,0,1,2,2,0
146,Fernandinho,br BRA,FW,Ceará,,27.79452055,1997,1.3,3,2,1,2,0,2,2,100,0,2,0,2,1,4,1,0
147,Fernando,br BRA,"MF,DF",Internacional,,37.77808219,1987,4.4,9,5,5,4,0,4,12,33.3,8,8,5,3,6,15,8,0
148,Nahuel Ferraresi,ve VEN,DF,São Paulo,,26.45753425,1998,4.1,10,5,5,4,1,8,13,61.5,5,5,3,2,5,15,31,0
149,Ferreira,br BRA,"FW,MF",São Paulo,,27.34246575,1997,5.3,8,5,4,4,0,5,12,41.7,7,8,1,7,4,12,6,0
150,Bruno Ferreira,br BRA,GK,Ceará,,31.1369863,1994,3.7,0,0,0,0,0,0,0,,0,0,0,0,0,0,2,0
151,Lucas Ferreira,br BRA,FW,São Paulo,,19.01917808,2006,4.3,14,8,5,7,2,4,9,44.4,5,10,0,10,1,15,9,0
152,Luiz Filipe,br BRA,FW,Mirassol,,23.9369863,2001,0.2,1,1,0,0,1,0,1,0,1,0,0,0,0,1,0,0
153,André Filipinho,br BRA,DF,Juventude,,28.30684932,1997,3.4,5,1,3,1,1,1,3,33.3,2,3,1,2,5,10,19,0
154,Caíque França,br BRA,GK,Sport Recife,,29.92054795,1995,7,1,1,1,0,0,1,1,100,0,0,0,0,0,1,4,0
155,Ryan Francisco,br BRA,"FW,MF",São Paulo,,18.45205479,2006,0.9,0,0,0,0,0,0,0,,0,0,0,0,0,0,0,0
156,Alan Franco,ec ECU,MF,Atlético Mineiro,,26.70410959,1998,2.5,7,4,2,3,2,3,3,100,0,1,0,1,1,8,4,0
157,Alan Franco,ar ARG,DF,São Paulo,,28.56438356,1996,5,3,2,1,2,0,2,4,50,2,6,6,0,5,8,27,1
158,Lucas Freitas,br BRA,DF,Vasco da Gama,,24.28767123,2001,5.4,6,4,4,2,0,5,6,83.3,1,10,8,2,5,11,31,0
159,Marlon Freitas,br BRA,MF,Botafogo (RJ),,30.10684932,1995,6.8,8,4,4,2,2,3,7,42.9,4,9,5,4,5,13,10,0
160,Juan Freytes,ar ARG,DF,Fluminense,,25.31232877,2000,7,6,3,5,0,1,3,7,42.9,4,7,5,2,5,11,47,1
161,Bruno Fuchs,br BRA,DF,Palmeiras,,26.09315068,1999,2.6,4,2,3,1,0,2,2,100,0,2,2,0,5,9,15,0
162,Gabriel Fuentes,co COL,DF,Fluminense,,28.23287671,1997,1,4,3,2,0,2,2,2,100,0,1,0,1,3,7,4,0
163,Gabriel,br BRA,"FW,DF",Bahia,,23.99726027,2001,0.5,2,2,2,0,0,2,3,66.7,1,0,0,0,1,3,5,0
164,Gabriel,br BRA,MF,Mirassol,,35.3260274,1990,1.6,2,2,0,2,0,1,1,100,0,3,2,1,1,3,3,0
165,Gabriel,br BRA,GK,Vitória,,32.60273973,1992,1,0,0,0,0,0,0,0,,0,0,0,0,0,0,1,0
166,Gabriel,br BRA,MF,RB Bragantino,,32.81917808,1992,4.4,20,14,10,7,3,8,16,50,8,8,1,7,5,25,7,0
167,Victor Gabriel,br BRA,DF,Internacional,,21.01917808,2004,2,2,2,0,2,0,0,0,,0,2,2,0,4,6,15,0
168,Antonio Galeano,py PAR,FW,Ceará,,25.12054795,2000,6.2,7,4,4,3,0,4,12,33.3,8,8,1,7,1,8,5,0
169,Emerson Galego,br BRA,"FW,MF",Juventude,,25.73424658,1999,0.3,0,0,0,0,0,0,1,0,1,1,0,1,0,0,0,0
170,Mateo Gamarra,py PAR,DF,Cruzeiro,,24.53972603,2000,1.7,6,5,5,1,0,5,6,83.3,1,1,1,0,4,10,18,0
171,Ganso,br BRA,MF,Fluminense,,35.56164384,1989,2.7,4,0,1,3,0,2,3,66.7,1,0,0,0,0,4,0,0
172,Maurício Garcez,br BRA,"MF,FW",Juventude,,28.1369863,1997,0.6,0,0,0,0,0,0,0,,0,2,0,2,0,0,1,0
173,Benjamín Garré,ar ARG,"FW,MF",Vasco da Gama,,24.81643836,2000,2.9,5,4,3,2,0,3,11,27.3,8,5,0,5,2,7,3,0
174,Gerson,br BRA,FW,Flamengo,,27.95890411,1997,5.3,9,7,1,3,5,4,7,57.1,3,5,0,5,2,11,2,0
175,Agustín Giay,ar ARG,DF,Palmeiras,,21.29863014,2004,5.8,18,14,14,3,1,10,14,71.4,4,9,2,7,6,24,21,1
176,Gil,br BRA,DF,Santos,,37.89589041,1987,6,13,7,11,1,1,8,11,72.7,3,4,2,2,5,18,22,0
177,Gilberto,br BRA,DF,Bahia,,32.16164384,1993,5.1,16,15,12,4,0,10,14,71.4,4,2,1,1,4,20,19,1
178,Gilberto,br BRA,FW,Juventude,,35.91506849,1989,1.6,0,0,0,0,0,0,0,,0,1,0,1,1,1,1,0
179,Giovanny,br BRA,"FW,MF",Juventude,,27.62465753,1997,2.3,0,0,0,0,0,0,7,0,7,4,0,4,1,1,3,0
180,Daniel Giraldo,co COL,MF,Juventude,,32.84383562,1992,4.6,6,6,3,3,0,2,7,28.6,5,6,2,4,2,8,16,1
181,Leonardo Godoy,ar ARG,DF,Santos,,30.01917808,1995,2.3,3,3,1,2,0,2,4,50,2,4,1,3,0,3,11,0
182,Davi Goes,br BRA,MF,Juventude,,19.86849315,2005,0.7,1,1,1,0,0,0,0,,0,4,4,0,1,2,2,0
183,Fredi Gomes,br BRA,DF,Bahia,,18.95068493,2006,1,1,1,1,0,0,1,1,100,0,1,0,1,2,3,2,1
184,Igor Gomes,br BRA,"MF,FW",Atlético Mineiro,,26.13424658,1999,1.1,0,0,0,0,0,0,1,0,1,0,0,0,2,2,0,0
185,Gustavo Gómez,py PAR,DF,Palmeiras,,31.99726027,1993,5,5,3,3,1,1,3,6,50,3,2,2,0,5,10,42,1
186,Nuno Gonçalo Moreira,pt POR,FW,Vasco da Gama,,25.88493151,1999,4.7,6,4,1,2,3,4,10,40,6,3,1,2,3,9,6,0
187,Matheus Gonçalves,br BRA,FW,Flamengo,,19.71232877,2005,0.1,1,1,0,1,0,1,2,50,1,1,0,1,0,1,0,0
188,Gregore,br BRA,MF,Botafogo (RJ),,31.17534247,1994,5.6,23,17,12,6,5,13,20,65,7,7,3,4,5,28,7,0
189,Guga,br BRA,DF,Fluminense,,26.68219178,1998,1.6,7,6,3,4,0,4,5,80,1,2,0,2,3,10,3,0
190,Guilherme,br BRA,FW,Santos,,30.06027397,1995,5.8,15,8,8,2,5,6,11,54.5,5,13,0,13,4,19,15,0
191,Guilherme,br BRA,DF,RB Bragantino,,23.21917808,2002,0.3,2,2,1,1,0,1,1,100,0,0,0,0,0,2,3,0
192,Gustavinho,br BRA,MF,RB Bragantino,,21.03287671,2004,0.4,2,1,0,1,1,1,1,100,0,0,0,0,0,2,2,0
193,Gustavo,br BRA,GK,Juventude,,32.15342466,1993,4,1,1,1,0,0,1,1,100,0,0,0,0,0,1,1,1
194,Luiz Gustavo,br BRA,MF,São Paulo,,37.78356164,1987,1,5,2,1,3,1,2,3,66.7,1,1,1,0,1,6,0,0
195,Luiz Gustavo,br BRA,DF,Vasco da Gama,,19.0630137,2006,0.5,,0,,,,,,,,,,,0,,,
196,Ryan Gustavo,br BRA,MF,Corinthians,,21.80547945,2003,0.1,0,0,0,0,0,0,0,,0,1,0,1,0,0,0,0
197,Lucas Halter,br BRA,DF,Vitória,,25.00821918,2000,7,11,6,9,2,0,7,11,63.6,4,3,3,0,3,14,39,0
198,Héctor,es ESP,"FW,MF",Corinthians,,29.63835616,1995,0.7,3,2,0,2,1,1,1,100,0,0,0,0,0,3,1,0
199,Bruno Henrique,br BRA,"FW,MF",Flamengo,,34.34520548,1990,3.4,2,1,0,1,1,0,0,,0,2,0,2,1,3,3,0
200,Bruno Henrique,br BRA,MF,Internacional,,35.5369863,1989,4.4,10,4,2,6,2,3,9,33.3,6,3,1,2,3,13,3,0
201,Dalbert Henrique,br BRA,DF,Sport Recife,,31.65479452,1993,0,0,0,0,0,0,0,0,,0,0,0,0,0,0,1,0
202,Gustavo Henrique,br BRA,DF,Corinthians,,32.11506849,1993,3,5,5,4,1,0,3,3,100,0,5,1,4,2,7,18,1
203,Matheus Henrique,br BRA,MF,Cruzeiro,,27.37534247,1997,2,4,3,1,3,0,3,3,100,0,1,1,0,2,6,1,0
204,Paulo Henrique,br BRA,DF,Vasco da Gama,,28.77808219,1996,5.9,27,16,16,10,1,17,26,65.4,9,12,2,10,6,33,34,0
205,Pedro Henrique,br BRA,FW,Ceará,,34.88493151,1990,1.7,3,2,0,1,2,2,4,50,2,1,0,1,1,4,1,1
206,Pedro Henrique,br BRA,DF,RB Bragantino,,29.5890411,1995,6,8,4,6,2,0,5,9,55.6,4,7,5,2,11,19,54,0
207,Hércules,br BRA,MF,Fluminense,,24.53972603,2000,3.7,11,6,6,4,1,4,6,66.7,2,5,2,3,0,11,6,0
208,Diogo Hereda,br BRA,DF,Sport Recife,,26.62191781,1998,6.2,16,13,8,6,2,9,11,81.8,2,4,0,4,4,20,17,0
209,Hugo,br BRA,DF,Corinthians,,27.68219178,1997,1.7,3,2,1,1,1,1,3,33.3,2,2,0,2,2,5,6,0
210,Vitor Hugo,br BRA,DF,Atlético Mineiro,,33.95890411,1991,1,3,3,1,1,1,1,1,100,0,3,3,0,0,3,5,0
211,Hulk,br BRA,"FW,MF",Atlético Mineiro,,38.77808219,1986,5.6,2,1,0,2,0,0,1,0,1,1,0,1,0,2,4,0
212,José Hurtado,ec ECU,DF,RB Bragantino,,23.36438356,2001,5.5,15,11,9,6,0,7,9,77.8,2,2,0,2,5,20,21,0
213,Hyan,br BRA,MF,Santos,,21.11506849,2004,0.1,0,0,0,0,0,0,0,,0,0,0,0,0,0,0,0
214,Iago,br BRA,DF,Bahia,,28.11780822,1997,1.2,1,1,1,0,0,0,1,0,1,0,0,0,2,3,4,0
215,Ignácio,br BRA,DF,Fluminense,,28.42465753,1996,4,6,1,5,1,0,2,2,100,0,1,1,0,7,13,29,0
216,Juan Ignacio Dinenno,ar ARG,FW,Cruzeiro,,30.68493151,1994,0.1,0,0,0,0,0,0,0,,0,0,0,0,0,0,0,0
217,Zé Ivaldo,br BRA,DF,Santos,,28.2,1997,7,10,7,7,2,1,7,11,63.6,4,4,2,2,4,14,32,0
218,Jadson,br BRA,MF,Juventude,,31.67945205,1993,6,10,4,4,6,0,0,8,0,8,9,3,6,12,22,12,0
219,Jair,br BRA,MF,Vasco da Gama,,30.69041096,1994,3.4,9,7,5,4,0,5,10,50,5,7,2,5,4,13,5,0
220,Jamerson,br BRA,DF,Vitória,,26.65205479,1998,6.9,16,9,13,1,2,7,13,53.8,6,6,3,3,9,25,25,0
221,Janderson,br BRA,FW,Vitória,,25.99726027,1999,6.5,9,4,0,5,4,4,11,36.4,7,9,2,7,2,11,5,0
222,Léo Jardim,br BRA,GK,Vasco da Gama,,30.1260274,1995,7,0,0,0,0,0,0,0,,0,0,0,0,0,0,8,0
223,Jeffinho,br BRA,MF,Botafogo (RJ),,25.34520548,1999,0.1,1,0,1,0,0,0,0,,0,0,0,0,0,1,0,0
224,Jemerson,br BRA,DF,Grêmio,,32.69589041,1992,6.6,14,9,9,5,0,7,8,87.5,1,4,2,2,8,22,43,0
225,Jemmes,br BRA,DF,Mirassol,,25.07123288,2000,6,10,9,5,5,0,6,8,75,2,3,3,0,8,18,30,1
226,Igor Jesus,br BRA,FW,Botafogo (RJ),,24.1890411,2001,7,2,2,0,2,0,0,2,0,2,7,4,3,0,2,7,0
227,John,br BRA,GK,Botafogo (RJ),,29.22191781,1996,7,1,1,1,0,0,1,1,100,0,1,0,1,0,1,3,0
228,Jonathan,br BRA,DF,Cruzeiro,,20.93972603,2004,2,4,3,4,0,0,3,9,33.3,6,0,0,0,3,7,11,0
229,Kaio Jorge,br BRA,FW,Cruzeiro,,23.27671233,2002,5.3,3,2,1,1,1,2,4,50,2,5,0,5,4,7,4,0
230,José,br BRA,DF,Cruzeiro,,19.67671233,2005,0,0,0,0,0,0,0,0,,0,0,0,0,0,0,0,0
231,Willian José,br BRA,FW,Bahia,,33.44657534,1991,3.4,1,0,0,0,1,0,2,0,2,1,0,1,2,3,8,0
232,Jhonatan Jowjow,br BRA,MF,RB Bragantino,,22.65205479,2002,5.2,6,5,3,2,1,2,4,50,2,4,0,4,2,8,6,0
233,Luciano Juba,br BRA,"DF,MF",Bahia,,25.68219178,1999,6.3,13,8,8,4,1,12,17,70.6,5,5,1,4,5,18,20,0
234,Juninho,br BRA,FW,Flamengo,,28.45205479,1996,1.9,3,3,0,2,1,1,3,33.3,2,1,0,1,0,3,1,0
235,Juninho,br BRA,DF,Internacional,,29.35616438,1995,1,0,0,0,0,0,0,1,0,1,0,0,0,0,0,5,0
236,Kaiki,br BRA,DF,Cruzeiro,,22.15890411,2003,6.9,22,17,12,7,3,7,11,63.6,4,9,2,7,6,28,18,0
237,Walter Kannemann,ar ARG,DF,Grêmio,,34.14246575,1991,0.7,1,1,1,0,0,1,1,100,0,2,1,1,2,3,4,0
238,Kanu,br BRA,DF,Bahia,,28.16164384,1997,1.1,1,1,1,0,0,1,2,50,1,2,1,1,5,6,2,0
239,Keno,br BRA,FW,Fluminense,,35.64931507,1989,1,2,1,1,0,1,1,2,50,1,0,0,0,0,2,1,0
240,Kevyson,br BRA,DF,Santos,,21.10136986,2004,0.2,0,0,0,0,0,0,2,0,2,0,0,0,0,0,2,0
241,Benjamín Kuscevic,cl CHI,DF,Fortaleza,,29.00821918,1996,6.9,11,6,9,2,0,6,8,75,2,9,4,5,8,19,53,0
242,Ignacio Laquintana,uy URU,FW,RB Bragantino,,26.25479452,1999,1.4,0,0,0,0,0,0,0,,0,1,0,1,1,1,1,0
243,Joaquín Lavega,uy URU,DF,Fluminense,,20.24931507,2005,0.1,0,0,0,0,0,0,0,,0,0,0,0,0,0,0,0
244,Lelê,br BRA,"FW,MF",Ceará,,27.59178082,1997,0.4,0,0,0,0,0,0,0,,0,1,0,1,0,0,0,0
245,Mauricio Lemos,uy URU,DF,Vasco da Gama,,29.35068493,1995,1,1,1,0,1,0,1,1,100,0,2,2,0,0,1,4,0
246,Rubén Lezcano,py PAR,MF,Fluminense,,21.23287671,2004,0.5,1,0,0,0,1,1,1,100,0,0,0,0,0,1,0,0
247,Lima,br BRA,MF,Fluminense,,28.89863014,1996,3.5,4,2,1,2,1,2,5,40,3,1,0,1,2,6,0,0
248,Lucas Lima,br BRA,MF,Ceará,,24.83561644,2000,0.1,0,0,0,0,0,0,0,,0,0,0,0,0,0,0,0
249,Lucas Lima,br BRA,"FW,MF",Sport Recife,,34.82191781,1990,5.8,4,3,2,1,1,2,10,20,8,4,0,4,2,6,3,0
250,Lenny Lobato,br BRA,FW,Sport Recife,,24.24931507,2001,2.7,2,1,1,0,1,1,2,50,1,1,0,1,1,3,1,0
251,David Loiola,br BRA,DF,Botafogo (RJ),,22.36986301,2002,1.7,1,1,1,0,0,0,1,0,1,3,0,3,3,4,8,0
252,José López,ar ARG,FW,Palmeiras,,24.4109589,2000,3.3,3,3,1,2,0,1,2,50,1,3,1,2,1,4,1,0
253,Lourenço,br BRA,MF,Ceará,,27.65753425,1997,1.8,6,3,2,4,0,1,1,100,0,3,2,1,3,9,5,0
254,Lucão,br BRA,GK,RB Bragantino,,24.18630137,2001,1,0,0,0,0,0,0,0,,0,0,0,0,0,0,0,0
255,Ayrton Lucas,br BRA,DF,Flamengo,,27.87671233,1997,2.3,8,6,3,5,0,2,3,66.7,1,2,0,2,1,9,3,0
256,Jean Lucas,br BRA,MF,Bahia,,26.86849315,1998,5.2,8,4,3,4,1,3,5,60,2,6,3,3,4,12,5,0
257,João Lucas,br BRA,DF,Grêmio,,27.15616438,1998,0.5,1,1,1,0,0,1,2,50,1,1,0,1,0,1,3,0
258,Zé Lucas,br BRA,MF,Sport Recife,,17.11780822,2008,2.1,8,5,2,5,1,4,6,66.7,2,1,0,1,4,12,3,0
259,Luciano,br BRA,"MF,FW",São Paulo,,31.96438356,1993,3.6,1,0,1,0,0,0,2,0,2,1,0,1,2,3,2,0
260,Victor Luis,br BRA,DF,Vasco da Gama,,31.86575342,1993,1,0,0,0,0,0,0,1,0,1,0,0,0,1,1,4,0
261,Luisão,br BRA,DF,Santos,,21.65205479,2003,1.6,4,3,1,3,0,4,7,57.1,3,2,1,1,1,5,8,1
262,David Luiz,br BRA,DF,Fortaleza,,38.03561644,1987,3.4,4,3,3,1,0,2,2,100,0,7,6,1,5,9,27,0
263,Guilherme Luiz,br BRA,FW,Ceará,,20.02739726,2005,1.1,3,2,2,0,1,1,3,33.3,2,0,0,0,1,4,3,0
264,Lyanco,br BRA,DF,Atlético Mineiro,,28.25479452,1997,4,6,4,4,2,0,4,8,50,4,4,3,1,14,20,17,2
265,Everton Maceió,br BRA,"FW,MF",Mirassol,,21.80821918,2003,1.5,1,1,0,1,0,0,0,,0,2,0,2,0,1,4,1
266,Willian Machado,br BRA,DF,Ceará,,28.4739726,1996,6.8,6,3,4,2,0,3,4,75,1,6,3,3,7,13,56,0
267,Talles Magno,br BRA,"FW,MF",Corinthians,,22.85753425,2002,1.7,3,3,2,1,0,3,4,75,1,1,0,1,0,3,1,0
268,Gustavo Maia,br BRA,FW,Sport Recife,,24.28219178,2001,0.2,0,0,0,0,0,0,0,,0,0,0,0,0,0,0,0
269,Thiago Maia,br BRA,"MF,FW",Internacional,,28.11780822,1997,2,2,1,1,1,0,0,3,0,3,1,0,1,0,2,1,0
270,Léo Mana,br BRA,DF,Corinthians,,21.07945205,2004,1.5,3,2,0,2,1,1,4,25,3,2,0,2,3,6,2,0
271,Gustavo Mancha,br BRA,DF,Fortaleza,,20.77808219,2004,3.9,10,4,6,4,0,7,9,77.8,2,0,0,0,7,17,15,0
272,Eros Mancuso,ar ARG,"DF,FW",Fortaleza,,26.04931507,1999,4.6,9,7,4,4,1,7,13,53.8,6,4,1,3,3,12,10,0
273,Luis Mandaca,br BRA,"MF,FW",Juventude,,23.5890411,2001,3.8,9,3,2,4,3,2,3,66.7,1,5,0,5,1,10,1,0
274,Elias Manoel,br BRA,MF,Botafogo (RJ),,23.42739726,2001,0.2,0,0,0,0,0,0,1,0,1,2,0,2,0,0,0,0
275,Marcão,br BRA,GK,Juventude,,33.16438356,1992,2,0,0,0,0,0,0,0,,0,0,0,0,0,0,0,0
276,João Marcelo,br BRA,FW,Atlético Mineiro,,20.05479452,2005,0.5,2,1,1,1,0,2,2,100,0,0,0,0,0,2,0,0
277,Zé Marcos,br BRA,DF,Vitória,,27.25479452,1998,5.5,5,5,2,2,1,3,3,100,0,4,2,2,3,8,30,0
278,Marinho,br BRA,FW,Fortaleza,,34.93424658,1990,1.9,1,1,1,0,0,0,0,,0,0,0,0,2,3,1,0
279,Marlon,br BRA,DF,Cruzeiro,,27.95890411,1997,0.1,0,0,0,0,0,0,0,,0,0,0,0,0,0,0,0
280,Marlon,br BRA,DF,Grêmio,,27.95890411,1997,3,8,7,7,1,0,6,12,50,6,3,1,2,8,16,14,0
281,Marquinhos,br BRA,"FW,MF",Cruzeiro,,22.07671233,2003,0.5,3,0,1,1,1,1,2,50,1,0,0,0,0,3,0,0
282,Juan Martín Lucero,ar ARG,FW,Fortaleza,,33.42739726,1991,4.3,5,0,1,1,3,2,8,25,6,2,0,2,0,5,5,1
283,Martinelli,br BRA,MF,Fluminense,,23.98630137,2001,6.6,8,7,5,2,1,3,5,60,2,11,1,10,5,13,9,0
284,Alejandro Martínez,ar ARG,FW,Ceará,,28.05205479,1997,0.5,0,0,0,0,0,0,2,0,2,1,0,1,1,1,1,0
285,Emiliano Martínez,uy URU,MF,Palmeiras,,25.71506849,1999,4,13,10,7,6,0,9,15,60,6,2,1,1,3,16,7,0
286,Adriano Martins,br BRA,DF,Juventude,,28.09315068,1997,4,5,3,3,1,1,3,3,100,0,4,3,1,6,11,27,0
287,Andre Martins,br BRA,FW,Grêmio,,23.38082192,2001,0.5,0,0,0,0,0,0,0,,0,0,0,0,0,0,1,0
288,Matheus Martins,br BRA,"FW,MF",Botafogo (RJ),,21.80273973,2003,3.1,8,6,2,6,0,4,7,57.1,3,1,0,1,1,9,1,0
289,Gonzalo Mastriani,uy URU,FW,Botafogo (RJ),,32.01917808,1993,1.8,1,1,1,0,0,1,2,50,1,0,0,0,2,3,0,0
290,Matheusinho,br BRA,MF,Vitória,,27.54520548,1997,5.8,5,3,0,3,2,1,3,33.3,2,1,1,0,7,12,2,0
291,Matheuzinho,br BRA,DF,Corinthians,,24.65479452,2000,5,12,6,9,3,0,9,15,60,6,3,2,1,10,22,9,1
292,Guillermo Matías Fernández,ar ARG,MF,Fortaleza,,33.56438356,1991,2,6,3,3,2,1,4,4,100,0,3,2,1,0,6,4,0
293,Mauricio,br BRA,"MF,FW",Palmeiras,,23.95342466,2001,1,0,0,0,0,0,0,1,0,1,0,0,0,0,0,0,0
294,Maycon,br BRA,MF,Corinthians,,27.80547945,1997,2,8,7,6,1,1,4,5,80,1,1,0,1,2,10,0,0
295,Mayke,br BRA,DF,Palmeiras,,32.48219178,1992,0.7,2,1,2,0,0,1,1,100,0,0,0,0,0,2,2,0
296,Luca Meirelles,br BRA,MF,Santos,,18.13972603,2007,0.1,0,0,0,0,0,0,0,,0,0,0,0,0,0,0,0
297,Memphis,nl NED,FW,Corinthians,,31.22191781,1994,5.4,2,0,0,1,1,1,2,50,1,3,0,3,0,2,0,0
298,Vinicius Mendonça,br BRA,FW,RB Bragantino,,21.20273973,2004,3.5,7,3,2,3,2,1,10,10,9,5,0,5,4,11,3,0
299,Jean Meneses,cl CHI,FW,Vasco da Gama,,32.1369863,1993,0,1,1,0,1,0,1,1,100,0,0,0,0,0,1,0,0
300,Gabriel Menino,br BRA,MF,Atlético Mineiro,,24.59726027,2000,2.2,0,0,0,0,0,0,1,0,1,1,0,1,1,1,1,0
301,Micael,br BRA,DF,Palmeiras,,24.72876712,2000,5,10,7,5,4,1,6,7,85.7,1,3,1,2,1,11,41,1
302,Michael,br BRA,FW,Flamengo,,29.14794521,1996,3.1,3,0,0,1,2,1,6,16.7,5,5,0,5,1,4,1,0
303,Fernando Miguel,br BRA,GK,Ceará,,40.25205479,1985,3.3,0,0,0,0,0,0,0,,0,0,0,0,0,0,2,0
304,Moises,br BRA,"FW,MF",Fortaleza,,28.67123288,1996,1.6,1,0,0,0,1,1,2,50,1,1,0,1,0,1,0,0
305,Miguel Monsalve,co COL,"MF,FW",Grêmio,,21.18356164,2004,1.8,4,4,2,2,0,2,3,66.7,1,1,1,0,0,4,0,0
306,Aníbal Moreno,ar ARG,MF,Palmeiras,,25.97808219,1999,2.7,7,4,4,2,1,7,9,77.8,2,4,2,2,2,9,5,0
307,Henry Mosquera,co COL,FW,RB Bragantino,,23.46849315,2001,3.2,9,5,3,4,2,5,6,83.3,1,2,0,2,1,10,2,0
308,Gustavo Mosquito,br BRA,FW,Vitória,,27.65753425,1997,3.3,1,0,1,0,0,0,4,0,4,1,0,1,2,3,5,0
309,Hugo Moura,br BRA,MF,Vasco da Gama,,27.33424658,1998,6.2,19,10,11,7,1,10,17,58.8,7,6,1,5,9,28,26,2
310,Lucas Moura,br BRA,FW,São Paulo,,32.7260274,1992,0.3,0,0,0,0,0,0,0,,0,1,0,1,1,1,1,0
311,Neto Moura,br BRA,MF,Mirassol,,28.74520548,1996,4.2,8,3,2,5,1,3,4,75,1,6,1,5,4,12,7,0
312,Lucas Mugni,ar ARG,MF,Ceará,,33.30958904,1992,4.5,17,13,10,5,2,7,10,70,3,10,1,9,3,20,0,0
313,Alex Muralha,br BRA,GK,Mirassol,,35.48219178,1989,6,0,0,0,0,0,0,0,,0,0,0,0,0,0,9,1
314,Nata,br BRA,MF,Juventude,,23.91506849,2001,0.3,1,0,1,0,0,1,1,100,0,1,0,1,1,2,1,0
315,Natanael,br BRA,DF,Atlético Mineiro,,23.32876712,2002,4.5,8,6,4,4,0,4,9,44.4,5,5,1,4,3,11,5,0
316,Nathan,br BRA,DF,Internacional,,23.6630137,2001,1,4,0,2,1,1,1,2,50,1,1,0,1,0,4,1,0
317,Nathan,br BRA,FW,Grêmio,,29.14520548,1996,0.4,0,0,0,0,0,0,0,,0,2,0,2,0,0,1,0
318,Kaiky Naves,br BRA,DF,Palmeiras,,22.99178082,2002,0.2,1,0,0,1,0,1,1,100,0,0,0,0,0,1,3,0
319,Negueba,br BRA,FW,Mirassol,,25.41917808,1999,2,4,2,1,3,0,2,2,100,0,1,0,1,0,4,4,0
320,Nenê,br BRA,MF,Juventude,,43.79452055,1981,0.3,0,0,0,0,0,0,0,,0,0,0,0,0,0,0,0
321,Neris,br BRA,DF,Vitória,,32.88219178,1992,1.5,1,1,1,0,0,0,1,0,1,2,1,1,1,2,10,0
322,Rodrigo Nestor,br BRA,MF,Bahia,,24.7369863,2000,1.5,3,2,0,3,0,2,2,100,0,1,0,1,0,3,0,0
323,Newton,br BRA,MF,Botafogo (RJ),,25.14794521,2000,1.3,1,1,0,1,0,1,3,33.3,2,2,0,2,1,2,3,0
324,Neymar,br BRA,MF,Santos,,33.24383562,1992,0.9,0,0,0,0,0,0,1,0,1,0,0,0,0,0,0,0
325,Nicolas,br BRA,"DF,FW",Ceará,,28.19178082,1997,0.1,0,0,0,0,0,0,0,,0,0,0,0,1,1,0,0
326,Nonato,br BRA,MF,Fluminense,,27.17260274,1998,1.3,6,5,2,4,0,4,4,100,0,1,1,0,2,8,2,0
327,Sérgio Oliveira,pt POR,MF,Sport Recife,,32.92328767,1992,3.7,8,7,2,6,0,5,9,55.6,4,2,0,2,2,10,1,1
328,Cauly Oliveira Souza,br BRA,"FW,MF",Bahia,,29.63561644,1995,3.2,1,1,0,1,0,0,1,0,1,1,0,1,2,3,0,0
329,Cristian Olivera,uy URU,FW,Grêmio,,23.04931507,2002,3.8,8,8,1,3,4,4,7,57.1,3,3,0,3,1,9,1,0
330,Christian Ortiz,ar ARG,MF,Sport Recife,,32.70684932,1992,0.9,1,1,0,1,0,1,3,33.3,2,1,0,1,1,2,0,0
331,Leo Ortiz,br BRA,DF,Flamengo,,29.33424658,1996,6,6,6,4,2,0,1,1,100,0,3,3,0,4,10,15,1
332,Osvaldo,br BRA,"FW,MF",Vitória,,38.06575342,1987,0.4,0,0,0,0,0,0,0,,0,0,0,0,0,0,1,0
333,Luis Otávio,br BRA,MF,Internacional,,18.0630137,2007,0.3,2,2,0,2,0,1,3,33.3,2,1,0,1,0,2,0,0
334,Pablo,br BRA,FW,Sport Recife,,32.86575342,1992,2.9,3,3,1,2,0,1,1,100,0,3,0,3,1,4,5,0
335,Ruan Pablo,br BRA,FW,Bahia,,16.78356164,2008,0.1,0,0,0,0,0,0,0,,0,0,0,0,0,0,0,0
336,Bruno Pacheco,br BRA,DF,Fortaleza,,33.40547945,1991,2,7,6,6,1,0,5,7,71.4,2,1,0,1,0,7,7,0
337,Gonçalo Paciência,pt POR,FW,Sport Recife,,30.75890411,1994,0.9,0,0,0,0,0,0,0,,0,0,0,0,0,0,1,0
338,Alan Patrick,br BRA,"MF,FW",Internacional,,33.97808219,1991,5.2,8,6,1,5,2,6,13,46.2,7,3,0,3,0,8,0,1
339,Jair Paula,br BRA,DF,Botafogo (RJ),,20.16164384,2005,7,11,8,7,4,0,6,8,75,2,6,3,3,7,18,36,0
340,Patrick de Paula,br BRA,MF,Botafogo (RJ),,25.65479452,1999,3.2,6,3,1,4,1,3,8,37.5,5,3,3,0,4,10,2,0
341,Paulinho,br BRA,"MF,FW",Vasco da Gama,,28.32054795,1997,1.7,6,3,3,3,0,3,8,37.5,5,2,0,2,2,8,3,1
342,Paulinho,br BRA,"MF,FW",Palmeiras,,24.80547945,2000,1,1,1,1,0,0,0,1,0,1,3,1,2,0,1,0,0
343,Caio Paulista,br BRA,DF,Atlético Mineiro,,26.98356164,1998,1.3,8,4,4,1,3,5,6,83.3,1,3,2,1,1,9,2,0
344,Marcos Paulo,br BRA,DF,Juventude,,22.29315068,2003,1.5,2,2,2,0,0,1,2,50,1,1,0,1,2,4,10,0
345,Cristian Pavón,ar ARG,FW,Grêmio,,29.28493151,1996,2.4,3,2,2,0,1,3,6,50,3,3,1,2,3,6,3,0
346,Dimitri Payet,fr FRA,MF,Vasco da Gama,,38.10136986,1987,2.1,3,3,0,2,1,1,3,33.3,2,0,0,0,2,5,0,0
347,Pedro,br BRA,FW,Flamengo,,27.8739726,1997,2.2,1,1,0,1,0,0,0,,0,1,0,1,0,1,2,0
348,João Pedro Chermont,br BRA,DF,Santos,,19.29315068,2006,2.8,10,8,5,5,0,7,7,100,0,1,0,1,3,13,13,0
349,João Pedro,br BRA,DF,Corinthians,,21.34246575,2003,0.5,2,1,1,1,0,1,2,50,1,1,1,0,0,2,0,0
350,João Pedro,br BRA,DF,Grêmio,,28.46849315,1996,3.3,6,4,3,3,0,2,3,66.7,1,1,0,1,1,7,10,0
351,João Pedro Pepê,br BRA,MF,Vitória,,27.3260274,1998,1.9,8,5,1,4,3,4,6,66.7,2,3,1,2,2,10,1,0
352,Léo Pereira,br BRA,DF,Flamengo,,29.25753425,1996,7,5,3,3,1,1,4,9,44.4,5,7,5,2,1,6,18,0
353,Matheus Pereira,br BRA,MF,Cruzeiro,,29,1996,5.1,11,9,2,7,2,4,9,44.4,5,5,0,5,3,14,0,0
354,Luan Peres Petroni,br BRA,DF,Santos,,30.79452055,1994,1,2,0,2,0,0,1,1,100,0,1,1,0,1,3,6,0
355,Pernambuco,br BRA,"FW,MF",Juventude,,27.01917808,1998,0.4,3,2,1,1,1,0,1,0,1,2,1,1,0,3,0,0
356,Petterson,br BRA,MF,Juventude,,21.33150685,2004,0.9,0,0,0,0,0,0,1,0,1,3,0,3,1,1,1,0
357,Yago Pikachu,br BRA,"DF,MF",Fortaleza,,32.91506849,1992,5.8,7,4,5,2,0,6,8,75,2,5,2,3,2,9,4,0
358,Joaquín Piquerez,uy URU,"DF,MF",Palmeiras,,26.69589041,1998,6.5,7,3,3,3,1,7,9,77.8,2,10,3,7,8,15,19,0
359,Rafael Pires,br BRA,GK,São Paulo,,35.86575342,1989,7,0,0,0,0,0,0,0,,0,0,0,0,0,0,1,1
360,Lucas Piton,br BRA,DF,Vasco da Gama,,24.56986301,2000,6,7,7,1,4,2,3,5,60,2,2,0,2,3,10,14,0
361,Isidro Pitta,py PAR,FW,RB Bragantino,,25.72328767,1999,0.9,0,0,0,0,0,0,0,,0,0,0,0,0,0,0,0
362,Diego Pituca,br BRA,MF,Santos,,32.72054795,1992,2.2,3,2,2,1,0,1,4,25,3,2,1,1,2,5,5,0
363,Gonzalo Plata,ec ECU,"FW,MF",Flamengo,,24.50684932,2000,2.4,5,3,2,1,2,1,6,16.7,5,4,0,4,1,6,1,0
364,Tomas Pochettino,ar ARG,MF,Fortaleza,,29.25479452,1996,0.2,0,0,0,0,0,0,1,0,1,1,0,1,1,1,1,0
365,Mateo Ponte,uy URU,DF,Botafogo (RJ),,21.94794521,2003,1.1,0,0,0,0,0,0,1,0,1,0,0,0,2,2,1,0
366,Gustavo Prado,br BRA,"MF,FW",Internacional,,19.91232877,2005,0.5,1,0,0,0,1,0,0,,0,0,0,0,0,1,0,0
367,Lucca Prior,br BRA,FW,Fortaleza,,21.22465753,2004,0.2,1,0,1,0,0,1,1,100,0,0,0,0,0,1,1,0
368,Erick Pulga,br BRA,FW,Bahia,,24.5890411,2000,5.4,9,5,4,3,2,2,6,33.3,4,3,0,3,5,14,9,0
369,Erick Pulgar,cl CHI,MF,Flamengo,,31.30136986,1994,6.5,9,8,1,6,2,3,10,30,7,4,2,2,12,21,10,1
370,Du Queiroz,br BRA,MF,Sport Recife,,25.29041096,2000,5,6,5,1,1,4,0,4,0,4,5,1,4,4,10,2,0
371,Igor Rabello,br BRA,FW,Atlético Mineiro,,30.01917808,1995,0.1,0,0,0,0,0,0,0,,0,0,0,0,0,0,1,0
372,André Ramalho,br BRA,DF,Corinthians,,33.21369863,1992,5,4,1,2,2,0,2,4,50,2,2,2,0,6,10,25,0
373,Eric Ramires,br BRA,MF,RB Bragantino,,24.73424658,2000,3.6,5,4,2,2,1,3,8,37.5,5,1,1,0,6,11,4,0
374,Ramon,br BRA,DF,Internacional,,24.14520548,2001,1.1,3,2,0,3,0,1,2,50,1,2,1,1,0,3,3,1
375,Lucas Ramon,br BRA,DF,Mirassol,,31.16164384,1994,4.4,10,7,5,4,1,4,11,36.4,7,4,1,3,11,21,17,0
376,Santi Ramos Mingo,ar ARG,DF,Bahia,,23.45205479,2001,7,9,6,6,2,1,5,8,62.5,3,13,11,2,5,14,27,0
377,Rafael Ramos,pt POR,DF,Ceará,,30.31780822,1995,2.7,8,5,7,0,1,6,9,66.7,3,3,1,2,2,10,11,0
378,Raniele,br BRA,MF,Corinthians,,28.34246575,1996,4.7,7,7,2,3,2,2,7,28.6,5,5,2,3,6,13,6,0
379,Wellington Rato,br BRA,"FW,MF",Vitória,,32.85205479,1992,1.4,0,0,0,0,0,0,0,,0,3,0,3,0,0,0,0
380,Pedro Raul,br BRA,FW,Ceará,,28.49589041,1996,6.8,4,2,0,4,0,1,4,25,3,2,1,1,0,4,7,0
381,Reginaldo,br BRA,DF,Juventude,,32.19726027,1993,0.4,1,0,0,1,0,0,0,,0,3,1,2,1,2,1,0
382,Reinaldo,br BRA,DF,Mirassol,,35.6,1989,5.1,6,3,4,0,2,5,9,55.6,4,4,1,3,3,9,19,1
383,Cristian Renato,br BRA,FW,Mirassol,,25.20821918,2000,3.3,2,2,0,1,1,1,3,33.3,2,1,0,1,1,3,2,0
384,Renê,br BRA,DF,Fluminense,,32.63835616,1992,5.9,15,8,8,7,0,5,12,41.7,7,7,1,6,10,25,21,0
385,Everton Ribeiro,br BRA,MF,Bahia,,36.06849315,1989,3.5,10,7,4,3,3,3,7,42.9,4,1,1,0,1,11,4,0
386,Ricardo,br BRA,MF,Vitória,,31.18356164,1994,4,9,4,3,2,4,5,6,83.3,1,6,2,4,4,13,9,1
387,João Ricardo Riedi,br BRA,GK,Fortaleza,,36.66027397,1988,7,0,0,0,0,0,0,0,,0,0,0,0,0,0,5,0
388,Charles Rigon Matos,br BRA,"DF,MF",Corinthians,,28.87671233,1996,0.5,0,0,0,0,0,0,0,,0,0,0,0,1,1,3,0
389,Tomás Rincón,ve VEN,MF,Santos,,37.30684932,1988,1.2,3,0,1,2,0,1,3,33.3,2,1,1,0,2,5,1,1
390,Richard Ríos,co COL,MF,Palmeiras,,24.92328767,2000,5.1,7,5,5,2,0,2,11,18.2,9,13,1,12,6,13,3,0
391,Christian Rivera,co COL,MF,Sport Recife,,29.30410959,1996,5.7,15,11,7,8,0,6,13,46.2,7,6,1,5,6,21,7,1
392,Sergio Rochet,uy URU,GK,Internacional,,32.11780822,1993,0.5,0,0,0,0,0,0,0,,0,0,0,0,0,0,0,0
393,Rodrigo,br BRA,"FW,MF",São Paulo,,21.1369863,2004,0.2,3,3,0,3,0,1,2,50,1,0,0,0,0,3,1,0
394,Guzmán Rodríguez,uy URU,DF,RB Bragantino,,25.23561644,2000,6,6,4,3,3,0,3,8,37.5,5,5,5,0,2,8,37,0
395,Luciano Rodríguez,uy URU,FW,Bahia,,21.80273973,2003,3.1,4,3,2,2,0,0,1,0,1,6,1,5,1,5,1,0
396,Santiago Rodríguez,uy URU,"MF,FW",Botafogo (RJ),,25.32054795,2000,0.8,1,1,1,0,0,1,1,100,0,2,1,1,1,2,0,0
397,Rodriguinho,br BRA,FW,Cruzeiro,,21.91506849,2003,0.2,0,0,0,0,0,0,1,0,1,0,0,0,0,0,0,0
398,Agustín Rogel,uy URU,DF,Internacional,,27.54794521,1997,4,8,5,6,2,0,5,9,55.6,4,4,3,1,1,9,21,0
399,Benjamín Rollheiser,ar ARG,"MF,FW",Santos,,25.11506849,2000,5.2,6,5,2,3,1,3,9,33.3,6,0,0,0,0,6,2,0
400,Iván Román,cl CHI,DF,Atlético Mineiro,,18.81369863,2006,1,2,1,0,2,0,2,3,66.7,1,0,0,0,0,2,7,0
401,Romarinho,br BRA,FW,Sport Recife,,31.17808219,1994,0.1,0,0,0,0,0,0,1,0,1,0,0,0,0,0,0,0
402,Ángel Romero,py PAR,"FW,MF",Corinthians,,32.83561644,1992,4.9,7,6,3,3,1,3,7,42.9,4,2,0,2,4,11,2,0
403,Lucas Romero,ar ARG,MF,Cruzeiro,,31.04657534,1994,6.5,23,11,6,14,3,12,22,54.5,10,6,1,5,5,28,8,0
404,Óscar Romero,py PAR,MF,Internacional,,32.83561644,1992,1.6,6,4,0,4,2,3,4,75,1,0,0,0,1,7,0,0
405,Romulo,br BRA,MF,Ceará,,23.57534247,2001,0.8,1,1,0,1,0,0,1,0,1,1,0,1,0,1,2,0
406,Rômulo,br BRA,DF,Atlético Mineiro,,21.25753425,2004,0.7,2,2,1,1,0,1,1,100,0,0,0,0,2,4,5,0
407,Ronald,br BRA,MF,Vitória,,27.87945205,1997,3.2,3,3,1,2,0,1,1,100,0,2,0,2,1,4,2,0
408,Ronaldo,br BRA,GK,Bahia,,28.70136986,1996,3.2,0,0,0,0,0,0,0,,0,0,0,0,0,0,2,0
409,Ronaldo,br BRA,MF,Internacional,,28.53150685,1996,3.6,14,11,5,8,1,4,7,57.1,3,2,1,1,3,17,10,0
410,Budiga Roni,br BRA,MF,Mirassol,,26.05479452,1999,0.4,1,0,1,0,0,1,1,100,0,0,0,0,3,4,1,0
411,Rony,br BRA,"FW,MF",Atlético Mineiro,,29.98356164,1995,5.8,6,2,0,3,3,1,2,50,1,5,2,3,2,8,2,0
412,Vitor Roque,br BRA,FW,Palmeiras,,20.18082192,2005,4.3,4,4,1,0,3,1,3,33.3,2,5,0,5,3,7,2,0
413,Diego Rosa,br BRA,"MF,DF",Internacional,,22.56164384,2002,0.6,3,1,0,1,2,1,2,50,1,1,0,1,0,3,2,0
414,Matheus Rossetto,br BRA,MF,Fortaleza,,28.92054795,1996,4.2,10,4,4,5,1,5,8,62.5,3,4,1,3,0,10,10,0
415,Agustín Rossi,ar ARG,GK,Flamengo,,29.70410959,1995,7,0,0,0,0,0,0,0,,0,0,0,0,0,0,1,0
416,Ruan,br BRA,DF,São Paulo,,25.90958904,1999,3,1,1,1,0,0,1,1,100,0,5,4,1,6,7,27,1
417,Rubens,br BRA,"MF,DF",Atlético Mineiro,,23.87123288,2001,4.6,17,12,7,8,2,8,10,80,2,7,0,7,9,26,13,0
418,Alan Ruschel,br BRA,DF,Juventude,,35.69863014,1989,2.6,4,1,2,2,0,0,2,0,2,3,1,2,3,7,3,0
419,Rwan,br BRA,FW,Botafogo (RJ),,23.95890411,2001,0.2,0,0,0,0,0,0,1,0,1,0,0,0,0,0,0,0
420,José Sabino,br BRA,DF,São Paulo,,28.5260274,1996,2.5,3,3,3,0,0,1,1,100,0,1,1,0,6,9,8,0
421,Rodrigo Sam,br BRA,DF,Juventude,,29.78082192,1995,1,3,3,3,0,0,0,1,0,1,0,0,0,1,4,8,0
422,Alex Sandro,br BRA,DF,Flamengo,,34.27123288,1991,4.4,4,3,3,0,1,2,4,50,2,3,1,2,8,12,6,0
423,Agustín Sant'Anna,uy URU,DF,RB Bragantino,,27.60273973,1997,0.3,1,0,1,0,0,1,1,100,0,0,0,0,2,3,0,0
424,Alex Santana,br BRA,MF,Corinthians,,29.97808219,1995,0.9,0,0,0,0,0,0,1,0,1,0,0,0,0,0,1,0
425,Ademir Santos,br BRA,FW,Bahia,,30.21369863,1995,4.4,8,6,2,2,4,4,13,30.8,9,2,0,2,1,9,2,0
426,Eduardo Santos,br BRA,DF,RB Bragantino,,27.43287671,1997,0.4,2,2,2,0,0,0,0,,0,4,3,1,2,4,8,0
427,Júnior Santos,br BRA,MF,Atlético Mineiro,,30.56438356,1994,0.4,0,0,0,0,0,0,0,,0,0,0,0,0,0,0,0
428,Renzo Saravia,ar ARG,DF,Atlético Mineiro,,31.88493151,1993,1.2,3,3,1,1,1,2,4,50,2,0,0,0,0,3,2,0
429,Eduardo Sasha,br BRA,"FW,MF",RB Bragantino,,33.19178082,1992,5.4,5,2,0,2,3,1,3,33.3,2,2,1,1,1,6,7,0
430,Lucas Sasha,br BRA,MF,Fortaleza,,35.17808219,1990,5.9,21,12,9,12,0,9,25,36,16,12,0,12,3,24,8,0
431,Jefferson Savarino,ve VEN,"MF,FW",Botafogo (RJ),,28.47945205,1996,5.7,1,1,0,1,0,0,2,0,2,1,0,1,1,2,2,0
432,Gustavo Scarpa,br BRA,"MF,FW",Atlético Mineiro,,31.32876712,1994,4.9,1,1,1,0,0,1,6,16.7,5,4,2,2,1,2,3,1
433,João Schmidt,br BRA,MF,Santos,,31.96164384,1993,6.8,14,9,1,9,4,6,18,33.3,12,12,5,7,9,23,14,0
434,Cleiton Schwengber,br BRA,GK,RB Bragantino,,27.70958904,1997,5,0,0,0,0,0,0,1,0,1,0,0,0,0,0,1,0
435,Kevin Serna,co COL,FW,Fluminense,,27.38082192,1997,1.4,2,2,1,0,1,1,3,33.3,2,0,0,0,0,2,1,0
436,Igor Serrote,br BRA,DF,Grêmio,,20.17808219,2005,3.2,15,9,11,4,0,14,17,82.4,3,5,5,0,10,25,21,0
437,Aderlan Silva,br BRA,DF,Santos,,34.71232877,1990,0.3,0,0,0,0,0,0,0,,0,2,0,2,0,0,1,0
438,André Silva,br BRA,FW,São Paulo,,27.92054795,1997,4.9,4,3,0,1,3,1,3,33.3,2,6,2,4,2,6,5,0
439,João Silva,pt POR,DF,Sport Recife,,26.30410959,1999,7,6,4,4,1,1,1,5,20,4,9,7,2,6,12,31,0
440,Lucas Silva,br BRA,MF,Cruzeiro,,32.21369863,1993,4.8,12,5,5,6,1,8,11,72.7,3,7,2,5,1,13,4,0
441,Thiago Silva,br BRA,DF,Fluminense,,40.61643836,1984,3,1,0,1,0,0,0,1,0,1,2,2,0,2,3,12,1
442,Cédric Soares,pt POR,"DF,FW",São Paulo,,33.67671233,1991,4.5,6,4,3,2,1,2,4,50,2,5,3,2,2,8,17,1
443,Everton Soares,br BRA,"FW,MF",Flamengo,,29.12054795,1996,3.3,3,3,1,2,0,1,3,33.3,2,3,0,3,2,5,1,0
444,Tiquinho Soares,br BRA,FW,Santos,,34.29589041,1991,5.2,4,3,0,2,2,2,3,66.7,1,2,0,2,1,5,4,0
445,Fernando Sobral,br BRA,MF,Ceará,,30.38082192,1994,5.5,19,15,8,9,2,5,15,33.3,10,7,2,5,6,25,7,0
446,Yeferson Soteldo,ve VEN,"FW,MF",Santos,,27.84657534,1997,1.8,2,1,0,1,1,1,2,50,1,1,0,1,0,2,1,0
447,Fabiano Souza,br BRA,DF,Ceará,,25.14246575,2000,5.5,9,7,4,5,0,6,7,85.7,1,4,1,3,6,15,19,1
448,Hugo Souza,br BRA,GK,Corinthians,,26.25753425,1999,2,0,0,0,0,0,0,0,,0,0,0,0,0,0,0,1
449,Igor Vinícius de Souza,br BRA,DF,São Paulo,,28.09315068,1997,1.8,2,1,0,2,0,0,1,0,1,1,0,1,1,3,0,0
450,Everaldo Stum,br BRA,FW,Fluminense,,33.83287671,1991,1.7,2,1,0,2,0,1,1,100,0,0,0,0,0,2,0,0
451,Bruno Tabata,br BRA,"FW,MF",Internacional,,28.09863014,1997,2,3,2,1,2,0,2,5,40,3,1,0,1,2,5,3,0
452,Gabriel Taliari,br BRA,FW,Juventude,,28.06027397,1997,2.9,3,2,2,0,1,1,5,20,4,1,1,0,0,3,1,0
453,Tchê Tchê,br BRA,"MF,FW",Vasco da Gama,,32.67945205,1992,2.3,1,0,0,1,0,0,0,,0,1,0,1,2,3,0,0
454,Alex Teixeira,br BRA,"MF,FW",Vasco da Gama,,35.3260274,1990,0.8,3,1,1,2,0,0,1,0,1,1,0,1,0,3,4,0
455,Alex Telles,br BRA,DF,Botafogo (RJ),,32.38630137,1992,2.6,5,4,2,3,0,2,4,50,2,1,0,1,4,9,10,0
456,Thaciano,br BRA,"MF,FW",Santos,,29.98082192,1995,2.2,4,3,0,2,2,2,4,50,2,1,0,1,1,5,0,0
457,Tiago,br BRA,FW,Bahia,,20.0739726,2005,0.4,1,0,0,1,0,0,0,,0,0,0,0,0,1,0,0
458,Guilherme Tinga,br BRA,DF,Fortaleza,,31.6739726,1993,2,5,2,4,1,0,4,6,66.7,2,4,3,1,2,7,17,0
459,Titi,br BRA,DF,Fortaleza,,37.14794521,1988,3,4,1,2,2,0,2,4,50,2,2,2,0,10,14,11,0
460,Félix Torres Caicedo,ec ECU,DF,Corinthians,,28.31232877,1997,3,4,2,3,1,0,3,3,100,0,2,1,1,7,11,10,0
461,Facundo Torres,uy URU,"MF,FW",Palmeiras,,25.06027397,2000,5.8,4,3,2,1,1,2,6,33.3,4,8,1,7,1,5,4,0
462,Bruno Tubarão,br BRA,FW,Ceará,,30.16712329,1995,0.1,2,2,0,2,0,2,2,100,0,0,0,0,0,2,0,0
463,Enner Valencia,ec ECU,FW,Internacional,,35.49863014,1989,4.4,1,1,0,1,0,0,2,0,2,1,1,0,1,2,3,0
464,Vanderlan,br BRA,DF,Palmeiras,,22.65753425,2002,0.5,0,0,0,0,0,0,0,,0,3,1,2,2,2,0,0
465,Guillermo Varela,uy URU,DF,Flamengo,,32.11506849,1993,0.4,1,0,1,0,0,0,0,,0,0,0,0,0,1,1,0
466,Pablo Vegetti,ar ARG,FW,Vasco da Gama,,36.55342466,1988,5.2,2,1,0,1,1,1,6,16.7,5,1,0,1,2,4,7,0
467,Raphael Veiga,br BRA,MF,Palmeiras,,29.87671233,1995,1.1,2,1,1,1,0,0,0,,0,2,1,1,0,2,0,0
468,Fausto Vera,ar ARG,MF,Atlético Mineiro,,25.10958904,2000,3.1,3,1,1,2,0,2,5,40,3,4,2,2,2,5,6,0
469,Gabriel Veron,br BRA,FW,Santos,,22.66849315,2002,1.3,6,5,4,2,0,2,5,40,3,1,1,0,0,6,0,0
470,João Victor,br BRA,DF,Mirassol,,27.67123288,1997,6,3,2,0,2,1,1,1,100,0,13,10,3,3,6,42,0
471,João Victor,br BRA,FW,Ceará,,21.02191781,2004,0.1,0,0,0,0,0,0,0,,0,1,0,1,0,0,0,0
472,João Victor,br BRA,DF,Vasco da Gama,,26.8,1998,7,17,15,14,3,0,8,8,100,0,12,5,7,7,24,44,2
473,Viery,br BRA,DF,Grêmio,,20.3369863,2005,0.3,0,0,0,0,0,0,0,,0,4,2,2,0,0,4,1
474,Lucas Villalba,ar ARG,DF,Cruzeiro,,30.70958904,1994,5,7,5,4,3,0,5,6,83.3,1,7,5,2,5,12,39,0
475,Mathías Villasanti,py PAR,MF,Grêmio,,28.27671233,1997,5.5,21,16,7,11,3,9,14,64.3,5,8,1,7,9,30,14,0
476,Vitão,br BRA,DF,Internacional,,25.25205479,2000,7,11,7,8,3,0,6,10,60,4,7,2,5,5,16,31,0
477,Vitinho,br BRA,"FW,MF",Internacional,,26.09315068,1999,3.1,5,1,3,2,0,2,6,33.3,4,6,1,5,2,7,1,0
478,Vitinho,br BRA,DF,Botafogo (RJ),,25.78356164,1999,5.9,10,6,6,2,2,5,10,50,5,6,0,6,4,14,15,0
479,Rayan Vitor,br BRA,FW,Vasco da Gama,,18.75342466,2006,4.1,4,0,1,2,1,1,1,100,0,1,0,1,1,5,7,0
480,Tiago Volpi,br BRA,GK,Grêmio,,34.37534247,1990,7,0,0,0,0,0,0,1,0,1,0,0,0,0,0,2,0
481,Wagner,br BRA,DF,Grêmio,,25.78356164,1999,6.3,10,4,7,3,0,3,7,42.9,4,5,4,1,9,19,48,1
482,Walace,br BRA,MF,Cruzeiro,,30.08493151,1995,0.9,1,0,0,1,0,1,5,20,4,1,0,1,1,2,0,0
483,Wallace,br BRA,MF,Flamengo,,20.23561644,2005,0.2,0,0,0,0,0,0,0,,0,0,0,0,0,0,0,0
484,Wanderson,br BRA,"FW,MF",Cruzeiro,,30.57534247,1994,6.1,5,5,3,2,0,4,12,33.3,8,6,1,5,2,7,2,0
485,Deivid Washington,br BRA,FW,Santos,,19.91506849,2005,2,0,0,0,0,0,0,2,0,2,0,0,0,1,1,1,0
486,José Welison,br BRA,MF,Fortaleza,,30.15068493,1995,1.9,8,3,5,2,1,4,5,80,1,4,1,3,1,9,5,0
487,Wendell,br BRA,DF,São Paulo,,31.79178082,1993,3.1,5,4,2,1,2,1,1,100,0,1,1,0,4,9,10,0
488,Wesley,br BRA,DF,Flamengo,,21.66027397,2003,6.9,16,10,9,6,1,8,16,50,8,7,1,6,7,23,12,1
489,Wesley,br BRA,"FW,MF",Internacional,,26.09863014,1999,5,16,10,4,8,4,8,12,66.7,4,4,1,3,4,20,3,0
490,Wéverton,br BRA,GK,Palmeiras,,37.39178082,1987,7,0,0,0,0,0,0,0,,0,0,0,0,0,0,4,1
491,William,br BRA,DF,Cruzeiro,,30.08767123,1995,2.5,9,5,7,2,0,8,19,42.1,11,8,2,6,4,13,7,0
492,Willian,br BRA,MF,Vitória,,31.96986301,1993,1.5,1,0,0,1,0,1,4,25,3,0,0,0,2,3,3,0
493,Estêvão Willian,br BRA,"FW,MF",Palmeiras,,18.03013699,2007,5.4,2,1,2,0,0,0,5,0,5,1,0,1,0,2,0,0
494,Mateus Xavier,br BRA,"MF,FW",Santos,,17.84931507,2007,0.2,1,1,0,0,1,1,1,100,0,0,0,0,0,1,0,0
495,Samuel Xavier,br BRA,DF,Fluminense,,34.91232877,1990,5.4,8,5,5,1,2,5,7,71.4,2,7,2,5,1,9,20,0
496,Yago,br BRA,MF,Mirassol,,30.24931507,1995,2.1,6,0,2,4,0,1,5,20,4,2,1,1,2,8,0,1
497,Lukas Zuccarello,br BRA,FW,Vasco da Gama,,18.42191781,2006,0.2,1,1,1,0,0,1,1,100,0,0,0,0,0,1,0,0
1,Saminu Abdullahi,ng NGA,MF,FC Juárez,,24.33424658,2001,0.5,1,1,1,0,0,0,1,0,1,0,0,0,1,2,1,0
2,José Abella,mx MEX,DF,Santos,,31.23013699,1994,16.8,35,22,15,16,4,15,33,45.5,18,16,8,8,20,55,69,1
3,José Abella,mx MEX,DF,FC Juárez,,31.23013699,1994,11.3,22,14,14,8,0,14,26,53.8,12,8,5,3,14,36,32,1
4,Diego Abitia,mx MEX,FW,Atlético,,22.05205479,2003,3.6,3,1,1,1,1,1,2,50,1,0,0,0,1,4,3,0
5,Carlos Acevedo,mx MEX,GK,Santos,,29.04383562,1996,33,1,0,1,0,0,1,2,50,1,0,0,0,0,1,18,3
6,Alonso Aceves,mx MEX,DF,Pachuca,,24.10410959,2001,14.8,36,21,26,10,0,17,19,89.5,2,19,8,11,12,48,70,1
7,Gilberto Adame,mx MEX,"DF,MF",Mazatlán,,20.50684932,2004,4.6,8,7,6,2,0,3,6,50,3,6,1,5,0,8,15,0
8,Sergio Aguayo,us USA,FW,Pachuca,,22.44383562,2002,1.8,4,2,0,1,3,0,2,0,2,0,0,0,0,4,2,0
9,Eduardo Águila,mx MEX,DF,Atlético,,22.96712329,2002,30,41,26,29,11,1,25,36,69.4,11,34,20,14,33,74,148,0
10,Eduardo Aguirre,mx MEX,"FW,MF",Atlas,,26.75342466,1998,24.4,19,11,4,7,8,6,18,33.3,12,19,3,16,4,23,18,0
11,Érick Aguirre,mx MEX,DF,Monterrey,,28.19452055,1997,10.4,26,19,14,10,2,16,24,66.7,8,14,1,13,18,44,23,0
12,Gaddi Aguirre,mx MEX,DF,Atlas,,29.09589041,1996,11.7,18,13,12,6,0,10,26,38.5,16,13,7,6,27,45,65,0
13,Rodrigo Aguirre,uy URU,"FW,MF",América,,30.59178082,1994,9.8,21,14,7,9,5,7,15,46.7,8,12,2,10,2,23,7,0
14,Jorge Agustín Rodríguez,ar ARG,"MF,DF",Monterrey,,29.63561644,1995,26.5,82,50,38,43,1,39,65,60,26,37,15,22,33,115,68,0
15,Arnaud Ake,ci CIV,FW,Querétaro,,27.09315068,1998,2.6,1,1,1,0,0,1,1,100,0,0,0,0,1,2,1,0
16,Jesús Alberto Angulo,mx MEX,DF,UANL,,27.26027397,1998,26.3,62,43,34,20,8,29,55,52.7,26,30,15,15,36,98,94,1
17,Gil Alcalá,mx MEX,GK,UNAM,,32.76712329,1992,4,1,0,1,0,0,1,2,50,1,0,0,0,0,1,3,0
18,Jesús Alcantar,mx MEX,DF,Necaxa,,21.76438356,2003,6.8,10,5,8,1,1,4,10,40,6,14,7,7,13,23,43,0
19,Jordy Alcivar,ec ECU,"MF,FW",León,,25.74794521,1999,4.4,2,1,1,1,0,0,5,0,5,6,1,5,5,7,5,1
20,Luis Alfonso Rodríguez,mx MEX,DF,Pachuca,,34.28493151,1991,15.3,42,26,20,20,2,23,47,48.9,24,13,3,10,24,66,30,2
21,Guillermo Allison,mx MEX,GK,Querétaro,,34.60821918,1990,25,1,1,1,0,0,1,2,50,1,1,0,1,0,1,15,3
22,Facundo Almada,ar ARG,DF,Mazatlán,,26.81917808,1998,19.5,29,16,23,6,0,20,29,69,9,16,7,9,16,45,91,3
23,Carlos Alonso Vargas,mx MEX,"DF,FW",Cruz Azul,,26.21917808,1999,0.6,5,1,4,1,0,2,5,40,3,2,0,2,1,6,0,0
24,Alfonso Alvarado,mx MEX,"FW,MF",Monterrey,,25.13972603,2000,4.1,3,2,0,1,2,1,4,25,3,2,0,2,1,4,1,0
25,Alfonso Alvarado,mx MEX,"FW,MF",León,,25.13972603,2000,8.4,13,8,1,10,2,5,7,71.4,2,2,0,2,0,13,5,0
26,Daniel Alvarado,mx MEX,MF,América,,20.62739726,2004,0,0,0,0,0,0,0,0,,0,0,0,0,0,0,0,0
27,Roberto Alvarado,mx MEX,"MF,FW",Guadalajara,,26.65753425,1998,26.3,38,21,13,21,4,15,36,41.7,21,18,2,16,11,49,18,1
28,Ventura Alvarado,us USA,DF,Mazatlán,,32.71780822,1992,4.4,3,2,2,1,0,2,3,66.7,1,2,2,0,6,9,13,0
29,Alek Álvarez,mx MEX,MF,Necaxa,,22.09041096,2003,3.6,,6,,,,,,,,,,,0,,,
30,Antonio Álvarez,mx MEX,"FW,MF",América,,21.35616438,2003,1.3,2,1,1,1,0,0,0,,0,3,1,2,0,2,0,0
31,Daniel Álvarez,mx MEX,"MF,FW",Puebla,,30.78630137,1994,5.9,7,4,3,2,2,3,10,30,7,3,0,3,0,7,11,0
32,Efrain Alvarez,mx MEX,"FW,MF",Tijuana,,22.87671233,2002,24.9,26,20,12,7,7,12,24,50,12,12,0,12,8,34,1,0
33,Gael Álvarez,mx MEX,FW,Pachuca,,19.15616438,2006,2.5,7,5,5,1,1,3,10,30,7,6,1,5,1,8,1,0
34,Jaime Alvarez,mx MEX,"FW,MF",FC Juárez,,22.20273973,2003,0.5,0,0,0,0,0,0,0,,0,0,0,0,0,0,0,0
35,Jaime Alvarez,mx MEX,"FW,MF",Tijuana,,22.20273973,2003,3.8,1,1,0,1,0,0,3,0,3,3,0,3,0,1,0,0
36,Kevin Álvarez,mx MEX,DF,América,,26.30136986,1999,15.2,28,18,18,9,1,15,30,50,15,11,1,10,13,41,28,0
37,Luis Amarilla,py PAR,FW,Mazatlán,,29.69315068,1995,15.5,18,13,6,6,6,6,13,46.2,7,6,2,4,5,23,12,0
38,Frankie Amaya,us USA,MF,Toluca,,24.60547945,2000,4,15,9,3,11,1,9,15,60,6,3,0,3,10,25,9,0
39,Fidel Ambríz,mx MEX,MF,Monterrey,,22.12328767,2003,13.3,37,20,11,22,4,20,32,62.5,12,18,4,14,15,52,30,2
40,Fidel Ambríz,mx MEX,MF,León,,22.12328767,2003,4.7,15,10,5,7,3,6,10,60,4,6,3,3,6,21,5,0
41,Bruno Amione,ar ARG,DF,Santos,,23.33424658,2002,16.9,41,21,31,10,0,28,38,73.7,10,30,14,16,23,64,63,0
42,Esteban Andrada,ar ARG,GK,Monterrey,,34.27123288,1991,24,1,1,1,0,0,0,2,0,2,1,0,1,0,1,12,1
43,Alejandro Andrade,mx MEX,"DF,MF",Necaxa,,23.71780822,2001,5.7,13,6,9,3,1,6,8,75,2,7,2,5,4,17,21,0
44,Luis Ángel Malagón,mx MEX,GK,América,,28.17534247,1997,28.5,1,0,1,0,0,1,1,100,0,0,0,0,0,1,16,2
45,Brayan Angulo,co COL,"DF,MF",Puebla,,35.50410959,1989,28.1,63,41,33,24,6,36,56,64.3,20,18,4,14,34,97,66,0
46,Jesús Angulo,mx MEX,"MF,FW",Toluca,,28.20273973,1997,20.1,21,19,7,11,3,9,22,40.9,13,9,1,8,6,27,3,0
47,José Antonio Rodríguez,mx MEX,GK,Tijuana,,32.83561644,1992,20.9,1,1,1,0,0,1,3,33.3,2,1,0,1,0,1,14,2
48,Uriel Antuna,mx MEX,"FW,MF",Cruz Azul,,27.70410959,1997,2.6,0,0,0,0,0,0,0,,0,5,0,5,0,0,0,0
49,Uriel Antuna,mx MEX,"FW,MF",UANL,,27.70410959,1997,8.7,14,9,2,8,4,4,12,33.3,8,7,1,6,5,19,6,0
50,Javier Aquino,mx MEX,DF,UANL,,35.22739726,1990,29,89,57,48,36,5,49,77,63.6,28,37,7,30,61,150,66,1
51,Pedro Aquino,pe PER,MF,Santos,,30.06027397,1995,7.4,12,6,6,6,0,5,14,35.7,9,14,8,6,9,21,20,0
52,Diego Araujo,mx MEX,MF,Querétaro,,22.20821918,2003,1.2,3,2,1,2,0,2,3,66.7,1,2,1,1,2,5,1,0
53,Maximiliano Araújo,uy URU,FW,Toluca,,25.21643836,2000,1.1,2,1,0,1,1,1,2,50,1,1,0,1,0,2,1,0
54,Néstor Araujo,mx MEX,DF,América,,33.68219178,1991,13.4,20,15,13,7,0,12,13,92.3,1,11,8,3,18,38,74,0
55,Fernando Arce Jr.,us USA,"MF,FW",Puebla,,28.43561644,1996,2.2,5,2,1,3,1,3,6,50,3,1,0,1,2,7,3,0
56,Fernando Arce Jr.,us USA,MF,Necaxa,,28.43561644,1996,11.5,32,24,15,17,0,13,19,68.4,6,12,6,6,25,57,19,0
57,Ramiro Árciga,mx MEX,"MF,FW",Tijuana,,20.67945205,2004,3.3,7,2,2,3,2,4,10,40,6,5,0,5,5,12,3,0
58,Ramiro Árciga,mx MEX,"MF,FW",Mazatlán,,20.67945205,2004,10.6,33,21,12,14,7,9,23,39.1,14,24,1,23,3,36,5,0
59,Eduardo Armenta,mx MEX,MF,Querétaro,,23.38356164,2001,2.3,12,9,4,8,0,3,8,37.5,5,2,0,2,0,12,2,0
60,Aarón Arredondo,mx MEX,MF,América,,22.17808219,2003,2,3,2,1,2,0,1,2,50,1,2,1,1,2,5,3,0
61,Diego Arriaga,mx MEX,"FW,MF",América,,21.01369863,2004,1.6,1,1,0,0,1,1,3,33.3,2,1,0,1,0,1,0,0
62,Gerardo Arteaga,mx MEX,DF,Monterrey,,26.65753425,1998,25.5,45,33,26,14,5,27,42,64.3,15,25,4,21,27,72,48,0
63,Víctor Arteaga,mx MEX,MF,Toluca,,21.18630137,2004,9.2,19,11,11,6,2,12,23,52.2,11,5,1,4,15,34,9,1
64,Ali Ávila,mx MEX,"FW,MF",UNAM,,21.61369863,2003,2.5,3,3,2,1,0,2,6,33.3,4,0,0,0,0,3,1,0
65,Ettson Ayon,mx MEX,FW,León,,24.10958904,2001,5.8,4,3,1,1,2,1,3,33.3,2,1,0,1,1,5,1,0
66,Angel Azuaje,ve VEN,DF,UNAM,,20.60821918,2004,2.4,2,2,2,0,0,1,2,50,1,2,1,1,0,2,18,0
67,Tomás Badaloni,ar ARG,FW,Necaxa,,25.00821918,2000,10.3,5,1,1,4,0,1,5,20,4,7,2,5,3,8,11,0
68,Claudio Baeza,cl CHI,"MF,DF",Toluca,,31.36438356,1993,11.3,12,8,5,7,0,7,23,30.4,16,18,8,10,15,27,19,1
69,Kevin Balanta,co COL,DF,Tijuana,,28.01917808,1997,7.6,19,11,13,6,0,11,13,84.6,2,9,5,4,8,27,34,1
70,Fidel Barajas,mx MEX,"MF,FW",Guadalajara,,19.08219178,2006,1,0,0,0,0,0,0,1,0,1,0,0,0,0,0,0,0
71,Víctor Barajas,mx MEX,DF,León,,22.14520548,2003,0,1,0,0,1,0,1,1,100,0,0,0,0,0,1,0,0
72,Diego Barbosa,mx MEX,DF,Toluca,,28.60821918,1996,10.8,60,40,31,28,1,36,51,70.6,15,7,2,5,19,79,20,0
73,Diego Barbosa,mx MEX,DF,Tijuana,,28.60821918,1996,2.7,9,6,4,5,0,8,13,61.5,5,5,1,4,3,12,7,0
74,Jaine Barreiro,co COL,DF,León,,30.87671233,1994,33.7,76,47,53,21,2,45,64,70.3,19,45,20,25,60,136,180,3
75,Pablo Barrera,mx MEX,"MF,FW",Querétaro,,37.87123288,1987,23.4,22,17,10,11,1,7,23,30.4,16,17,2,15,6,28,13,2
76,Sergio Barreto,ar ARG,DF,Pachuca,,26.04109589,1999,18.2,27,16,18,7,2,17,28,60.7,11,13,6,7,21,48,99,0
77,Bruno Barticciotto,cl CHI,FW,Santos,,23.99452055,2001,7.4,8,3,0,3,5,1,7,14.3,6,6,2,4,2,10,6,0
78,Abraham Bass,mx MEX,MF,Atlas,,23.7369863,2001,0.1,0,0,0,0,0,0,1,0,1,1,1,0,0,0,0,0
79,Borja Bastón,es ESP,FW,Pachuca,,32.69315068,1992,3.9,1,1,0,1,0,0,0,,0,5,2,3,0,1,10,0
80,Alán Bautista,mx MEX,"MF,FW",Pachuca,,22.49315068,2002,9.9,20,12,3,14,3,13,20,65,7,11,2,9,13,33,10,0
81,Paul Bellón,mx MEX,DF,León,,27.91780822,1997,28.3,49,28,36,13,0,31,53,58.5,22,31,16,15,33,82,127,1
82,Fernando Beltrán,mx MEX,"MF,FW",Guadalajara,,26.99178082,1998,20.4,41,25,16,20,5,20,30,66.7,10,12,2,10,13,54,9,0
83,Nicolás Benedetti,co COL,"FW,MF",Mazatlán,,28.02739726,1997,14.2,26,19,13,12,1,14,30,46.7,16,12,0,12,3,29,2,0
84,Darío Benedetto,ar ARG,FW,Querétaro,,34.96712329,1990,4.7,1,0,0,1,0,1,1,100,0,3,0,3,1,2,5,0
85,Pablo Bennevendo Peña,mx MEX,DF,UNAM,,25.33424658,2000,27,68,41,30,32,6,30,54,55.6,24,41,11,30,42,110,104,1
86,Jorge Berlanga,mx MEX,DF,Pachuca,,21.79726027,2003,11.2,26,18,16,9,1,15,25,60,10,15,9,6,27,53,40,0
87,Germán Berterame,mx MEX,FW,Monterrey,,26.4739726,1998,26,22,13,3,16,3,6,12,50,6,15,3,12,8,30,11,0
88,Unai Bilbao,es ESP,DF,Tijuana,,31.24657534,1994,26.2,45,32,27,16,2,17,29,58.6,12,37,20,17,47,92,165,1
89,Alfonso Blanco Antúnez,mx MEX,GK,León,,37.76164384,1987,26,1,1,1,0,0,1,2,50,1,2,0,2,0,1,9,3
90,Domingo Blanco,ar ARG,"FW,MF",Tijuana,,30.03561644,1995,16.7,37,23,11,17,9,10,18,55.6,8,9,2,7,9,46,7,0
91,Rodrigo Bogarín,py PAR,"MF,FW",Querétaro,,27.94794521,1997,7.9,13,5,5,7,1,2,11,18.2,9,12,8,4,11,24,13,0
92,Mateusz Bogusz,pl POL,"MF,FW",Cruz Azul,,23.70136986,2001,8,12,11,3,7,2,3,10,30,7,8,1,7,1,13,3,0
93,Franck Boli,ci CIV,FW,Atlético,,31.40821918,1993,9,6,1,1,3,2,2,5,40,3,2,0,2,3,9,6,0
94,Léo Bonatini,br BRA,FW,Atlético,,31.10410959,1994,11.8,4,3,0,3,1,1,4,25,3,7,1,6,4,8,8,0
95,Cristian Borja,co COL,DF,América,,32.20821918,1993,14.7,31,24,21,8,2,13,17,76.5,4,10,2,8,16,47,31,0
96,Frank Boya,cm CMR,MF,Tijuana,,28.84383562,1996,8.2,11,7,3,8,0,4,6,66.7,2,13,4,9,15,26,17,0
97,Juan Brigido,mx MEX,"FW,MF",Pachuca,,23.59726027,2001,0.6,2,0,0,2,0,0,0,,0,2,0,2,0,2,1,0
98,Antonio Briseño,mx MEX,DF,Toluca,,31.24383562,1994,3.2,2,1,1,1,0,1,2,50,1,1,1,0,1,3,29,0
99,Antonio Briseño,mx MEX,DF,Guadalajara,,31.24383562,1994,6,8,7,6,2,0,5,8,62.5,3,7,7,0,12,20,21,1
100,Isaác Brizuela,mx MEX,"MF,DF",Guadalajara,,34.68493151,1990,1.4,1,0,1,0,0,1,1,100,0,2,0,2,2,3,2,0
101,Juan Brunetta,ar ARG,MF,UANL,,27.98082192,1997,24.7,20,13,5,11,4,11,19,57.9,8,20,3,17,7,27,7,0
102,Gustavo Cabral,ar ARG,DF,Pachuca,,39.55616438,1985,12.1,12,8,6,6,0,10,18,55.6,8,13,3,10,24,36,52,0
103,Luciano Cabral,cl CHI,"FW,MF",León,,30.02465753,1995,11.9,16,6,5,9,2,8,19,42.1,11,15,2,13,2,18,10,0
104,Sebastián Cáceres,uy URU,DF,América,,25.71232877,1999,9.1,25,16,15,9,1,13,16,81.3,3,10,6,4,20,45,51,0
105,Jhonder Cádiz,ve VEN,FW,León,,29.76712329,1995,23.3,13,9,1,4,8,5,12,41.7,7,10,6,4,1,14,22,0
106,José Caicedo,co COL,MF,UNAM,,22.95068493,2002,31.9,73,44,33,39,1,35,65,53.8,30,29,4,25,32,105,61,2
107,Cristian Calderón,mx MEX,DF,América,,27.94794521,1997,18.3,36,27,24,7,5,19,28,67.9,9,17,3,14,22,58,42,1
108,Francisco Calvo,cr CRC,DF,FC Juárez,,32.82465753,1992,3,6,4,4,2,0,2,4,50,2,3,3,0,1,7,9,0
109,Raúl Camacho,mx MEX,"FW,DF",Mazatlán,,23.12876712,2002,3.8,1,1,0,1,0,0,2,0,2,4,0,4,1,2,3,0
110,Hugo Camberos,mx MEX,"FW,MF",Guadalajara,,18.7890411,2006,9.7,31,20,15,13,3,13,23,56.5,10,17,2,15,8,39,5,0
111,Diber Cambindo,co COL,FW,Necaxa,,29.2109589,1996,24,11,7,1,8,2,6,8,75,2,15,1,14,5,16,17,0
112,Diego Campillo,mx MEX,MF,FC Juárez,,23.54246575,2001,24.5,31,19,15,16,0,17,40,42.5,23,26,5,21,40,71,50,2
113,Omar Campos,mx MEX,DF,Cruz Azul,,22.79178082,2002,1.6,2,2,1,0,1,1,3,33.3,2,2,0,2,1,3,6,0
114,Sergio Canales,es ESP,"MF,FW",Monterrey,,34.21369863,1991,29.3,22,13,6,14,2,9,33,27.3,24,21,3,18,11,33,1,0
115,Luis Cañamar,mx MEX,DF,Atlético,,22.96986301,2002,1,4,3,3,1,0,0,0,,0,2,0,2,0,4,1,0
116,Camilo Cándido,uy URU,"DF,MF",Cruz Azul,,29.92328767,1995,2.5,11,9,6,5,0,10,14,71.4,4,3,1,2,2,13,7,0
117,Luis Cárdenas,mx MEX,GK,Monterrey,,31.63561644,1993,10,0,0,0,0,0,0,0,,0,0,0,0,1,1,7,2
118,Rafael Carioca,br BRA,MF,UANL,,35.87945205,1989,15.7,34,21,15,14,5,15,29,51.7,14,9,2,7,9,43,6,0
119,Jan Carmona,mx MEX,"MF,FW",FC Juárez,,21.03835616,2004,1.2,0,0,0,0,0,0,1,0,1,3,0,3,2,2,3,0
120,Héctor Carranza,mx MEX,MF,Santos,,21.33424658,2004,0.1,1,0,1,0,0,0,0,,0,0,0,0,0,1,0,0
121,Adalberto Carrasquilla,pa PAN,MF,UNAM,,26.43287671,1998,11.2,8,7,3,3,2,2,8,25,6,13,2,11,7,15,4,0
122,Jordan Carrillo,mx MEX,"MF,FW",Santos,,23.42739726,2001,15.4,33,15,15,13,5,21,35,60,14,14,2,12,7,40,5,0
123,Stephano Carrillo,mx MEX,"FW,MF",Santos,,19.16164384,2006,4.5,2,2,1,1,0,0,2,0,2,1,0,1,1,3,1,0
124,Guilherme Carvalho,br BRA,MF,FC Juárez,,25.62465753,1999,24.2,39,21,18,19,2,13,49,26.5,36,31,6,25,29,68,36,0
125,Kevin Castañeda,mx MEX,"MF,FW",Tijuana,,25.51780822,1999,21.9,15,8,4,7,4,3,12,25,9,10,0,10,10,25,10,1
126,Christian Castillo,cl CHI,FW,Querétaro,,28.41917808,1996,0.5,0,0,0,0,0,0,0,,0,0,0,0,0,0,0,0
127,Klever Castillo,mx MEX,FW,Toluca,,19.72876712,2005,0.8,1,1,0,1,0,1,2,50,1,1,0,1,0,1,0,0
128,Moises Castillo,co COL,DF,FC Juárez,,23.94794521,2001,21.5,49,40,39,9,1,27,34,79.4,7,21,7,14,36,85,115,1
129,José Castillo Pérez,mx MEX,DF,Guadalajara,,23.42191781,2001,25,46,29,26,17,3,24,37,64.9,13,27,9,18,20,66,61,0
130,Raúl Castillo,mx MEX,"MF,FW",Puebla,,23.42191781,2001,16.6,29,18,9,13,7,13,21,61.9,8,11,1,10,9,38,1,0
131,Christopher Castro,mx MEX,DF,Mazatlán,,19.8630137,2005,1.2,4,1,2,2,0,3,4,75,1,1,0,1,4,8,1,1
132,Manuel Castro,uy URU,"MF,FW",FC Juárez,,29.60273973,1995,1,1,1,1,0,0,1,1,100,0,0,0,0,1,2,3,0
133,Lucas Cavallini,ca CAN,FW,Puebla,,32.35068493,1992,3.6,2,1,0,1,1,0,1,0,1,1,1,0,1,3,1,0
134,Alan Cervantes,mx MEX,MF,Santos,,27.29589041,1998,1,3,2,0,2,1,2,4,50,2,1,0,1,1,4,3,0
135,Alan Cervantes,mx MEX,MF,América,,27.29589041,1998,14.4,41,32,16,22,3,18,32,56.3,14,14,4,10,15,56,12,0
136,Luís Cervantes,mx MEX,DF,León,,24.23287671,2001,0.4,2,2,0,2,0,1,1,100,0,1,0,1,0,2,0,0
137,Ángel Chávez,mx MEX,DF,Necaxa,,20.20547945,2005,0.1,0,0,0,0,0,0,1,0,1,0,0,0,0,0,0,0
138,Mateo Chávez,mx MEX,DF,Guadalajara,,20.98082192,2004,19.9,96,66,51,37,8,51,82,62.2,31,37,6,31,19,115,43,1
139,Ricardo Chávez Soto,mx MEX,"DF,MF",Atlético,,30.45753425,1994,13.7,24,12,15,6,3,14,21,66.7,7,12,5,7,15,39,39,0
140,Ricardo Chávez Soto,mx MEX,DF,Monterrey,,30.45753425,1994,11.3,36,23,16,18,2,11,19,57.9,8,12,3,9,8,44,36,0
141,Ronaldo Cisneros,mx MEX,FW,Querétaro,,28.32054795,1997,8.2,8,3,2,4,2,4,6,66.7,2,3,1,2,6,14,7,0
142,Matías Cóccaro,uy URU,"FW,MF",Atlas,,27.46849315,1997,2.4,2,0,0,1,1,1,1,100,0,2,0,2,0,2,4,0
143,Josué Colmán,py PAR,"MF,FW",Querétaro,,26.77808219,1998,8.4,14,8,4,9,1,7,13,53.8,6,2,1,1,5,19,8,0
144,Josué Colmán,py PAR,"MF,DF",Mazatlán,,26.77808219,1998,6.1,4,2,1,1,2,2,11,18.2,9,6,1,5,2,6,2,0
145,Bryan Colula,mx MEX,DF,Mazatlán,,29.07945205,1996,24.5,59,44,34,20,5,33,68,48.5,35,28,6,22,22,81,58,0
146,Francisco Contreras,mx MEX,"DF,MF",Tijuana,,25.88767123,1999,7.3,29,21,14,13,2,16,24,66.7,8,12,3,9,13,42,15,0
147,Mario Cordero,mx MEX,FW,Santos,,21.42739726,2003,0.1,1,0,0,1,0,1,1,100,0,0,0,0,0,1,0,0
148,Jesús Corona,mx MEX,"FW,MF",Monterrey,,32.3260274,1993,14.6,26,21,6,8,12,7,14,50,7,10,0,10,7,33,4,0
149,Joe Corona,us USA,MF,Tijuana,,34.82191781,1990,10.9,23,15,8,15,0,9,19,47.4,10,10,5,5,15,38,20,1
150,José Corona,mx MEX,GK,Tijuana,,44.27123288,1981,10.1,0,0,0,0,0,0,0,,0,0,0,0,0,0,8,1
151,Rogelio Cortéz Pineda,mx MEX,"FW,MF",Necaxa,,20.82739726,2004,1.9,3,3,0,2,1,0,3,0,3,5,0,5,0,3,1,0
152,Jordi Cortizo,mx MEX,"MF,FW",Monterrey,,28.84657534,1996,10.2,24,16,7,15,2,11,28,39.3,17,7,0,7,7,31,3,0
153,Rodolfo Cota,mx MEX,GK,América,,37.83835616,1987,5.5,1,1,1,0,0,1,1,100,0,0,0,0,0,1,2,0
154,Cade Cowell,us USA,"FW,MF",Guadalajara,,21.55616438,2003,13.6,18,12,3,7,8,10,15,66.7,5,10,1,9,2,20,9,0
155,Aldo Cruz,mx MEX,DF,Atlético,,27.6109589,1997,26.7,48,34,32,15,1,29,40,72.5,11,23,8,15,19,67,83,2
156,Cristián Dajome,co COL,"FW,MF",Santos,,31.33424658,1994,7.6,14,8,7,3,4,5,22,22.7,17,12,1,11,4,18,5,0
157,Jürgen Damm,mx MEX,DF,Atlético,,32.49041096,1992,0.3,2,2,1,1,0,1,1,100,0,1,0,1,0,2,0,0
158,Jesús David Murillo,co COL,DF,FC Juárez,,31.20821918,1994,8.7,23,16,22,1,0,12,18,66.7,6,15,7,8,11,34,53,1
159,José David Ramírez,mx MEX,"MF,DF",León,,29.3890411,1995,13.4,28,16,10,18,0,14,26,53.8,12,19,3,16,12,40,29,1
160,Víctor Dávila,cl CHI,"FW,MF",América,,27.49863014,1997,12.8,15,7,4,9,2,7,8,87.5,1,4,1,3,1,16,9,0
161,Diego De Buen,mx MEX,MF,Puebla,,33.83835616,1991,15.9,26,13,9,13,4,11,26,42.3,15,22,11,11,21,47,55,0
162,Diego De Buen,mx MEX,"MF,DF",Necaxa,,33.83835616,1991,8.1,11,8,6,5,0,6,12,50,6,2,0,2,7,18,27,1
163,Sergio De los Ríos,mx MEX,"MF,DF",Pachuca,,21.85205479,2003,1.2,1,1,0,1,0,0,1,0,1,0,0,0,1,2,2,0
164,Gustavo Del Prete,ar ARG,"MF,FW",Atlas,,28.89589041,1996,6.2,11,8,2,9,0,3,6,50,3,11,0,11,5,16,0,0
165,Gustavo Del Prete,ar ARG,"MF,FW",Mazatlán,,28.89589041,1996,2.6,2,2,0,1,1,1,3,33.3,2,3,0,3,0,2,0,0
166,Everardo Del Villar,mx MEX,DF,Toluca,,20.11780822,2005,8.6,18,12,9,9,0,7,11,63.6,4,9,8,1,9,27,29,0
167,Diego Delgadillo,mx MEX,FW,Guadalajara,,21.28493151,2004,0.1,0,0,0,0,0,0,1,0,1,0,0,0,1,1,0,0
168,Arturo Delgado,mx MEX,GK,FC Juárez,,23.20821918,2002,2,0,0,0,0,0,0,0,,0,0,0,0,0,0,1,0
169,Nelson Deossa,co COL,MF,Pachuca,,25.24109589,2000,13.5,31,18,8,18,5,14,24,58.3,10,21,6,15,9,40,15,1
170,Nelson Deossa,co COL,"MF,FW",Monterrey,,25.24109589,2000,12.1,40,29,12,25,3,16,21,76.2,5,14,2,12,7,47,9,0
171,Benny Díaz,mx MEX,GK,FC Juárez,,26.38630137,1998,11,0,0,0,0,0,0,0,,0,0,0,0,1,1,8,3
172,Nicolás Díaz Huincales,cl CHI,DF,Tijuana,,25.95890411,1999,7.5,18,13,12,6,0,8,9,88.9,1,8,1,7,6,24,14,0
173,Jair Díaz,mx MEX,DF,Mazatlán,,26.70410959,1998,22.7,42,28,23,17,2,26,42,61.9,16,19,7,12,19,61,89,0
174,Javairô Dilrosun,nl NED,"FW,MF",América,,26.86849315,1998,11.7,13,10,4,7,2,8,19,42.1,11,19,0,19,5,18,9,0
175,Willer Ditta,co COL,DF,Cruz Azul,,28.27945205,1997,32.7,52,27,20,27,5,24,39,61.5,15,48,25,23,35,87,106,3
176,Alexei Dominguez,mx MEX,"FW,MF",Pachuca,,20.33424658,2005,1.9,10,9,4,5,1,3,4,75,1,2,0,2,4,14,1,0
177,Idekel Domínguez,mx MEX,DF,Atlas,,24.92328767,2000,6.5,20,15,9,8,3,13,22,59.1,9,7,1,6,8,28,21,0
178,Joel Domínguez,mx MEX,MF,Monterrey,,20.31780822,2005,0,1,1,0,1,0,1,1,100,0,0,0,0,0,1,1,0
179,Jose Domínguez,py PAR,DF,Querétaro,,28.79178082,1996,20.5,25,19,13,10,2,12,18,66.7,6,28,19,9,18,43,130,1
180,Juan Domínguez,mx MEX,"FW,MF",Toluca,,26.51232877,1998,16.4,20,14,9,9,2,7,13,53.8,6,9,1,8,6,26,7,0
181,Julio Domínguez,mx MEX,DF,Atlético,,37.48767123,1987,19.9,19,10,10,7,2,10,14,71.4,4,18,11,7,18,37,69,0
182,Misael Domínguez,mx MEX,"FW,MF",Querétaro,,25.52054795,1999,0.9,2,2,1,0,1,1,1,100,0,0,0,0,0,2,0,0
183,Dória,br BRA,DF,Atlas,,30.48767123,1994,29,35,22,20,13,2,16,29,55.2,13,43,32,11,35,70,121,0
184,Jonathan dos Santos,mx MEX,MF,América,,35.02465753,1990,12.5,38,25,20,17,1,20,38,52.6,18,13,2,11,18,56,18,0
185,Rodrigo Dourado,br BRA,MF,Atlético,,30.88219178,1994,32.7,81,53,34,35,12,37,80,46.3,43,51,17,34,48,129,61,0
186,Anderson Duarte,uy URU,"MF,FW",Toluca,,21.11780822,2004,1.5,4,1,2,2,0,1,4,25,3,2,0,2,1,5,1,0
187,Anderson Duarte,uy URU,"FW,MF",Mazatlán,,21.11780822,2004,6.5,13,10,4,4,5,8,13,61.5,5,5,1,4,1,14,3,0
188,Rubén Duarte,es ESP,DF,UNAM,,29.54520548,1995,25.5,54,29,26,23,5,27,39,69.2,12,30,10,20,36,90,82,1
189,Jeyson Duran,mx MEX,MF,Cruz Azul,,20.27123288,2005,0.1,0,0,0,0,0,0,0,,0,0,0,0,0,0,0,0
190,Rafael Durán,mx MEX,"MF,FW",Puebla,,27.70684932,1997,1.7,2,2,0,2,0,0,0,,0,2,0,2,0,2,1,0
191,Emmanuel Echeverría,mx MEX,DF,Santos,,21.58356164,2003,24,32,24,22,8,2,19,44,43.2,25,29,9,20,17,49,66,1
192,Rodrigo Echeverría,cl CHI,"MF,FW",León,,30.04931507,1995,13.9,32,25,18,12,2,16,32,50,16,20,5,15,17,49,23,1
193,Edson,br BRA,DF,FC Juárez,,27.03013699,1998,5.8,20,14,13,7,0,13,19,68.4,6,4,1,3,6,26,19,0
194,José Eduardo Castillo,mx MEX,DF,Pachuca,,21.21369863,2004,1,2,1,1,1,0,0,0,,0,3,0,3,0,2,2,0
195,Javier Eduardo López,mx MEX,"MF,FW",Pachuca,,30.63013699,1994,4.7,3,3,1,2,0,1,8,12.5,7,0,0,0,2,5,0,0
196,Jorge Eduardo Sánchez,mx MEX,"DF,FW",Cruz Azul,,27.4,1997,25.5,62,30,27,24,11,32,61,52.5,29,29,7,22,19,81,53,1
197,Francisco Eduardo Venegas,mx MEX,DF,Querétaro,,26.80273973,1998,21.5,46,28,26,16,4,23,47,48.9,24,17,6,11,18,64,72,0
198,Luis Enrique Quiñones,co COL,"FW,MF",Puebla,,33.85753425,1991,15.2,26,19,8,16,2,5,15,33.3,10,16,1,15,5,31,1,0
199,Luis Enrique Quiñones,co COL,"FW,MF",UANL,,33.85753425,1991,1.9,6,3,2,2,2,2,7,28.6,5,4,1,3,1,7,3,0
200,Robert Ergas,uy URU,DF,UNAM,,27.30136986,1998,25,68,44,36,26,6,39,72,54.2,33,26,2,24,19,87,44,0
201,Carlos Ernesto Cisneros,mx MEX,"FW,MF",Guadalajara,,31.67945205,1993,3.6,5,3,2,0,3,3,4,75,1,2,1,1,1,6,1,0
202,Carlos Ernesto Cisneros,mx MEX,"FW,MF",León,,31.67945205,1993,2.2,1,0,0,0,1,1,2,50,1,1,0,1,0,1,3,0
203,Kevin Escamilla,mx MEX,"MF,DF",Querétaro,,31.2,1994,22.1,34,19,18,14,2,18,36,50,18,22,12,10,36,70,65,1
204,Alonso Escoboza,mx MEX,"DF,MF",Mazatlán,,32.28219178,1993,9.6,6,5,3,3,0,1,7,14.3,6,3,0,3,6,12,15,1
205,Dagoberto Espinoza,mx MEX,"DF,MF",América,,21.04931507,2004,11,25,19,15,8,2,16,28,57.1,12,13,1,12,8,33,25,0
206,Luis Espinoza,mx MEX,"DF,FW",Santos,,21.27671233,2004,1.8,3,2,3,0,0,1,3,33.3,2,6,0,6,2,5,2,0
207,Ángel Estrada,mx MEX,MF,León,,22.28767123,2003,14.6,34,23,21,11,2,15,26,57.7,11,20,10,10,15,49,21,0
208,Oscar Estupiñan,co COL,FW,FC Juárez,,28.34794521,1996,21.1,10,3,0,6,4,7,12,58.3,5,11,3,8,1,11,20,1
209,José Eulogio,mx MEX,GK,Pachuca,,21.22739726,2004,2,0,0,0,0,0,0,0,,0,0,0,0,0,0,0,0
210,Franco Fagúndez,uy URU,"MF,FW",Santos,,24.79452055,2000,9.1,28,18,9,12,7,14,32,43.8,18,14,2,12,4,32,18,0
211,Lorenzo Faravelli,ar ARG,MF,Cruz Azul,,32.10136986,1993,23.1,46,33,10,28,8,29,51,56.9,22,16,1,15,16,62,5,0
212,Juan Fedorco,ar ARG,DF,Puebla,,24.43287671,2000,9.2,19,14,12,7,0,7,8,87.5,1,16,13,3,18,37,71,0
213,Carlos Felipe Rodríguez,mx MEX,GK,UANL,,36.08767123,1989,3,0,0,0,0,0,0,0,,0,0,0,0,0,0,2,0
214,Gabriel Fernández,uy URU,FW,Cruz Azul,,30.97808219,1994,7.6,8,2,2,5,1,2,5,40,3,3,0,3,1,9,5,0
215,Joaquín Fernández,uy URU,DF,Tijuana,,26.28219178,1999,2.2,4,4,3,1,0,3,5,60,2,5,1,4,3,7,3,0
216,Rafael Fernández,mx MEX,DF,Tijuana,,24.74794521,2000,19.5,45,33,26,17,2,22,38,57.9,16,24,6,18,33,78,71,0
217,Gustavo Ferrareis,br BRA,"DF,MF",Puebla,,29.3369863,1996,23.2,43,29,27,13,3,28,59,47.5,31,27,8,19,26,69,60,0
218,Álvaro Fidalgo,es ESP,MF,América,,28.07123288,1997,23.8,35,23,13,17,5,10,29,34.5,19,22,4,18,17,52,18,1
219,Sebastián Fierro,mx MEX,MF,León,,23.71506849,2001,2.1,4,3,2,2,0,0,2,0,2,2,0,2,3,7,7,0
220,Iker Fimbres,mx MEX,MF,Monterrey,,19.92328767,2005,14.3,28,16,7,14,7,15,36,41.7,21,10,0,10,15,43,12,0
221,Daniel Flores,us USA,DF,Guadalajara,,21.98356164,2003,0.1,1,1,1,0,0,1,1,100,0,0,0,0,0,1,0,0
222,Jonathan Flores,mx MEX,DF,UNAM,,18.80821918,2006,1,3,1,2,1,0,2,2,100,0,2,0,2,0,3,3,0
223,Leonardo Flores,mx MEX,"FW,MF",Atlas,,22.03835616,2003,7.4,20,13,8,8,4,14,26,53.8,12,9,0,9,7,27,12,0
224,Marcelo Flores,mx MEX,"FW,MF",UANL,,21.59178082,2003,11.3,13,9,5,3,5,6,9,66.7,3,11,1,10,9,22,4,1
225,Nicolas Fonseca,uy URU,MF,León,,26.54246575,1998,13.3,36,18,10,22,4,22,48,45.8,26,10,0,10,13,49,12,1
226,Alexis Francisco Peña,mx MEX,DF,Necaxa,,29.30684932,1996,17,13,7,12,1,0,7,10,70,3,18,16,2,16,29,127,0
227,Ramiro Franco,mx MEX,DF,Tijuana,,21.5260274,2003,7.1,17,12,10,6,1,13,22,59.1,9,9,4,5,8,25,36,1
228,Ramiro Franco,mx MEX,DF,Mazatlán,,21.5260274,2003,4.1,11,7,6,4,1,5,10,50,5,5,1,4,9,20,8,0
229,Adonis Frías,ar ARG,"DF,MF",León,,27.13424658,1998,9.5,10,3,7,3,0,5,15,33.3,10,5,3,2,15,25,26,0
230,Raymundo Fulgencio,mx MEX,"FW,MF",Atlas,,25.22465753,2000,11.7,13,7,1,8,4,5,14,35.7,9,9,0,9,4,17,4,0
231,Raymundo Fulgencio,mx MEX,FW,UANL,,25.22465753,2000,1.8,2,2,1,1,0,2,2,100,0,4,0,4,4,6,0,0
232,Rogelio Funes Mori,mx MEX,FW,UNAM,,34.16712329,1991,13.3,3,1,1,2,0,1,2,50,1,5,0,5,2,5,9,0
233,Eduardo Gabriel,br BRA,DF,Pachuca,,29.22191781,1996,14.4,20,13,12,7,1,11,15,73.3,4,16,10,6,25,45,59,0
234,Benjamín Galdames,mx MEX,"MF,FW",Atlético,,24.19178082,2001,5.6,10,7,2,6,2,6,14,42.9,8,11,0,11,5,15,5,0
235,José Galindo,mx MEX,"DF,MF",UNAM,,27.30684932,1998,0.6,1,0,0,1,0,0,0,,0,0,0,0,2,3,3,0
236,Jesús Gallardo,mx MEX,DF,Toluca,,30.72054795,1994,28.2,50,29,25,21,4,29,52,55.8,23,31,6,25,20,70,101,0
237,Bryan Gamboa,mx MEX,"MF,FW",Cruz Azul,,23.14520548,2002,0.4,1,1,1,0,0,1,1,100,0,0,0,0,1,2,2,0
238,Aitor García,es ESP,"FW,MF",FC Juárez,,31.11232877,1994,4.7,9,5,6,2,1,3,9,33.3,6,4,1,3,5,14,8,0
239,Amaury García,mx MEX,"MF,FW",Cruz Azul,,23.37534247,2001,0.2,0,0,0,0,0,0,0,,0,0,0,0,0,0,2,0
240,Brian García,mx MEX,DF,Toluca,,27.50958904,1997,17.1,31,19,10,19,2,17,24,70.8,7,20,5,15,18,49,39,0
241,Denzell García,mx MEX,"DF,MF",FC Juárez,,21.72054795,2003,16.6,53,36,20,24,9,27,53,50.9,26,32,5,27,24,77,54,1
242,Eduardo García,mx MEX,GK,Guadalajara,,22.81643836,2002,2,0,0,0,0,0,0,0,,0,0,0,0,0,0,0,0
243,Francisco García,mx MEX,FW,América,,21.57260274,2003,0.2,0,0,0,0,0,0,0,,0,0,0,0,0,0,0,0
244,Gael García,mx MEX,FW,Guadalajara,,16.91780822,2008,0,0,0,0,0,0,0,0,,0,0,0,0,0,0,0,0
245,Jorge García,mx MEX,"MF,FW",Cruz Azul,,23.28219178,2002,0.9,1,1,0,1,0,0,1,0,1,2,1,1,3,4,1,0
246,José García,mx MEX,DF,FC Juárez,,28.86849315,1996,14.3,13,10,7,6,0,11,15,73.3,4,16,8,8,27,40,80,0
247,Luan Garcia,br BRA,DF,Toluca,,31.98630137,1993,24.5,32,18,23,8,1,20,29,69,9,28,18,10,36,68,90,1
248,Luis García,mx MEX,"MF,FW",Puebla,,32.11232877,1993,1.3,3,0,2,0,1,2,2,100,0,0,0,0,0,3,6,0
249,Mateo García,ar ARG,"MF,FW",Atlas,,28.64931507,1996,4.5,12,7,4,4,4,7,22,31.8,15,14,0,14,5,17,2,0
250,Miguel Garcia,mx MEX,"DF,MF",Atlético,,23.55616438,2001,9.5,19,15,11,8,0,2,7,28.6,5,10,5,5,13,32,32,1
251,Bryan Garnica,mx MEX,"FW,DF",Puebla,,28.93972603,1996,2.3,10,8,4,4,2,3,4,75,1,4,0,4,3,13,5,0
252,Bryan Garnica,mx MEX,"FW,DF",Necaxa,,28.93972603,1996,11.1,27,22,13,12,2,9,26,34.6,17,14,2,12,6,33,10,0
253,César Garza,mx MEX,MF,Monterrey,,19.84383562,2005,0.2,1,1,0,1,0,0,0,,0,1,0,1,0,1,0,0
254,Jesús Garza,mx MEX,DF,UANL,,24.91232877,2000,14,47,29,23,18,6,22,37,59.5,15,12,2,10,24,71,20,0
255,Giorgos Giakoumakis,gr GRE,FW,Cruz Azul,,30.40273973,1994,14.8,12,8,2,6,4,4,9,44.4,5,12,1,11,4,16,8,0
256,André-Pierre Gignac,fr FRA,FW,UANL,,39.41369863,1985,12.3,2,2,1,1,0,1,4,25,3,4,2,2,2,4,8,0
257,Faber Gil,co COL,"FW,MF",Pachuca,,30.14246575,1995,3.1,4,4,1,3,0,0,1,0,1,2,0,2,1,5,3,0
258,Said Godínez,mx MEX,MF,Mazatlán,,20.52328767,2004,2.3,3,3,1,2,0,3,6,50,3,0,0,0,4,7,1,0
259,Alejandro Gómez,mx MEX,"DF,MF",Tijuana,,23.25753425,2002,22.8,47,22,30,16,1,17,33,51.5,16,28,10,18,37,84,73,0
260,Diego Gómez,mx MEX,"MF,FW",Necaxa,,21.64931507,2003,5.1,18,13,12,6,0,11,16,68.8,5,1,0,1,12,30,9,1
261,Emiliano Gómez,uy URU,"FW,MF",Puebla,,23.62739726,2001,22.8,11,5,1,7,3,3,14,21.4,11,7,0,7,2,13,11,0
262,Luis Gómez,mx MEX,"DF,FW",Santos,,18.3369863,2007,0.3,1,0,0,1,0,0,1,0,1,1,0,1,0,1,0,0
263,Miguel Gómez,mx MEX,DF,Guadalajara,,22.59726027,2002,6.2,13,7,3,8,2,5,8,62.5,3,8,3,5,6,19,18,0
264,Jaime Gómez Valencia,mx MEX,"DF,MF",Querétaro,,31.8,1993,11.8,19,15,11,6,2,11,26,42.3,15,7,3,4,11,30,37,0
265,Alfonso González,mx MEX,"FW,MF",Pachuca,,30.6630137,1994,7.7,24,14,5,13,6,4,15,26.7,11,6,1,5,5,29,10,1
266,Armando González,mx MEX,FW,Guadalajara,,22.04109589,2003,7.2,8,4,2,5,1,3,5,60,2,7,1,6,1,9,9,0
267,Bryan González,mx MEX,DF,Pachuca,,22.06849315,2003,28.6,73,52,40,28,5,37,62,59.7,25,31,7,24,59,132,98,0
268,Pablo González Díaz,mx MEX,MF,Puebla,,32.82739726,1992,21.1,37,24,16,20,1,17,32,53.1,15,31,14,17,23,60,29,0
269,Diego González,py PAR,"MF,FW",Atlas,,22.32328767,2003,8.6,20,15,8,5,7,6,12,50,6,10,1,9,3,23,6,0
270,Hugo González Durán,mx MEX,GK,Mazatlán,,34.75890411,1990,33.5,0,0,0,0,0,0,1,0,1,0,0,0,0,0,13,0
271,Carlos González Espínola,py PAR,FW,Tijuana,,32.24657534,1993,6.4,5,4,2,0,3,1,1,100,0,2,0,2,1,6,10,0
272,Fernando González,mx MEX,"FW,MF",Querétaro,,24.02465753,2001,2,5,4,1,3,1,1,5,20,4,3,0,3,0,5,4,0
273,Jair González,mx MEX,"MF,FW",Puebla,,23.16986301,2002,1.9,2,1,0,0,2,1,5,20,4,1,0,1,0,2,0,0
274,Jonathan González,mx MEX,MF,FC Juárez,,26.06027397,1999,12.4,18,12,9,9,0,4,8,50,4,10,4,6,25,43,31,0
275,Mateo González Mora,mx MEX,DF,Puebla,,16.27671233,2009,0.2,1,0,1,0,0,0,1,0,1,0,0,0,1,2,0,0
276,Owen González,mx MEX,FW,Pachuca,,21.79178082,2003,12.7,11,5,6,4,1,4,11,36.4,7,14,1,13,4,15,7,0
277,Fernando Gorriarán,uy URU,MF,UANL,,30.43561644,1994,28.6,49,34,15,27,7,15,50,30,35,49,6,43,25,74,23,0
278,Ismael Govea,mx MEX,DF,Santos,,28.20273973,1997,11.2,23,15,18,5,0,15,21,71.4,6,16,3,13,8,31,65,0
279,Omar Govea,mx MEX,MF,Guadalajara,,29.29315068,1996,5,11,5,2,7,2,5,8,62.5,3,10,3,7,5,16,7,0
280,Andrés Guardado,mx MEX,MF,León,,38.6,1986,15.3,27,17,14,13,0,6,24,25,18,15,6,9,11,38,19,1
281,Andrés Gudiño,mx MEX,GK,Cruz Azul,,28.26849315,1997,1,0,0,0,0,0,0,0,,0,0,0,0,0,0,1,0
282,Javier Güemez,mx MEX,MF,Santos,,33.54794521,1991,15.4,40,25,16,22,2,17,28,60.7,11,15,6,9,11,51,29,0
283,Javier Güemez,mx MEX,MF,Atlético,,33.54794521,1991,10,23,14,7,14,2,11,20,55,9,9,1,8,10,33,11,0
284,Edgar Guerra,co COL,"DF,MF",León,,24.15616438,2001,11.9,35,18,23,10,2,22,39,56.4,17,14,4,10,11,46,16,1
285,Carlos Guillen,mx MEX,"MF,FW",Atlas,,21.31506849,2004,3.3,8,7,0,4,4,4,7,57.1,3,3,1,2,0,8,1,0
286,Daniel Guillén,mx MEX,DF,Atlético,,23.74794521,2001,7.6,10,7,7,2,1,6,9,66.7,3,17,13,4,13,23,21,2
287,Emanuel Gularte,uy URU,DF,Puebla,,27.59452055,1997,27.9,41,24,28,13,0,21,30,70,9,29,17,12,47,88,163,0
288,Alex Gutiérrez,mx MEX,MF,Necaxa,,16.84383562,2008,0.1,0,0,0,0,0,0,0,,0,0,0,0,0,0,0,0
289,Alexis Gutiérrez,mx MEX,"MF,FW",Cruz Azul,,25.18630137,2000,18.8,20,12,4,13,3,6,19,31.6,13,14,0,14,11,31,10,0
290,Luis Gutiérrez Castellanos,mx MEX,MF,Santos,,23.25479452,2002,6,5,3,1,4,0,3,11,27.3,8,7,1,6,7,12,9,0
291,Edson Gutiérrez,mx MEX,DF,Santos,,29.29041096,1996,11.7,14,10,9,5,0,6,8,75,2,17,13,4,15,29,61,0
292,Edson Gutiérrez,mx MEX,DF,Monterrey,,29.29041096,1996,6.5,18,10,11,6,1,12,14,85.7,2,8,1,7,9,27,23,0
293,Erick Gutiérrez,mx MEX,MF,Guadalajara,,29.88767123,1995,24.5,83,53,28,47,8,36,62,58.1,26,22,9,13,31,114,29,0
294,Luis Gutiérrez,mx MEX,DF,Cruz Azul,,23.54794521,2001,0,1,1,1,0,0,0,0,,0,0,0,0,0,1,0,0
295,Ricardo Gutiérrez,mx MEX,GK,Mazatlán,,27.88219178,1997,0.5,0,0,0,0,0,0,0,,0,0,0,0,0,0,0,0
296,Jorge Guzmán,mx MEX,"MF,DF",Atlas,,21.39178082,2003,4.2,8,6,1,6,1,3,3,100,0,4,0,4,2,10,8,0
297,Nahuel Guzmán,ar ARG,GK,UANL,,39.23013699,1986,28,1,1,1,0,0,1,1,100,0,0,0,0,2,3,9,3
298,Víctor Guzmán,mx MEX,"FW,MF",Guadalajara,,30.24931507,1995,7.8,8,7,3,4,1,5,12,41.7,7,6,3,3,3,11,7,0
299,Víctor Guzmán,mx MEX,DF,Monterrey,,23.16164384,2002,15.6,32,23,22,10,0,16,19,84.2,3,11,3,8,27,59,47,0
300,Helinho,br BRA,"FW,MF",Toluca,,25.02739726,2000,8.1,11,8,6,3,2,6,13,46.2,7,7,1,6,6,17,3,0
301,Diego Hernández,uy URU,"MF,FW",León,,24.86849315,2000,8.6,11,9,6,4,1,3,10,30,7,3,0,3,4,15,5,0
302,Illian Hernandez,mx MEX,"FW,DF",América,,25.0630137,2000,1.4,0,0,0,0,0,0,0,,0,1,0,1,0,0,0,0
303,Illian Hernandez,mx MEX,"FW,MF",Pachuca,,25.0630137,2000,0.8,0,0,0,0,0,0,0,,0,0,0,0,0,0,0,0
304,Javier Hernández,mx MEX,FW,Guadalajara,,36.9260274,1988,10.1,6,4,2,3,1,1,6,16.7,5,3,1,2,2,8,7,0
305,Jesús Hernández,mx MEX,FW,Tijuana,,21.31780822,2004,0.5,0,0,0,0,0,0,1,0,1,0,0,0,1,1,0,0
306,Jesús Hernández,mx MEX,"FW,MF",León,,23.75890411,2001,1.9,2,2,0,2,0,1,3,33.3,2,2,0,2,0,2,0,0
307,Jorge Hernández,mx MEX,GK,Querétaro,,26.40821918,1998,9,0,0,0,0,0,0,0,,0,0,0,0,0,0,3,0
308,Pedro Hernández,mx MEX,MF,León,,24.50958904,2000,0,0,0,0,0,0,0,0,,0,0,0,0,0,0,0,0
309,Sebastián Hernández,mx MEX,"MF,FW",Querétaro,,21.14520548,2004,6.5,20,15,14,6,0,11,14,78.6,3,6,2,4,7,27,11,0
310,Sergio Hernández,mx MEX,"MF,FW",Pachuca,,22.62739726,2002,7.9,10,7,1,4,5,3,10,30,7,8,1,7,4,14,1,0
311,Alberto Herrera,mx MEX,"MF,FW",Puebla,,24.19452055,2001,10.6,19,8,4,9,6,8,18,44.4,10,10,1,9,13,32,11,0
312,Héctor Herrera,mx MEX,MF,Toluca,,35.04383562,1990,5.1,13,8,6,6,1,3,6,50,3,6,3,3,12,25,3,0
313,Ozziel Herrera,mx MEX,"FW,MF",UANL,,23.95068493,2001,12.6,17,7,4,11,2,4,17,23.5,13,13,2,11,10,27,12,0
314,Héctor Holguín,mx MEX,GK,Santos,,24.03013699,2001,1,0,0,0,0,0,0,0,,0,0,0,0,0,0,0,0
315,Santiago Homenchenko,uy URU,MF,Pachuca,,21.67945205,2003,5.2,18,11,3,11,4,6,16,37.5,10,6,2,4,6,24,9,0
316,César Huerta,mx MEX,"FW,MF",UNAM,,24.41917808,2000,14.3,29,21,9,12,8,13,26,50,13,12,1,11,3,32,4,0
317,Rodrigo Huescas,mx MEX,DF,Cruz Azul,,21.62739726,2003,1,2,1,0,0,2,0,0,,0,0,0,0,0,2,1,0
318,Avilés Hurtado,co COL,"FW,MF",FC Juárez,,38.04109589,1987,4.8,6,3,2,3,1,5,12,41.7,7,1,0,1,2,8,0,0
319,Nicolás Ibáñez,ar ARG,FW,UANL,,30.69863014,1994,21.4,14,10,1,6,7,8,26,30.8,18,12,2,10,3,17,18,1
320,Oussama Idrissi,ma MAR,"FW,MF",Pachuca,,29.18630137,1996,26.1,41,28,12,21,8,16,33,48.5,17,31,0,31,9,50,5,2
321,Jefferson Intriago,ec ECU,MF,Mazatlán,,28.91780822,1996,10.4,25,17,10,14,1,15,28,53.6,13,12,5,7,8,33,15,0
322,Hugo Isaác Rodríguez,mx MEX,DF,Santos,,34.90684932,1990,0.8,0,0,0,0,0,0,1,0,1,0,0,0,3,3,5,0
323,Mauricio Isais,mx MEX,"DF,MF",León,,24.07123288,2001,3,9,4,4,5,0,6,9,66.7,3,5,0,5,4,13,1,0
324,Omar Israel Mendoza,mx MEX,DF,Querétaro,,36.51780822,1988,21.8,43,29,27,14,2,17,32,53.1,15,26,13,13,28,71,65,0
325,José Iván Rodríguez,mx MEX,MF,Necaxa,,28.88219178,1996,13.6,35,20,17,15,3,10,17,58.8,7,16,7,9,15,50,27,1
326,Tristhan Jaimes,mx MEX,"MF,FW",Puebla,,22.1260274,2003,0.3,3,1,1,1,1,0,3,0,3,0,0,0,0,3,1,0
327,Cristian Jiménez,mx MEX,"DF,MF",Cruz Azul,,22.79726027,2002,0.5,0,0,0,0,0,0,0,,0,1,1,0,0,0,4,0
328,Oscar Jiménez,mx MEX,GK,León,,36.56164384,1988,8,0,0,0,0,0,0,0,,0,0,0,0,0,0,3,0
329,Miguel Jiménez Ponce,mx MEX,GK,Puebla,,35.14246575,1990,24,0,0,0,0,0,0,2,0,2,3,0,3,0,0,12,1
330,Ricardo Jiménez,mx MEX,MF,Necaxa,,19.03561644,2006,0,0,0,0,0,0,0,0,,0,0,0,0,0,0,0,0
331,Tahiel Jiménez,mx MEX,"FW,MF",Santos,,19.28219178,2006,10.7,7,3,2,2,3,3,8,37.5,5,5,2,3,3,10,3,1
332,Joaquim,br BRA,DF,UANL,,26.35068493,1998,27.7,55,41,40,13,2,29,38,76.3,9,36,26,10,36,91,133,1
333,José Joaquín Esquivel,mx MEX,DF,Mazatlán,,27.32328767,1998,9,33,23,20,13,0,17,20,85,3,22,13,9,16,49,39,0
334,Julio José González,mx MEX,GK,Puebla,,34.03287671,1991,6,1,0,1,0,0,1,2,50,1,0,0,0,0,1,3,2
335,Julio José González,mx MEX,GK,UNAM,,34.03287671,1991,13,0,0,0,0,0,0,1,0,1,0,0,0,0,0,11,1
336,Juan José Sánchez,co COL,DF,UANL,,27.31780822,1998,7.4,10,5,3,6,1,6,7,85.7,1,4,3,1,10,20,39,0
337,José Juan Macías,mx MEX,"FW,MF",Santos,,25.61643836,1999,0.6,0,0,0,0,0,0,0,,0,1,1,0,0,0,2,0
338,Ramón Juárez,mx MEX,DF,América,,23.9890411,2001,18.9,26,16,16,10,0,18,27,66.7,9,18,14,4,32,58,93,0
339,Jhojan Julio,ec ECU,"FW,DF",Tijuana,,27.22739726,1998,3.7,10,7,5,4,1,6,7,85.7,1,2,0,2,3,13,1,0
340,Heriberto Jurado,mx MEX,"DF,FW",Necaxa,,20.33424658,2005,10.5,20,18,12,7,1,6,14,42.9,8,13,3,10,10,30,15,0
341,Sebastián Jurado,mx MEX,GK,FC Juárez,,27.6,1997,21,1,0,1,0,0,1,2,50,1,0,0,0,0,1,9,4
342,John Kennedy,br BRA,"MF,FW",Pachuca,,22.96438356,2002,12.4,4,2,1,3,0,1,3,33.3,2,11,0,11,2,6,2,0
343,Mateo Klimowicz,de GER,"FW,MF",Atlético,,24.83013699,2000,9.3,14,8,3,6,5,4,7,57.1,3,6,0,6,1,15,3,0
344,Roberto de la Rosa,mx MEX,"FW,MF",Monterrey,,25.33150685,2000,7.1,1,1,1,0,0,0,5,0,5,5,0,5,0,1,4,0
345,Diego Lainez,mx MEX,"FW,DF",UANL,,24.90410959,2000,17.8,36,20,12,20,4,17,30,56.7,13,17,0,17,16,52,14,0
346,Mauro Laínez,mx MEX,"MF,DF",Mazatlán,,28.9890411,1996,7.4,12,10,7,4,1,7,11,63.6,4,3,0,3,7,19,7,0
347,Emilio Lara,mx MEX,DF,América,,22.96438356,2002,0.7,1,1,0,1,0,1,2,50,1,2,0,2,1,2,3,0
348,Emilio Lara,mx MEX,DF,Necaxa,,22.96438356,2002,21.8,33,23,14,17,2,16,26,61.5,10,34,18,16,28,61,75,2
349,Pablo Lara,mx MEX,GK,UNAM,,19.84931507,2005,7,0,0,0,0,0,0,2,0,2,0,0,0,0,0,6,1
350,Israel Larios,mx MEX,"FW,MF",Atlas,,21.98356164,2003,2.1,8,5,2,4,2,1,3,33.3,2,1,1,0,1,9,0,0
351,Antonio Leone,mx MEX,DF,Monterrey,,21.01917808,2004,1.1,1,0,0,1,0,0,0,,0,2,1,1,1,2,5,0
352,Federico Lértora,ar ARG,MF,Querétaro,,34.83287671,1990,25.9,63,37,26,34,3,26,58,44.8,32,40,17,23,18,81,50,1
353,Mateo Levy,mx MEX,"FW,MF",Cruz Azul,,18.53424658,2006,2.1,1,1,0,0,1,0,1,0,1,2,0,2,0,1,0,0
354,Emanuel Ley,mx MEX,FW,Tijuana,,19.09589041,2006,0.2,0,0,0,0,0,0,0,,0,0,0,0,0,0,0,0
355,Ángel Leyva,mx MEX,DF,Mazatlán,,18.55890411,2006,0.1,1,1,1,0,0,1,1,100,0,1,1,0,0,1,0,0
356,Igor Lichnovsky,cl CHI,DF,América,,31.16164384,1994,1,3,3,2,1,0,1,1,100,0,1,1,0,0,3,3,0
357,Erik Lira,mx MEX,"DF,MF",Cruz Azul,,24.99178082,2000,29.1,78,46,43,33,2,36,57,63.2,21,34,12,22,27,105,48,1
358,Aldo López,mx MEX,"MF,DF",Santos,,24.95068493,2000,22.3,35,20,12,21,2,17,36,47.2,19,24,7,17,37,72,28,2
359,César López,mx MEX,"MF,FW",FC Juárez,,23.16164384,2002,0.9,1,1,0,1,0,1,2,50,1,2,0,2,0,1,0,0
360,Cesar López,mx MEX,GK,Atlético,,24.90136986,2000,4.8,0,0,0,0,0,0,0,,0,0,0,0,0,0,5,3
361,Daniel López,mx MEX,"FW,MF",Querétaro,,25.14246575,2000,0.1,1,1,0,0,1,0,0,,0,0,0,0,0,1,0,0
362,Eder López,mx MEX,DF,FC Juárez,,19.33972603,2006,2.9,10,6,6,3,1,5,7,71.4,2,3,2,1,4,14,9,0
363,Edgar López,mx MEX,"FW,MF",Toluca,,26.03835616,1999,6.8,1,1,0,0,1,1,2,50,1,4,1,3,7,8,3,0
364,Pau López,es ESP,GK,Toluca,,30.39178082,1994,10,1,1,1,0,0,1,2,50,1,0,0,0,0,1,3,1
365,Rodrigo López,mx MEX,"MF,DF",UNAM,,23.47671233,2001,11.2,16,13,5,6,5,7,11,63.6,4,8,1,7,5,21,11,0
366,Santiago López,ca CAN,"MF,FW",UNAM,,19.90136986,2005,1.3,2,1,1,0,1,2,4,50,2,0,0,0,0,2,1,0
367,Victor Lopez,mx MEX,MF,Querétaro,,21.99178082,2003,0.5,0,0,0,0,0,0,0,,0,1,0,1,0,0,0,0
368,Vladimir Loroña,mx MEX,"DF,FW",Santos,,26.46575342,1998,2.7,7,5,5,2,0,4,7,57.1,3,8,3,5,3,10,14,0
369,Vladimir Loroña,mx MEX,"DF,MF",UANL,,26.46575342,1998,2.8,11,8,7,3,1,10,11,90.9,1,3,1,2,2,13,10,0
370,Anthony Lozano,hn HON,FW,Santos,,32.02739726,1993,13.8,9,6,3,6,0,4,12,33.3,8,4,2,2,1,10,11,0
371,Esteban Lozano,mx MEX,"MF,FW",América,,22.15342466,2003,1.2,0,0,0,0,0,0,0,,0,1,0,1,0,0,1,0
372,José Lozano,mx MEX,"FW,DF",Atlas,,26.58082192,1998,24.9,30,16,11,15,4,15,26,57.7,11,22,4,18,21,51,30,0
373,José Luis Rodríguez,pa PAN,"FW,MF",FC Juárez,,26.87671233,1998,21.5,32,22,19,11,2,15,24,62.5,9,21,1,20,16,48,18,0
374,Israel Luna,mx MEX,"DF,MF",Pachuca,,23.11780822,2002,0.4,0,0,0,0,0,0,1,0,1,1,0,1,0,0,0,0
375,Oscar Macías,mx MEX,MF,Atlético,,26.82191781,1998,24.6,54,29,30,22,2,29,52,55.8,23,24,5,19,15,69,21,0
376,Waldo Madrid,mx MEX,FW,Necaxa,,21.69315068,2003,0.3,0,0,0,0,0,0,0,,0,2,0,2,0,0,1,0
377,Fernando Madrigal,mx MEX,"MF,DF",Tijuana,,33.47671233,1991,3.6,9,5,5,3,1,5,16,31.3,11,5,0,5,0,9,2,0
378,Madson,br BRA,"FW,MF",FC Juárez,,25.69041096,1999,9.6,6,4,3,3,0,4,12,33.3,8,12,1,11,4,10,4,0
379,Lisandro Magallán,ar ARG,DF,UNAM,,31.60273973,1993,21.1,39,22,27,11,1,18,27,66.7,9,21,11,10,35,74,108,0
380,Luis Manuel García,mx MEX,GK,Toluca,,32.34246575,1992,5,0,0,0,0,0,0,0,,0,0,0,0,0,0,4,1
381,Óscar Manzanarez,mx MEX,DF,Querétaro,,30.03013699,1995,13.5,23,15,14,7,2,13,20,65,7,10,9,1,20,43,77,1
382,Cristian Mares,mx MEX,"FW,MF",Puebla,,20.64383562,2004,2.2,3,1,1,1,1,2,6,33.3,4,3,0,3,2,5,2,0
383,Antonio María,mx MEX,"FW,MF",Querétaro,,21.0630137,2004,2.7,1,1,0,1,0,1,4,25,3,0,0,0,1,2,2,0
384,Ricardo Marín,mx MEX,"FW,MF",Puebla,,27.13150685,1998,11.5,13,5,4,7,2,3,9,33.3,6,19,3,16,3,16,13,0
385,Ricardo Marín,mx MEX,"FW,MF",Guadalajara,,27.13150685,1998,7,13,9,1,9,3,4,6,66.7,2,2,0,2,1,14,2,0
386,Salvador Mariscal,mx MEX,MF,Santos,,22.03561644,2003,16,32,25,22,10,0,11,20,55,9,34,18,16,21,53,35,0
387,Ángel Márquez,mx MEX,MF,Atlas,,24.87123288,2000,27.7,59,37,21,31,7,23,50,46,27,25,4,21,47,106,27,2
388,Henry Martín,mx MEX,FW,América,,32.46027397,1992,18.6,20,8,2,14,4,3,10,30,7,16,2,14,1,21,16,0
389,Guillermo Martínez Ayala,mx MEX,FW,UNAM,,30.13972603,1995,18.6,9,6,1,6,2,3,8,37.5,5,7,1,6,3,12,6,0
390,Gabriel Martínez,mx MEX,DF,Atlético,,22.78082192,2002,0.2,0,0,0,0,0,0,0,,0,0,0,0,1,1,1,0
391,Emilio Martínez González,mx MEX,DF,Necaxa,,22.25205479,2003,9.2,15,10,8,6,1,12,24,50,12,10,4,6,5,20,30,1
392,Raúl Martínez,mx MEX,DF,Guadalajara,,22.16712329,2003,6.8,15,12,8,7,0,9,13,69.2,4,12,9,3,2,17,19,0
393,Sebastián Martínez,mx MEX,FW,Atlético,,22.02739726,2003,0,0,0,0,0,0,0,0,,0,0,0,0,0,0,0,0
394,Alejandro Mayorga,mx MEX,DF,Necaxa,,27.93424658,1997,20.8,42,25,26,14,2,30,45,66.7,15,33,4,29,27,69,57,1
395,Alan Medina,mx MEX,"MF,DF",Querétaro,,27.70958904,1997,7.9,13,10,8,3,2,3,7,42.9,4,3,0,3,5,18,2,0
396,Alan Medina,uy URU,"MF,FW",León,,27.06849315,1998,2.4,4,0,2,1,1,2,5,40,3,4,2,2,1,5,2,0
397,Diego Medina,mx MEX,"FW,DF",Santos,,24.14794521,2001,6.3,19,11,7,9,3,10,22,45.5,12,9,2,7,5,24,7,0
398,Stefan Medina,co COL,DF,Monterrey,,32.89041096,1992,27.7,49,31,29,18,2,28,41,68.3,13,28,16,12,42,91,113,1
399,Aaron Mejía Montoya,mx MEX,"DF,MF",Tijuana,,23.91232877,2001,20.1,28,18,15,10,3,15,29,51.7,14,19,5,14,13,41,47,1
400,Ángel Mena,ec ECU,"MF,FW",Pachuca,,37.28493151,1988,1.9,1,0,0,1,0,1,2,50,1,3,0,3,0,1,0,0
401,Alex Mendez,us USA,"FW,MF",FC Juárez,,24.66027397,2000,0.7,2,1,1,0,1,2,4,50,2,1,0,1,0,2,2,0
402,Bruno Méndez,uy URU,DF,Toluca,,25.64931507,1999,17.8,23,15,13,7,3,14,24,58.3,10,26,14,12,23,46,71,0
403,Stiven Mendoza,co COL,"FW,MF",León,,32.85479452,1992,23.2,12,7,5,3,4,6,12,50,6,15,0,15,2,14,7,0
404,Jean Meneses,cl CHI,FW,Toluca,,32.1369863,1993,2.8,3,3,2,1,0,2,3,66.7,1,3,0,3,3,6,3,0
405,Roberto Meraz,mx MEX,MF,Mazatlán,,25.75068493,1999,19.8,27,21,13,11,3,7,25,28,18,19,10,9,15,42,39,0
406,Lucas Merolla,ar ARG,DF,Mazatlán,,29.85479452,1995,17.5,25,16,18,7,0,8,15,53.3,7,19,13,6,44,69,106,0
407,Maximiliano Meza,ar ARG,"MF,FW",Monterrey,,32.38630137,1992,2.2,4,1,2,2,0,2,5,40,3,2,0,2,1,5,3,1
408,Andrés Micolta,ec ECU,DF,Pachuca,,25.91232877,1999,6.3,7,5,5,2,0,3,4,75,1,9,8,1,5,12,40,2
409,Kevin Mier,co COL,GK,Cruz Azul,,24.96438356,2000,33,2,2,1,1,0,1,2,50,1,0,0,0,1,3,13,3
410,Fernando Monárrez,mx MEX,"DF,FW",Tijuana,,25.78630137,1999,1.2,4,3,1,2,1,2,4,50,2,4,0,4,4,8,1,0
411,Ricardo Monreal,mx MEX,"FW,MF",Necaxa,,24.23013699,2001,13.5,19,13,8,8,3,9,28,32.1,19,15,2,13,11,30,17,0
412,Pablo Monroy,mx MEX,DF,UNAM,,22.78630137,2002,11.4,19,16,11,7,1,13,23,56.5,10,13,4,9,11,30,31,0
413,Andres Montaño,mx MEX,"MF,FW",Cruz Azul,,22.95342466,2002,7.1,13,11,5,7,1,7,10,70,3,5,2,3,5,18,3,0
414,Alán Montes,mx MEX,DF,Necaxa,,24.52328767,2000,15.7,36,26,24,12,0,16,26,61.5,10,13,9,4,24,60,84,1
415,Elias Montiel,mx MEX,MF,Pachuca,,19.57534247,2005,24.6,76,43,31,33,12,29,48,60.4,19,39,7,32,30,106,11,0
416,Adrián Mora,mx MEX,DF,Atlas,,27.72054795,1997,8.5,25,19,20,4,1,14,16,87.5,2,12,8,4,17,42,49,1
417,Gilberto Mora,mx MEX,"MF,FW",Tijuana,,16.55616438,2008,15.1,10,8,2,6,2,7,15,46.7,8,8,0,8,8,18,4,0
418,Amaury Morales,mx MEX,"FW,MF",Cruz Azul,,19.41917808,2005,6.8,11,8,4,7,0,7,12,58.3,5,5,2,3,3,14,2,0
419,Robert Morales,py PAR,FW,Toluca,,26.13424658,1999,6.8,8,6,1,3,4,1,3,33.3,2,5,0,5,0,8,2,0
420,Carlos Moreno,mx MEX,GK,Pachuca,,27.2630137,1998,32,0,0,0,0,0,0,2,0,2,1,0,1,0,0,22,2
421,Héctor Moreno,mx MEX,DF,Monterrey,,37.29589041,1988,14.7,10,6,3,7,0,6,12,50,6,19,12,7,7,17,48,0
422,Iker Moreno,mx MEX,DF,Atlético,,21.63835616,2003,1.9,10,5,7,2,1,5,9,55.6,4,1,0,1,4,14,9,0
423,Iván Moreno,mx MEX,"MF,DF",León,,27.29589041,1998,13.4,36,20,18,15,3,19,35,54.3,16,7,0,7,6,42,21,0
424,Omar Moreno,mx MEX,"FW,MF",Mazatlán,,20.26027397,2005,4.6,7,6,0,5,2,3,4,75,1,3,0,3,1,8,1,0
425,Joaquín Moxica,mx MEX,FW,Monterrey,,19.26849315,2006,0.3,1,0,1,0,0,0,0,,0,0,0,0,0,1,0,0
426,Franco Moyano,ar ARG,MF,Puebla,,27.64109589,1997,13.8,17,12,4,10,3,8,22,36.4,14,4,1,3,19,36,17,0
427,Alan Mozo,mx MEX,DF,Guadalajara,,28.08219178,1997,22.2,49,38,31,15,3,22,44,50,22,19,2,17,23,72,39,0
428,Guillermo Muñoz,mx MEX,"DF,FW",Santos,,20.59452055,2004,3.7,13,11,7,4,2,7,18,38.9,11,2,0,2,5,18,9,1
429,Santiago Muñóz,mx MEX,"FW,MF",Santos,,22.72328767,2002,13.6,8,5,2,5,1,4,10,40,6,6,3,3,2,10,5,0
430,Jhon Murillo,ve VEN,"FW,DF",Atlético,,29.45205479,1995,3.8,1,0,1,0,0,0,4,0,4,2,1,1,1,2,5,1
431,Jhon Murillo,ve VEN,"FW,DF",Atlas,,29.45205479,1995,14,15,9,10,1,4,9,18,50,9,9,2,7,11,26,13,0
432,Luis Nájera,mx MEX,"MF,FW",Atlético,,22.19178082,2003,14.1,12,9,4,7,1,2,11,18.2,9,9,1,8,2,14,3,1
433,Gonzalo Nápoli,uy URU,"MF,FW",León,,24.99178082,2000,0.1,2,1,0,2,0,0,0,,0,0,0,0,0,2,0,0
434,Luis Navarrete,mx MEX,MF,Toluca,,18.69863014,2006,0.1,0,0,0,0,0,0,0,,0,0,0,0,0,0,0,0
435,Santiago Naveda,mx MEX,MF,Santos,,24.05205479,2001,10.5,27,13,14,12,1,17,24,70.8,7,9,2,7,10,37,9,0
436,Hugo Nervo,ar ARG,DF,Atlas,,34.3260274,1991,30.9,20,11,14,5,1,15,29,51.7,14,40,21,19,55,75,166,0
437,Francisco Nevarez,mx MEX,"DF,MF",FC Juárez,,24.41917808,2000,1.6,11,4,6,5,0,5,7,71.4,2,3,0,3,2,13,8,0
438,Shamar Nicholson,jm JAM,FW,Tijuana,,28.1369863,1997,4.7,1,1,1,0,0,0,0,,0,4,3,1,0,1,6,0
439,Santiago Núñez,ar ARG,DF,Santos,,25.01643836,2000,8.8,13,5,11,2,0,5,12,41.7,7,15,13,2,17,30,59,1
440,Joan Nungaray,mx MEX,FW,Puebla,,20.51780822,2004,0,0,0,0,0,0,0,0,,0,0,0,0,0,0,0,0
441,Lucas Ocampos,ar ARG,"FW,MF",Monterrey,,30.81643836,1994,13.9,18,14,5,5,8,8,16,50,8,10,2,8,5,23,11,0
442,Diego Ochoa,mx MEX,DF,Guadalajara,,20.04109589,2005,0.5,1,1,1,0,0,1,1,100,0,0,0,0,0,1,0,0
443,Agustín Oliveros,uy URU,DF,Necaxa,,26.71506849,1998,25.3,27,19,23,4,0,12,21,57.1,9,27,18,9,26,53,111,0
444,Sebastián Olmedo,py PAR,DF,Puebla,,23.87123288,2001,6.2,7,3,4,3,0,3,8,37.5,5,8,4,4,7,14,27,0
445,Fernando Ordóñez,mx MEX,DF,UANL,,23.92328767,2001,0.2,2,1,1,1,0,0,0,,0,0,0,0,0,2,0,0
446,Santiago Ormeño,pe PER,FW,Puebla,,31.24657534,1994,5.4,0,0,0,0,0,0,5,0,5,1,0,1,4,4,3,0
447,Efraín Orona,mx MEX,DF,Puebla,,26.19726027,1999,31.1,45,30,34,10,1,25,37,67.6,12,43,24,19,50,95,131,0
448,Jesús Orozco,mx MEX,DF,Cruz Azul,,23.20547945,2002,12.2,25,17,8,16,1,14,16,87.5,2,16,3,13,12,37,48,0
449,Jesús Orozco,mx MEX,DF,Guadalajara,,23.20547945,2002,14.1,21,15,16,5,0,13,15,86.7,2,18,10,8,29,50,44,2
450,Ralph Orquin,us USA,DF,FC Juárez,,22.05479452,2003,30.8,54,35,40,11,3,28,49,57.1,21,27,9,18,45,99,62,1
451,Carlos Orrantía,mx MEX,DF,Toluca,,34.25479452,1991,2.1,4,3,2,1,1,4,6,66.7,2,0,0,0,2,6,6,0
452,Carlos Orrantía,mx MEX,"DF,MF",Atlas,,34.25479452,1991,7.5,11,6,6,2,3,5,9,55.6,4,1,0,1,3,14,11,0
453,Haret Ortega,mx MEX,"DF,MF",FC Juárez,,24.96164384,2000,8.2,16,11,12,3,1,8,9,88.9,1,9,2,7,16,32,46,2
454,Kevin Ortega,mx MEX,MF,Atlético,,23.33150685,2002,0.1,3,2,1,2,0,3,5,60,2,0,0,0,0,3,0,0
455,Miguel Ortega,mx MEX,GK,Tijuana,,30.06027397,1995,3,0,0,0,0,0,0,0,,0,0,0,0,0,0,1,0
456,Pablo Ortiz,mx MEX,DF,Querétaro,,23.08219178,2002,9.4,19,10,15,3,1,12,20,60,8,10,6,4,9,28,52,2
457,Youssef Ortiz,mx MEX,DF,León,,18.49589041,2006,0.1,1,0,1,0,0,1,1,100,0,0,0,0,0,1,1,0
458,José Pablo Saldívar,mx MEX,MF,Pachuca,,22.09863014,2003,3.2,9,6,6,3,0,2,5,40,3,1,0,1,3,12,8,0
459,Juan Pablo Vigón,mx MEX,MF,UANL,,33.79178082,1991,4.7,7,6,1,5,1,4,5,80,1,4,0,4,2,9,0,1
460,Jose Pachuca,mx MEX,DF,Puebla,,19.78082192,2005,16.9,39,26,27,11,1,26,32,81.3,6,25,18,7,23,62,87,1
461,Alex Padilla,es ESP,GK,UNAM,,21.6739726,2003,10,0,0,0,0,0,0,0,,0,0,0,0,0,0,8,3
462,Jonathan Padilla,mx MEX,"MF,FW",Guadalajara,,19.37534247,2005,10.8,28,16,13,13,2,12,35,34.3,23,14,1,13,2,30,10,0
463,Joshua Palacios,mx MEX,MF,Necaxa,,18.33972603,2007,0.1,0,0,0,0,0,0,0,,0,0,0,0,0,0,0,0
464,Agustín Palavecino,ar ARG,MF,Necaxa,,28.48493151,1996,32.8,84,60,34,37,13,37,92,40.2,55,42,6,36,38,122,40,1
465,Arturo Palma,mx MEX,"DF,MF",Necaxa,,23.29863014,2002,5.9,13,6,8,5,0,4,8,50,4,6,2,4,3,16,12,0
466,José Paradela,ar ARG,"MF,FW",Necaxa,,26.38630137,1998,32,62,43,20,35,7,22,45,48.9,23,19,1,18,21,83,9,0
467,Bernardo Parra,mx MEX,MF,UANL,,20.3260274,2005,6,11,7,2,8,1,7,12,58.3,5,0,0,0,8,19,3,0
468,Paulinho,pt POR,FW,Toluca,,32.48493151,1992,29.4,20,13,3,10,7,5,16,31.3,11,14,2,12,4,24,27,0
469,Denilson Paz,mx MEX,MF,Puebla,,19.82191781,2005,0.4,1,0,0,1,0,1,2,50,1,2,0,2,0,1,0,0
470,Pedro Pedraza,mx MEX,MF,Pachuca,,25.01369863,2000,18.6,62,40,22,37,3,20,51,39.2,31,20,7,13,38,100,41,0
471,Federico Pereira,uy URU,DF,Toluca,,25.19178082,2000,22.5,52,36,36,16,0,25,50,50,25,33,18,15,24,76,104,2
472,Aldahir Perez,mx MEX,MF,Querétaro,,20.58356164,2004,8,19,12,6,11,2,10,22,45.5,12,7,0,7,7,26,2,0
473,Sebastián Pérez Bouquet,mx MEX,"MF,FW",FC Juárez,,21.86849315,2003,0.4,0,0,0,0,0,0,1,0,1,0,0,0,0,0,0,0
474,Sebastián Pérez Bouquet,mx MEX,MF,Atlético,,21.86849315,2003,0,1,0,0,1,0,0,0,,0,1,0,1,1,2,0,0
475,Jonathan Pérez,mx MEX,DF,Santos,,19.52054795,2005,10.9,26,16,19,5,2,9,15,60,6,15,7,8,21,47,57,0
476,Pavel Pérez,mx MEX,"MF,FW",Necaxa,,26.85753425,1998,9.5,26,17,7,14,5,9,21,42.9,12,19,0,19,6,32,6,0
477,Pavel Pérez,mx MEX,"MF,FW",Guadalajara,,26.85753425,1998,1.6,4,3,2,1,1,1,4,25,3,0,0,0,1,5,0,0
478,Jonathan Perlaza,ec ECU,"DF,MF",Querétaro,,27.64109589,1997,6,16,11,11,4,1,5,14,35.7,9,3,0,3,3,19,11,0
479,Yan Phillipe,br BRA,"FW,MF",Atlético,,20.96712329,2004,8.8,11,8,4,6,1,3,10,30,7,5,0,5,1,12,3,0
480,Cristiano Piccini,it ITA,DF,Atlético,,32.60547945,1992,3.3,7,3,4,3,0,4,7,57.1,3,6,0,6,9,16,9,1
481,Jesús Piñuelas,mx MEX,MF,Toluca,,27.10684932,1998,0,0,0,0,0,0,0,0,,0,0,0,0,1,1,0,0
482,Jesús Piñuelas,mx MEX,DF,Querétaro,,27.10684932,1998,2.4,6,5,3,3,0,2,3,66.7,1,1,1,0,1,7,13,0
483,Gonzalo Piovi,ar ARG,DF,Cruz Azul,,30.65479452,1994,25.6,77,53,46,29,2,50,77,64.9,27,22,4,18,48,125,91,3
484,Guido Pizarro,ar ARG,"DF,MF",UANL,,35.18630137,1990,24,54,32,21,31,2,23,46,50,23,38,14,24,18,72,52,0
485,Rodolfo Pizarro,mx MEX,"MF,FW",Mazatlán,,31.21643836,1994,17.2,29,19,5,13,11,8,22,36.4,14,12,0,12,4,33,8,0
486,Jackson Porozo,ec ECU,DF,Tijuana,,24.75068493,2000,12.3,26,12,14,11,1,14,20,70,6,11,7,4,21,47,80,2
487,Osvaldo Rodríguez del Portal,mx MEX,"DF,FW",UANL,,28.64931507,1996,1.9,3,2,2,1,0,1,3,33.3,2,0,0,0,3,6,4,0
488,Osvaldo Rodríguez del Portal,mx MEX,"FW,DF",León,,28.64931507,1996,0.1,0,0,0,0,0,0,0,,0,0,0,0,0,0,2,0
489,Walter Portales,us USA,"DF,FW",América,,21.10684932,2004,1,2,2,2,0,0,2,3,66.7,1,1,0,1,0,2,1,0
490,Adonis Preciado,ec ECU,"FW,MF",Querétaro,,28.11780822,1997,13.7,20,12,10,3,7,8,16,50,8,9,0,9,5,25,14,0
491,Ayrton Preciado,ec ECU,"MF,DF",Querétaro,,30.8,1994,1.5,3,2,1,2,0,0,0,,0,0,0,0,0,3,2,0
492,Ronaldo Prieto,mx MEX,DF,Santos,,28.17260274,1997,2.3,9,9,8,1,0,7,9,77.8,2,4,3,1,2,11,6,0
493,Luis Puente,mx MEX,FW,Pachuca,,22.22191781,2003,1.1,0,0,0,0,0,0,0,,0,1,0,1,0,0,1,0
494,Alan Pulido,mx MEX,FW,Guadalajara,,34.15890411,1991,5.9,3,3,1,0,2,2,3,66.7,1,0,0,0,1,4,4,1
495,Ignacio Pussetto,ar ARG,"FW,MF",UNAM,,29.36986301,1995,17.9,31,13,3,15,13,10,27,37,17,17,4,13,9,40,16,0
496,Piero Quispe,pe PER,MF,UNAM,,23.72328767,2001,20.3,41,27,15,19,7,20,36,55.6,16,24,1,23,14,55,5,0
497,Alonso Ramírez,mx MEX,MF,Atlas,,23.70684932,2001,0.6,3,1,2,1,0,2,2,100,0,2,0,2,1,4,0,0
498,Diego Ramirez,mx MEX,FW,UANL,,18.30136986,2007,0,0,0,0,0,0,0,0,,0,0,0,0,0,0,0,0
499,Héctor Ramírez,mx MEX,DF,UNAM,,21.28219178,2004,1.3,3,1,2,1,0,0,4,0,4,2,0,2,2,5,2,0
500,Miguel Ramírez,us USA,"MF,FW",América,,22.84657534,2002,3.5,3,3,2,1,0,2,6,33.3,4,2,1,1,1,4,0,1
501,Paulo Ramírez,mx MEX,MF,Atlas,,22.55068493,2002,6.9,12,9,5,6,1,6,18,33.3,12,5,0,5,5,17,4,0
502,Sergio Ramos,es ESP,DF,Monterrey,,39.09863014,1986,7.7,10,8,6,4,0,6,7,85.7,1,7,4,3,6,16,28,0
503,José Rangel Aguilar,mx MEX,GK,Guadalajara,,25.1890411,2000,32,3,2,3,0,0,3,4,75,1,0,0,0,2,5,21,2
504,Luis Rey,mx MEX,DF,Guadalajara,,22.63835616,2002,8.6,16,6,8,7,1,7,12,58.3,5,7,5,2,14,30,39,0
505,Cristian Reyes,mx MEX,"MF,FW",Monterrey,,19.06849315,2006,0.2,0,0,0,0,0,0,3,0,3,0,0,0,0,0,1,0
506,Diego Reyes,mx MEX,MF,América,,17.66849315,2007,0,1,0,0,1,0,1,1,100,0,0,0,0,0,1,0,0
507,Diego Reyes,mx MEX,DF,UANL,,32.62465753,1992,12.7,13,11,9,3,1,5,6,83.3,1,16,10,6,23,36,44,0
508,Israel Reyes,mx MEX,DF,América,,24.95068493,2000,23.8,27,19,16,11,0,19,25,76,6,23,13,10,51,78,71,1
509,Salvador Reyes,mx MEX,DF,León,,27.00273973,1998,31.7,54,36,34,14,6,31,64,48.4,33,44,8,36,27,81,86,0
510,Emanuel Reynoso,ar ARG,"MF,FW",Tijuana,,29.46575342,1995,11.1,23,16,4,15,4,3,14,21.4,11,13,0,13,5,28,1,0
511,Luis Ricardo Reyes,mx MEX,DF,Atlas,,34.08767123,1991,15.3,31,22,18,10,3,13,22,59.1,9,18,4,14,21,52,30,0
512,Luis Ricardo Reyes,mx MEX,DF,Monterrey,,34.08767123,1991,3.3,9,7,5,3,1,5,9,55.6,4,3,0,3,3,12,10,0
513,Ángel Rico,mx MEX,MF,UNAM,,20.30958904,2005,9.5,8,3,3,5,0,2,13,15.4,11,7,1,6,3,11,6,0
514,Emiliano Rigoni,ar ARG,"FW,MF",León,,32.24657534,1993,5.3,9,5,5,2,2,4,7,57.1,3,3,1,2,0,9,4,0
515,Martín Río,ar ARG,"MF,DF",Querétaro,,24.14246575,2001,7.3,15,10,9,5,1,7,13,53.8,6,15,5,10,11,26,21,0
516,Víctor Ríos,mx MEX,"DF,MF",Atlas,,21.22739726,2004,17.8,67,34,25,36,6,28,37,75.7,9,25,4,21,28,95,82,1
517,Jesús Rivas,mx MEX,DF,Puebla,,22.51506849,2002,9.5,39,22,22,14,3,26,45,57.8,19,10,2,8,9,48,39,0
518,Jesús Rivas,mx MEX,DF,UNAM,,22.51506849,2002,1.6,7,5,4,3,0,6,6,100,0,3,2,1,3,10,7,0
519,Ulises Rivas,mx MEX,"MF,DF",UNAM,,29.2739726,1996,10.3,19,14,6,11,2,7,14,50,7,13,4,9,15,34,21,0
520,Christian Rivera,co COL,MF,Tijuana,,29.30410959,1996,15.9,72,51,32,37,3,32,53,60.4,21,17,7,10,11,83,27,1
521,Ignacio Rivero,uy URU,"DF,MF",Cruz Azul,,33.06849315,1992,22.2,57,36,24,27,6,36,80,45,44,22,3,19,11,68,24,0
522,Ángel Robles,mx MEX,"MF,FW",Puebla,,23.46027397,2001,2.7,4,3,2,2,0,1,5,20,4,3,0,3,3,7,3,0
523,Carlos Robles,mx MEX,MF,Atlas,,24.81643836,2000,0.2,1,0,0,0,1,1,1,100,0,0,0,0,0,1,1,0
524,Juan Robles,mx MEX,"MF,DF",Querétaro,,21.62739726,2003,5.4,9,7,7,2,0,3,8,37.5,5,6,0,6,5,14,11,0
525,Aldo Rocha,mx MEX,MF,Atlas,,32.49315068,1992,28.6,48,30,21,22,5,26,58,44.8,32,24,7,17,27,75,30,2
526,Brian Rodríguez,uy URU,"FW,MF",América,,24.95890411,2000,17.6,18,14,5,10,3,6,17,35.3,11,11,2,9,6,24,4,0
527,Charly Rodríguez,mx MEX,MF,Cruz Azul,,28.33424658,1997,28.7,39,24,12,24,3,20,61,32.8,41,23,1,22,24,63,10,1
528,David Rodriguez,us USA,MF,Atlético,,23,2002,0.2,1,1,0,1,0,0,0,,0,0,0,0,0,1,0,0
529,James Rodríguez,co COL,"MF,FW",León,,33.81369863,1991,13.6,10,7,4,6,0,6,11,54.5,5,6,1,5,6,16,6,0
530,Jesús Rodríguez,mx MEX,GK,Puebla,,31.95616438,1993,4,0,0,0,0,0,0,0,,0,0,0,0,0,0,1,1
531,Jorge Rodríguez,mx MEX,DF,Puebla,,23.66849315,2001,6.7,20,12,14,5,1,5,13,38.5,8,11,0,11,5,25,16,0
532,Lucas Rodríguez,ar ARG,"MF,FW",Querétaro,,28.02191781,1997,21,43,24,11,21,11,18,28,64.3,10,15,4,11,11,54,13,0
533,Michell Rodríguez,mx MEX,"FW,DF",UNAM,,24.73424658,2000,0.8,3,1,1,0,2,3,4,75,1,2,0,2,4,7,1,0
534,Miguel Rodríguez,mx MEX,"MF,FW",Pachuca,,22.03835616,2003,5.9,10,6,4,6,0,3,10,30,7,8,1,7,2,12,2,0
535,Salvador Rodríguez,mx MEX,"DF,FW",Mazatlán,,23.74520548,2001,5.8,12,5,7,5,0,8,13,61.5,5,8,1,7,7,19,22,0
536,Johan Rojas,co COL,"MF,DF",Necaxa,,22.62191781,2002,2.4,14,6,6,6,2,5,11,45.5,6,3,0,3,2,16,9,0
537,Johan Rojas,co COL,"FW,MF",Monterrey,,22.62191781,2002,6,11,7,3,7,1,6,11,54.5,5,9,0,9,2,13,3,0
538,Franco Romero,ar ARG,MF,Toluca,,25.03287671,2000,9.3,25,12,13,11,1,17,26,65.4,9,8,3,5,14,39,11,0
539,Luka Romero,ar ARG,"MF,FW",Cruz Azul,,20.46027397,2004,7.4,11,9,6,4,1,4,11,36.4,7,7,0,7,0,11,3,0
540,Luis Romo,mx MEX,"MF,FW",Cruz Azul,,29.91506849,1995,12,24,14,6,15,3,16,27,59.3,11,8,3,5,9,33,9,0
541,Luis Romo,mx MEX,MF,Guadalajara,,29.91506849,1995,11.2,26,19,11,14,1,9,21,42.9,12,14,2,12,10,36,9,0
542,Romulo,br BRA,"DF,MF",UANL,,25.17808219,2000,6.4,15,10,7,7,1,8,8,100,0,6,2,4,9,24,17,0
543,Salomón Rondón,ve VEN,FW,Pachuca,,35.63287671,1989,26.6,9,6,2,6,1,2,11,18.2,9,21,2,19,6,15,22,0
544,Bryan Roque,mx MEX,"MF,FW",Necaxa,,20.5369863,2004,0.1,0,0,0,0,0,0,0,,0,0,0,0,0,0,0,0
545,Kevin Rosero,co COL,"DF,MF",Necaxa,,26.41917808,1998,16.7,47,38,21,20,6,27,41,65.9,14,21,4,17,10,57,31,0
546,Franco Rossano,mx MEX,DF,América,,19.77260274,2005,2.3,1,1,0,1,0,1,2,50,1,1,0,1,4,5,3,0
547,Carlos Rotondi,ar ARG,"DF,FW",Cruz Azul,,28.14794521,1997,27.9,87,62,40,32,15,46,78,59,32,31,2,29,24,111,48,0
548,Fernando Rubén González,mx MEX,MF,Guadalajara,,31.26849315,1994,22.8,70,45,36,33,1,31,46,67.4,15,31,12,19,28,98,34,0
549,Rubio Rubin,gt GUA,"FW,MF",Querétaro,,29.17808219,1996,4.7,0,0,0,0,0,0,2,0,2,1,0,1,2,2,3,0
550,Brian Rubio,mx MEX,FW,Querétaro,,28.48493151,1996,3.3,2,2,1,1,0,0,1,0,1,6,1,5,1,3,7,0
551,Brian Rubio,mx MEX,FW,Mazatlán,,28.48493151,1996,9.6,6,4,1,3,2,3,11,27.3,8,4,0,4,1,7,5,0
552,Ronaldo Rubio,mx MEX,MF,Santos,,21.26575342,2004,0.2,0,0,0,0,0,0,0,,0,1,0,1,0,0,0,0
553,Marcel Ruiz,mx MEX,MF,Toluca,,24.52328767,2000,30.5,112,65,54,48,10,40,74,54.1,34,44,9,35,33,145,52,0
554,Franco Russo,ar ARG,DF,Querétaro,,30.5260274,1994,26.5,60,32,43,14,3,35,54,64.8,19,45,35,10,50,110,178,4
555,Jorge Ruvalcaba,mx MEX,"MF,FW",UNAM,,23.78356164,2001,16,28,20,9,15,4,15,28,53.6,13,18,2,16,5,33,2,0
556,Ángel Saavedra,mx MEX,"FW,DF",Mazatlán,,21.89315068,2003,0.4,0,0,0,0,0,0,0,,0,1,0,1,0,0,1,0
557,Javier Salas,mx MEX,"MF,FW",FC Juárez,,31.70684932,1993,0,0,0,0,0,0,0,0,,0,0,0,0,0,0,0,0
558,Patricio Salas,mx MEX,FW,América,,21.2109589,2004,1.8,3,2,1,2,0,1,1,100,0,0,0,0,0,3,1,0
559,Carlos Salcedo,mx MEX,DF,FC Juárez,,31.59726027,1993,12.4,10,7,6,2,2,4,7,57.1,3,18,14,4,17,27,52,0
560,Sebastien Salles-Lamonge,fr FRA,"MF,FW",Atlético,,29.26575342,1996,28.7,19,8,5,9,5,8,29,27.6,21,28,3,25,32,51,8,0
561,Juan Sanabria,uy URU,"DF,MF",Atlético,,25.10136986,2000,32.1,69,44,29,33,7,39,57,68.4,18,49,2,47,31,100,77,0
562,Andrés Sánchez,mx MEX,GK,Atlético,,27.58630137,1997,29.2,2,2,2,0,0,2,8,25,6,0,0,0,0,2,30,1
563,Carlos Sánchez,mx MEX,DF,Pachuca,,23.06027397,2002,12.3,34,24,18,15,1,25,38,65.8,13,8,1,7,25,59,30,0
564,Diego Sánchez,mx MEX,FW,UANL,,20.0630137,2005,2.5,7,7,4,1,2,2,2,100,0,0,0,0,1,8,2,0
565,Erick Sánchez,mx MEX,"MF,FW",América,,25.60273973,1999,23.1,33,14,16,13,4,10,31,32.3,21,27,7,20,16,49,28,0
566,Jesús Sánchez García,mx MEX,DF,Guadalajara,,35.67671233,1989,0.2,1,1,0,1,0,0,0,,0,0,0,0,0,1,0,0
567,Luis Sánchez,mx MEX,DF,Mazatlán,,25.00547945,2000,20.6,17,9,13,4,0,6,14,42.9,8,24,13,11,20,37,79,0
568,Richard Sánchez,py PAR,MF,América,,29.10136986,1996,9,25,14,10,12,3,14,22,63.6,8,8,1,7,4,29,8,1
569,Raúl Sandoval,mx MEX,"DF,MF",Necaxa,,25.29315068,2000,3.7,7,4,6,1,0,4,6,66.7,2,6,2,4,4,11,14,0
570,Anderson Santamaría,pe PER,DF,Santos,,33.31506849,1992,20.1,58,40,40,18,0,32,41,78,9,43,26,17,24,82,104,2
571,José Santiago Hernández,mx MEX,GK,Atlas,,28.0109589,1997,3,0,0,0,0,0,0,0,,0,0,0,0,0,0,0,1
572,Emilio Santillán,mx MEX,DF,Santos,,21.65479452,2003,0.8,0,0,0,0,0,0,2,0,2,2,2,0,3,3,4,0
573,Samir Santos,br BRA,DF,Mazatlán,,30.41369863,1994,5.7,9,7,8,1,0,3,4,75,1,10,7,3,10,19,33,0
574,Sebastian Santos,mx MEX,DF,León,,22.28493151,2003,17.3,67,44,38,27,2,35,59,59.3,24,22,5,17,26,93,39,1
575,Francisco Sebastián Córdova,mx MEX,"FW,MF",UANL,,27.89589041,1997,15.9,29,15,10,15,4,12,26,46.2,14,13,0,13,7,36,6,0
576,Ángel Sepúlveda,mx MEX,FW,Cruz Azul,,34.21643836,1991,16.9,4,3,0,2,2,3,6,50,3,11,2,9,2,6,14,0
577,Gilberto Sepúlveda,mx MEX,DF,Guadalajara,,26.24657534,1999,24.8,32,23,19,13,0,16,21,76.2,5,22,18,4,28,60,85,2
578,Leonardo Sepulveda,us USA,"FW,DF",Guadalajara,,23.87945205,2001,0.2,0,0,0,0,0,0,0,,0,0,0,0,2,2,3,0
579,Jesús Serrato,mx MEX,MF,Atlas,,19.36986301,2005,4,7,4,2,3,2,3,12,25,9,6,1,5,3,10,0,0
580,Yehoshua Shtrimling,il ISR,DF,América,,22.12876712,2003,1,3,2,1,2,0,1,1,100,0,0,0,0,0,3,3,0
581,Jordan Sierra,ec ECU,MF,Mazatlán,,28.03287671,1997,22.3,13,23,7,6,0,5,15,33.3,10,8,0,8,21,34,11,1
582,Juan Sigala,mx MEX,FW,Pachuca,,18.07945205,2007,3.5,10,6,3,6,1,4,13,30.8,9,1,0,1,1,11,1,0
583,Nathan Silva,br BRA,DF,UNAM,,27.99726027,1997,26.7,48,36,32,14,2,24,32,75,8,30,19,11,30,78,120,1
584,Carlo Soldati,mx MEX,DF,Querétaro,,19.83013699,2005,0.1,0,0,0,0,0,0,0,,0,0,0,0,0,0,2,0
585,Ramiro Sordo,ar ARG,"FW,MF",Santos,,24.84931507,2000,23.1,36,27,17,16,3,19,41,46.3,22,13,0,13,8,44,21,0
586,Samuel Sosa,ve VEN,FW,Querétaro,,25.38082192,1999,7.1,3,1,0,0,3,2,4,50,2,0,0,0,1,4,3,0
587,Leonardo Suárez,ar ARG,"FW,MF",UNAM,,29.09863014,1996,7.8,5,2,1,4,0,2,14,14.3,12,6,0,6,2,7,1,0
588,Alessandro Tagle,mx MEX,DF,Monterrey,,19.84931507,2005,0.7,0,0,0,0,0,0,2,0,2,1,1,0,1,1,1,0
589,Fernando Tapia,mx MEX,GK,UANL,,23.88219178,2001,3,1,1,1,0,0,1,1,100,0,0,0,0,0,1,3,0
590,Miguel Tapias,mx MEX,DF,Guadalajara,,28.31780822,1997,8.9,14,9,10,4,0,8,11,72.7,3,15,9,6,11,25,59,0
591,Juan Tejeda,mx MEX,DF,Santos,,21.14246575,2004,0,0,0,0,0,0,0,0,,0,0,0,0,0,0,0,0
592,Eduardo Tercero,mx MEX,DF,UANL,,28.99726027,1996,0.4,2,0,2,0,0,1,1,100,0,0,0,0,0,2,2,0
593,Iván Tona,mx MEX,MF,Tijuana,,25.09315068,2000,21,28,16,18,7,3,14,31,45.2,17,16,2,14,17,45,21,0
594,Alan Torres,mx MEX,MF,Mazatlán,,25.20547945,2000,12.4,14,5,8,5,1,3,21,14.3,18,9,4,5,7,21,13,0
595,Dylan Torres,mx MEX,MF,Puebla,,21.24931507,2004,0.1,0,0,0,0,0,0,1,0,1,0,0,0,0,0,0,0
596,Jairo Torres,mx MEX,"MF,FW",FC Juárez,,24.83287671,2000,28.3,30,18,9,19,2,10,30,33.3,20,11,0,11,22,52,23,0
597,Óliver Torres,es ESP,"MF,FW",Monterrey,,30.48219178,1994,20.1,32,19,7,19,6,17,30,56.7,13,36,2,34,25,57,11,0
598,Román Torres,mx MEX,"DF,MF",Atlético,,20.36712329,2004,11.7,19,13,12,5,2,13,19,68.4,6,17,5,12,7,26,25,0
599,Román Torres,mx MEX,"DF,FW",Necaxa,,20.36712329,2004,0.1,0,0,0,0,0,0,0,,0,0,0,0,1,1,1,0
600,Santiago Trigos,mx MEX,MF,UNAM,,23.28219178,2002,8.5,25,15,6,16,3,15,27,55.6,12,11,1,10,5,30,16,0
601,Ezequiel Unsain,ar ARG,GK,Necaxa,,30.15616438,1995,34,0,0,0,0,0,0,1,0,1,0,0,0,1,1,13,2
602,Héctor Uribe,mx MEX,FW,León,,20.91780822,2004,0.5,2,2,0,1,1,1,2,50,1,0,0,0,0,2,0,0
603,Diego Valdés,cl CHI,"MF,FW",América,,31.26027397,1994,10.4,9,6,1,4,4,3,6,50,3,3,0,3,2,11,2,0
604,Christian Valdivia,mx MEX,DF,Cruz Azul,,19.62191781,2005,0.2,1,0,1,0,0,0,2,0,2,0,0,0,1,2,0,0
605,Aldieri Valenzuela,mx MEX,"FW,MF",Tijuana,,22.19178082,2003,0.4,0,0,0,0,0,0,0,,0,0,0,0,0,0,1,0
606,Francisco Valenzuela,mx MEX,MF,Monterrey,,18.06027397,2007,0.5,2,1,1,0,1,1,1,100,0,0,0,0,0,2,1,0
607,Diego Valoyes,co COL,"FW,MF",FC Juárez,,28.61643836,1996,7,14,9,6,1,7,7,11,63.6,4,8,1,7,1,15,3,0
608,Camilo Vargas,co COL,GK,Atlas,,36.15616438,1989,31,1,1,1,0,0,0,2,0,2,0,0,0,1,2,24,1
609,William Vargas,ec ECU,DF,Mazatlán,,27.89589041,1997,1.8,0,0,0,0,0,0,0,,0,5,1,4,2,2,7,0
610,Brandon Vazquez,us USA,"FW,MF",Monterrey,,26.55616438,1998,6.2,2,1,0,2,0,0,5,0,5,1,0,1,3,5,4,0
611,Brayton Vázquez,mx MEX,DF,Querétaro,,27,1998,3.3,2,1,2,0,0,1,3,33.3,2,1,1,0,6,8,15,0
612,Miguel Vázquez,mx MEX,DF,América,,21.23835616,2004,9.8,6,4,5,1,0,4,6,66.7,2,8,2,6,13,19,34,0
613,Alexis Vega,mx MEX,"FW,MF",Toluca,,27.44109589,1997,27.9,53,39,17,24,12,22,44,50,22,14,0,14,21,74,7,0
614,Jesús Vega,mx MEX,"FW,DF",Tijuana,,25.13150685,2000,7.7,17,14,12,5,0,12,19,63.2,7,4,0,4,8,25,20,0
615,Sebastián Vegas,cl CHI,DF,Monterrey,,28.41643836,1996,7,15,13,8,5,2,10,15,66.7,5,3,1,2,15,30,23,0
616,Christo Vela,mx MEX,"MF,FW",América,,20.76438356,2004,0.9,0,0,0,0,0,0,0,,0,0,0,0,0,0,1,0
617,Kevin Velasco,co COL,"MF,DF",Puebla,,28.01369863,1997,3.7,8,8,6,2,0,6,9,66.7,3,8,1,7,2,10,2,0
618,Jesús Venegas,mx MEX,"MF,FW",FC Juárez,,30.09863014,1995,4.2,5,3,2,2,1,2,6,33.3,4,4,1,3,5,10,3,0
619,Sebastián Venegas,mx MEX,MF,UNAM,,20.24383562,2005,0.5,2,2,1,0,1,2,2,100,0,0,0,0,0,2,1,0
620,Patrick Villa,mx MEX,DF,América,,21.39726027,2003,0.1,0,0,0,0,0,0,0,,0,0,0,0,0,0,0,0
621,Jonatan Villal,us USA,"FW,MF",Atlético,,20.3260274,2005,0.6,2,1,0,1,1,0,0,,0,1,0,1,0,2,0,0
622,Fran Villalba,es ESP,"MF,FW",Santos,,26.98356164,1998,14.3,7,6,1,5,1,1,17,5.9,16,13,2,11,9,16,12,0
623,Dieter Villalpando,mx MEX,"MF,FW",FC Juárez,,33.75068493,1991,21.6,27,20,8,15,4,8,25,32,17,25,1,24,8,35,7,2
624,Isaías Violante,mx MEX,"FW,MF",Toluca,,21.53972603,2003,13.5,13,9,6,5,2,10,21,47.6,11,11,2,9,8,21,10,0
625,Vitinho,br BRA,"FW,MF",Atlético,,24.03287671,2001,18.8,11,7,1,3,7,4,13,30.8,9,16,0,16,6,17,3,1
626,Tiago Volpi,br BRA,GK,Toluca,,34.37534247,1990,19,0,0,0,0,0,0,0,,0,0,0,0,0,0,9,1
627,Facundo Waller,uy URU,MF,Puebla,,28.07123288,1997,17.5,55,34,22,21,12,32,57,56.1,25,32,6,26,19,74,27,0
628,Teun Wilke,mx MEX,FW,Guadalajara,,23.14246575,2002,6,6,2,0,4,2,1,3,33.3,2,6,1,5,0,6,4,0
629,Édgar Yoel Bárcenas,pa PAN,"MF,FW",Mazatlán,,31.53150685,1993,22.3,44,24,14,24,6,18,36,50,18,23,3,20,17,61,23,0
630,Ángel Zaldívar,mx MEX,FW,FC Juárez,,31.23561644,1994,12.7,6,5,1,3,2,2,4,50,2,6,1,5,1,7,6,0
631,Edgar Zaldívar,mx MEX,DF,Atlas,,28.54794521,1996,11.1,27,17,15,11,1,11,20,55,9,6,4,2,15,42,23,0
632,Saúl Zamora,mx MEX,DF,Guadalajara,,22.10958904,2003,0.1,0,0,0,0,0,0,0,,0,0,0,0,0,0,0,0
633,Ángel Zapata,mx MEX,"MF,FW",Querétaro,,24.24931507,2001,0,0,0,0,0,0,0,0,,0,0,0,0,0,0,0,0
634,Alejandro Zendejas,us USA,"FW,MF",América,,27.23835616,1998,21.8,36,25,10,19,7,12,31,38.7,19,26,1,25,9,45,7,0
635,José Zúñiga,co COL,"FW,MF",Tijuana,,30.8109589,1994,23.4,15,10,3,7,5,6,13,46.2,7,9,2,7,7,22,12,0
636,Uroš Đurđević,me MNE,FW,Atlas,,31.17534247,1994,18.5,6,2,1,2,3,3,9,33.3,6,8,1,7,1,7,9,0
1,Rodrigo Abascal,uy URU,DF,Boavista,,31.30410959,1994,25.9,51,30,37,13,1,28,52,53.8,24,38,24,14,37,88,129,2
2,Nelson Abbey,eng ENG,DF,Rio Ave,,21.68493151,2003,7.1,12,7,7,2,3,7,8,87.5,1,10,4,6,5,17,46,1
3,Bilal Abdelrahman Zeeni,eg EGY,MF,Estrela,,22.28493151,2003,0.1,1,1,0,0,1,0,0,,0,0,0,0,0,1,1,0
4,Giorgi Aburjania,ge GEO,MF,AVS Futebol,,30.3369863,1995,3.4,11,6,3,6,2,7,13,53.8,6,3,0,3,3,14,5,0
5,Adriano,br BRA,MF,Santa Clara,,25.49863014,1999,27.2,36,18,12,21,3,18,34,52.9,16,23,6,17,16,52,42,1
6,Lucas Áfrico,br BRA,DF,Farense,,30.24383562,1995,18.5,25,15,13,11,1,14,20,70,6,17,13,4,12,37,94,0
7,Salvador Agra,pt POR,"MF,DF",Boavista,,33.47945205,1991,27.7,30,20,13,9,8,13,31,41.9,18,9,1,8,14,44,18,3
8,Brandon Aguilera,cr CRC,"MF,FW",Rio Ave,,21.85205479,2003,15.3,35,22,17,12,6,13,35,37.1,22,10,0,10,12,47,6,0
9,Jorge Aguirre,es ESP,FW,Gil Vicente FC,,25.32876712,2000,14.6,3,2,0,1,2,2,13,15.4,11,7,1,6,3,6,9,0
10,Babatunde Akinsola,ng NGA,"MF,FW",AVS Futebol,,22.15342466,2003,10.3,14,12,6,8,0,9,15,60,6,16,2,14,6,20,16,0
11,Kerem Aktürkoğlu,tr TUR,"FW,MF",Benfica,,26.5369863,1998,20.7,21,16,9,7,5,5,24,20.8,19,19,0,19,17,38,8,0
12,Léo Alaba,br BRA,DF,AVS Futebol,,25.84383562,1999,3.7,8,5,4,3,1,3,9,33.3,6,5,1,4,7,15,10,0
13,Alan,br BRA,MF,Moreirense,,25.15890411,2000,25.9,25,9,6,12,7,8,25,32,17,13,1,12,6,31,6,0
14,Gonçalo Almeida,pt POR,"DF,MF",Boavista,,21.99726027,2003,9,14,11,4,8,2,7,20,35,13,10,1,9,6,20,13,0
15,Pedro Álvaro,pt POR,DF,Estoril,,25.17534247,2000,28.6,23,14,14,9,0,9,20,45,11,25,15,10,45,68,177,3
16,Pedro Amaral,pt POR,"DF,MF",Estoril,,27.69315068,1997,24.8,28,19,13,7,8,22,39,56.4,17,19,2,17,22,50,68,0
17,Zeki Amdouni,ch SUI,"MF,FW",Benfica,,24.41643836,2000,9.5,15,11,3,9,3,10,17,58.8,7,15,0,15,3,18,4,0
18,Artur Jorge Marques Amorim,pt POR,DF,Farense,,30.72328767,1994,14.2,13,7,12,1,0,9,12,75,3,12,6,6,17,30,90,1
19,Andrew,br BRA,GK,Gil Vicente FC,,23.84383562,2001,32,2,2,2,0,0,1,2,50,1,0,0,0,0,2,11,3
20,Jeremy Antonisse,cw CUW,"FW,MF",Moreirense,,23.10136986,2002,9,20,7,10,8,2,11,25,44,14,10,0,10,3,23,19,0
21,Arvin Appiah,eng ENG,"DF,FW",Nacional,,24.32876712,2001,14.4,20,15,10,8,2,14,21,66.7,7,7,0,7,15,35,27,0
22,Óscar Aranda,es ESP,FW,Famalicão,,23.01643836,2002,27.2,26,19,6,16,4,15,32,46.9,17,10,0,10,8,34,21,0
23,Henrique Araújo,pt POR,FW,Arouca,,23.29041096,2002,10.6,5,4,0,3,2,2,7,28.6,5,4,1,3,2,7,8,1
24,Maximiliano Araújo,uy URU,"DF,MF",Sporting CP,,25.21643836,2000,17.8,44,30,20,15,9,19,32,59.4,13,24,1,23,15,59,38,0
25,Tomás Araújo,pt POR,DF,Benfica,,22.96986301,2002,24.1,62,40,40,16,6,34,47,72.3,13,19,10,9,26,88,47,1
26,Telmo Arcanjo,cv CPV,FW,Vitória,,23.87123288,2001,13.7,17,12,6,8,3,6,14,42.9,8,7,2,5,7,24,7,0
27,Gboly Ariyibi,us USA,"FW,MF",Boavista,,30.29315068,1995,3.1,0,0,0,0,0,0,1,0,1,3,1,2,0,0,0,0
28,Henrique Arreiol,pt POR,MF,Sporting CP,,19.87123288,2005,0.3,0,0,0,0,0,0,0,,0,2,1,1,1,1,0,0
29,Bright Arrey-Mbi,de GER,DF,Braga,,22.10958904,2003,12.6,20,11,13,4,3,11,17,64.7,6,11,6,5,8,28,37,1
30,Afonso Assis,pt POR,MF,Moreirense,,18.80547945,2006,0.2,0,0,0,0,0,0,0,,0,0,0,0,0,0,0,0
31,Gustavo Assuncao,pt POR,MF,AVS Futebol,,25.09863014,2000,15.2,33,22,17,16,0,20,43,46.5,23,18,6,12,8,41,24,1
32,Otavio Ataide,br BRA,DF,Porto,,23.03835616,2002,18.1,25,15,16,9,0,19,30,63.3,11,18,9,9,23,48,54,3
33,João Aurélio,pt POR,"FW,DF",Nacional,,36.71506849,1988,2.8,12,6,5,6,1,8,10,80,2,9,3,6,2,14,5,0
34,Fredrik Aursnes,no NOR,"MF,FW",Benfica,,29.4,1995,25.1,45,25,10,23,12,25,53,47.2,28,20,5,15,11,56,20,1
35,Felix Bacher,at AUT,DF,Estoril,,24.5260274,2000,21,42,31,27,12,3,23,35,65.7,12,28,7,21,32,74,141,2
36,Miguel Baeza,es ESP,"MF,FW",Nacional,,25.10684932,2000,2.3,2,2,1,1,0,1,2,50,1,1,0,1,0,2,1,0
37,Alexander Bah,dk DEN,DF,Benfica,,27.40273973,1997,15.7,49,34,19,21,9,33,49,67.3,16,19,1,18,20,69,18,0
38,Adrian Bajrami,al ALB,DF,Benfica,,23.08219178,2002,0.1,0,0,0,0,0,0,0,,0,0,0,0,0,0,0,0
39,Theofanis Bakoulas,gr GRE,MF,Rio Ave,,20.33150685,2005,2.3,3,2,2,1,0,1,4,25,3,2,0,2,4,7,5,0
40,Elves Baldé,gw GNB,"MF,FW",Farense,,25.5890411,1999,11.6,14,8,4,8,2,7,16,43.8,9,10,0,10,6,20,10,0
41,Mohamed Bamba,ci CIV,MF,Gil Vicente FC,,20.57260274,2004,8.6,15,10,8,6,1,9,19,47.4,10,8,4,4,13,28,29,2
42,Robson Bambu,br BRA,DF,Braga,,27.47671233,1997,11.2,15,5,10,5,0,9,11,81.8,2,12,8,4,6,21,59,3
43,Chico Banza,ao ANG,FW,Estrela,,26.38082192,1998,6.3,7,5,0,5,2,2,8,25,6,10,1,9,1,8,8,1
44,Simon Banza,cd COD,FW,Braga,,28.7260274,1996,0.2,0,0,0,0,0,0,0,,0,0,0,0,0,0,0,0
45,Rafael Barbosa,pt POR,"MF,FW",Farense,,29.10136986,1996,4,1,1,0,1,0,0,2,0,2,4,0,4,2,3,1,0
46,Leandro Barreiro Martins,lu LUX,MF,Benfica,,25.33424658,2000,12.5,30,16,4,18,8,14,26,53.8,12,14,2,12,8,38,10,0
47,Afonso Bastardo,pt POR,FW,Sporting CP,,20.12876712,2005,0,1,1,0,1,0,1,1,100,0,1,0,1,0,1,0,0
48,Gil Bastião Dias,pt POR,"FW,MF",Famalicão,,28.6,1996,14.5,30,19,13,11,6,10,34,29.4,24,23,5,18,11,41,22,0
49,Gabriel Batista,br BRA,GK,Santa Clara,,26.92054795,1998,32,3,1,3,0,0,2,2,100,0,0,0,0,0,3,20,0
50,Gilberto Batista,gw GNB,DF,Moreirense,,21.34794521,2003,3.2,4,3,4,0,0,3,4,75,1,2,2,0,3,7,17,0
51,Ricardo Batista,pt POR,GK,Casa Pia,,38.45753425,1986,1,0,0,0,0,0,0,0,,0,0,0,0,0,0,2,0
52,Yanis Begraoui,ma MAR,"FW,MF",Estoril,,23.83561644,2001,19.5,16,9,2,9,5,5,9,55.6,4,16,3,13,6,22,15,0
53,Gui Beleza,pt POR,MF,Gil Vicente FC,,18.40273973,2006,0,0,0,0,0,0,0,0,,0,0,0,0,0,0,0,0
54,Bachir Belloumi,dz ALG,FW,Farense,,22.9260274,2002,3,7,4,2,4,1,3,6,50,3,9,2,7,3,10,2,0
55,Andrea Belotti,it ITA,FW,Benfica,,31.37260274,1993,4.5,7,4,1,3,3,2,5,40,3,3,0,3,1,8,4,0
56,Fahem Benaissa Yahia,fr FRA,"DF,MF",Casa Pia,,23.01643836,2002,2.5,4,2,1,2,1,2,2,100,0,5,1,4,9,13,6,0
57,Beni,ao ANG,MF,Vitória,,22.95616438,2002,0.5,3,2,3,0,0,2,2,100,0,0,0,0,0,3,0,0
58,Beni,ao ANG,MF,Casa Pia,,22.95616438,2002,8.3,18,13,9,9,0,10,16,62.5,6,7,2,5,11,29,18,1
59,Álex Bermejo,es ESP,"MF,FW",Farense,,26.39726027,1998,6.3,9,5,2,5,2,5,20,25,15,5,2,3,2,11,7,0
60,Sergio Bermejo,es ESP,"MF,FW",Gil Vicente FC,,27.71506849,1997,4.5,10,5,7,1,2,5,6,83.3,1,3,0,3,3,13,3,0
61,Simão Bertelli,br BRA,GK,AVS Futebol,,31.92328767,1993,11,0,0,0,0,0,0,0,,0,0,0,0,0,0,3,2
62,Jan-Niklas Beste,de GER,"FW,DF",Benfica,,26.33150685,1999,5.6,19,15,5,10,4,9,14,64.3,5,4,0,4,4,23,4,0
63,José Bica,pt POR,"FW,MF",Vitória,,21.88493151,2003,0.3,0,0,0,0,0,0,0,,0,0,0,0,0,0,0,0
64,Biel,br BRA,"MF,FW",Sporting CP,,24.09315068,2001,0.2,0,0,0,0,0,0,0,,0,0,0,0,1,1,0,0
65,Raúl Blanco,es ESP,FW,Casa Pia,,23.76164384,2001,2.8,3,2,0,1,2,2,5,40,3,2,1,1,2,5,1,0
66,Paulinho Bóia,br BRA,"FW,MF",Nacional,,26.85753425,1998,10,9,5,3,4,2,6,15,40,9,11,0,11,7,16,6,0
67,Kévin Boma,tg TOG,DF,Estoril,,22.45479452,2002,25.4,45,32,29,14,2,25,34,73.5,9,17,10,7,40,85,116,1
68,Pedro Bondo,ao ANG,"DF,MF",Famalicão,,20.46575342,2004,1.4,3,0,3,0,0,2,2,100,0,0,0,0,0,3,4,0
69,Kiko Bondoso,pt POR,"FW,MF",Rio Ave,,29.4630137,1995,20.8,34,23,19,10,5,17,32,53.1,15,13,0,13,10,44,8,0
70,Toni Borevkovic,hr CRO,DF,Vitória,,27.87945205,1997,24.9,27,16,19,8,0,14,18,77.8,4,25,18,7,30,57,140,3
71,Daniel Borges,br BRA,"MF,FW",Santa Clara,,22.07945205,2003,2,9,4,1,3,5,5,9,55.6,4,2,2,0,5,14,4,0
72,Gonçalo Borges,pt POR,"FW,MF",Porto,,24.10136986,2001,7.8,10,5,0,5,5,4,8,50,4,6,0,6,2,12,0,0
73,Róbert Boženík,sk SVK,FW,Boavista,,25.46027397,1999,27.6,12,7,3,3,6,4,12,33.3,8,17,2,15,6,18,34,0
74,Daniel Bragança,pt POR,MF,Sporting CP,,25.93972603,1999,12,26,15,5,12,9,14,22,63.6,8,14,1,13,4,30,7,1
75,Bruno Brigido,br BRA,GK,Estrela,,34.15616438,1991,17.5,0,0,0,0,0,0,0,,0,0,0,0,0,0,12,2
76,Alexandre Brito,pt POR,"MF,DF",Sporting CP,,19.79452055,2005,1,5,3,3,2,0,1,1,100,0,2,1,1,1,6,0,0
77,Rafael Brito,pt POR,MF,Casa Pia,,23.29041096,2002,11.1,23,14,10,11,2,12,22,54.5,10,16,3,13,19,42,18,1
78,Tiago Brito,pt POR,MF,Estoril,,21.05205479,2004,0.8,4,1,1,3,0,4,4,100,0,1,0,1,0,4,0,0
79,Bruma,pt POR,"FW,MF",Braga,,30.52876712,1994,13.4,9,5,1,5,3,8,15,53.3,7,3,0,3,3,12,2,0
80,Bruma,pt POR,"FW,MF",Benfica,,30.52876712,1994,5,6,5,2,2,2,1,4,25,3,1,0,1,0,6,0,0
81,Jonathan Buatu Mananga,ao ANG,DF,Gil Vicente FC,,31.60273973,1993,18.3,22,15,12,10,0,15,18,83.3,3,26,16,10,16,38,93,1
82,Leonel Bucca,ar ARG,"MF,FW",Estrela,,26.1260274,1999,12.8,28,15,12,14,2,14,27,51.9,13,17,6,11,13,41,14,1
83,Leonardo Buta,pt POR,DF,Moreirense,,22.91506849,2002,4.6,7,3,4,2,1,6,9,66.7,3,1,0,1,3,10,23,1
84,Adrián Butzke,es ESP,FW,Nacional,,26.09863014,1999,5.4,4,2,0,4,0,2,4,50,2,2,0,2,3,7,6,0
85,Arthur Cabral,br BRA,FW,Benfica,,27.02739726,1998,4.1,3,2,0,1,2,1,1,100,0,3,0,3,0,3,3,0
86,Daniel Cabral,br BRA,MF,Estrela,,22.97534247,2002,0,0,0,0,0,0,0,1,0,1,0,0,0,0,0,1,0
87,Jovane Cabral,cv CPV,"FW,MF",Estrela,,26.89041096,1998,10.2,29,17,15,10,4,15,29,51.7,14,18,3,15,8,37,5,0
88,Lucas Calegari,br BRA,DF,Famalicão,,23.18356164,2002,16.5,36,20,20,14,2,15,25,60,10,14,5,9,11,47,33,0
89,Diogo Calila,pt POR,"MF,DF",Santa Clara,,26.56712329,1998,19.1,43,22,23,16,4,27,45,60,18,23,5,18,12,55,62,0
90,Ibrahima Camará,gn GUI,MF,Boavista,,26.2739726,1999,14.8,16,10,5,10,1,10,19,52.6,9,17,5,12,19,35,44,0
91,André Candeias,pt POR,"FW,MF",Farense,,22.28767123,2003,0.4,0,0,0,0,0,0,0,,0,0,0,0,0,0,0,0
92,Lazar Carević,me MNE,GK,Famalicão,,26.1369863,1999,18,0,0,0,0,0,0,0,,0,0,0,0,0,0,10,2
93,Zé Carlos,pt POR,"MF,DF",Vitória,,23.51232877,2001,1.4,6,4,3,3,0,2,4,50,2,1,0,1,3,9,4,0
94,Zé Carlos,pt POR,MF,Farense,,23.51232877,2001,7.4,25,15,8,15,2,12,20,60,8,10,1,9,9,34,13,0
95,Zé Carlos,pt POR,DF,Gil Vicente FC,,26.76164384,1998,28.1,53,41,26,21,6,37,61,60.7,24,29,11,18,43,96,110,3
96,Álvaro Carreras,es ESP,DF,Benfica,,22.11780822,2003,28.6,55,36,26,23,6,33,51,64.7,18,24,8,16,40,95,70,3
97,João Carvalho,pt POR,"MF,FW",Estoril,,28.15616438,1997,24,32,19,9,10,13,22,49,44.9,27,18,3,15,8,40,11,1
98,Pedro Carvalho,pt POR,"DF,MF",Estoril,,22.21917808,2003,7.1,19,13,14,5,0,10,16,62.5,6,5,2,3,9,28,22,0
99,Vitor Carvalho,br BRA,MF,Braga,,27.93972603,1997,16.5,33,20,10,20,3,18,31,58.1,13,13,3,10,22,55,28,0
100,Facundo Cáseres,ar ARG,MF,Gil Vicente FC,,23.9369863,2001,13.8,34,22,19,12,3,15,23,65.2,8,31,11,20,14,48,34,0
101,Cassiano,br BRA,FW,Casa Pia,,35.88493151,1989,20,20,12,7,8,5,5,15,33.3,10,17,2,15,3,23,11,0
102,Jesús Castillo,pe PER,MF,Gil Vicente FC,,23.89863014,2001,9.1,14,6,3,10,1,11,20,55,9,13,4,9,10,24,17,1
103,André Castro,pt POR,MF,Moreirense,,37.09041096,1988,0.2,0,0,0,0,0,0,0,,0,0,0,0,0,0,0,0
104,Cristian Castro,co COL,DF,AVS Futebol,,24.2739726,2001,27.6,31,26,22,6,3,19,26,73.1,7,21,12,9,30,61,171,3
105,Geny Catamo,mz MOZ,"MF,DF",Sporting CP,,24.27123288,2001,19.3,25,12,7,9,9,18,28,64.3,10,17,0,17,8,33,14,1
106,Cauê,br BRA,FW,Gil Vicente FC,,22.46575342,2002,7.4,6,2,1,4,1,1,4,25,3,9,2,7,2,8,15,0
107,Cauê,br BRA,"FW,MF",Casa Pia,,22.46575342,2002,3.9,0,0,0,0,0,0,2,0,2,1,0,1,2,2,2,0
108,César,br BRA,GK,Boavista,,33.26849315,1992,16,2,2,2,0,0,1,4,25,3,0,0,0,0,2,4,4
109,Tidjany Chabrol,fr FRA,"FW,MF",Gil Vicente FC,,22.80547945,2002,11.6,20,16,10,7,3,12,25,48,13,14,1,13,5,25,11,0
110,Kevin Chamorro,cr CRC,GK,Estoril,,25.0739726,2000,3,0,0,0,0,0,0,0,,0,0,0,0,0,0,3,2
111,Francisco Chissumba,pt POR,DF,Braga,,19.93424658,2005,14,23,16,12,10,1,16,34,47.1,18,11,1,10,13,36,53,0
112,Till Cissokho,fr FRA,DF,Estrela,,25.23561644,2000,4,1,0,1,0,0,0,1,0,1,0,0,0,2,3,12,1
113,Clayton,br BRA,DF,AVS Futebol,,25.08493151,2000,2,0,0,0,0,0,0,3,0,3,5,1,4,1,1,7,0
114,Clayton,br BRA,FW,Rio Ave,,26.31232877,1999,27.1,15,7,2,6,7,6,16,37.5,10,14,5,9,4,19,26,0
115,Diego Collado,es ESP,"MF,FW",Gil Vicente FC,,24.31780822,2001,0.3,1,1,1,0,0,0,0,,0,0,0,0,1,2,0,0
116,Semeu Commey,gh GHA,DF,Estrela,,20.98082192,2004,0.5,1,1,1,0,0,0,0,,0,0,0,0,0,1,10,0
117,Fábio Conceição,pt POR,"FW,MF",Estrela,,24.01917808,2001,6.8,13,8,5,4,4,5,11,45.5,6,6,3,3,7,20,1,0
118,Fábio Conceição,pt POR,"FW,DF",Rio Ave,,24.01917808,2001,4.7,9,7,4,3,2,3,10,30,7,4,1,3,4,13,4,1
119,Leo Cordeiro,br BRA,MF,Estrela,,29.60273973,1995,19.3,26,17,10,15,1,14,27,51.9,13,29,4,25,15,41,7,4
120,Félix Correia,pt POR,"FW,MF",Gil Vicente FC,,24.28219178,2001,30.1,32,21,17,13,2,16,31,51.6,15,22,1,21,36,68,37,1
121,Alberto costa,pt POR,DF,Vitória,,21.59726027,2003,7.5,24,16,11,7,6,16,21,76.2,5,17,2,15,9,33,26,0
122,Bruno Xavier Almeida Costa,pt POR,"MF,FW",Nacional,,28.04383562,1997,10.3,9,5,6,3,0,6,11,54.5,5,6,1,5,6,15,7,1
123,Diogo Costa,pt POR,GK,Porto,,25.62465753,1999,30,0,0,0,0,0,0,1,0,1,0,0,0,0,0,12,0
124,Gonçalo Costa,pt POR,"DF,MF",Estoril,,25.20821918,2000,4.4,12,5,5,7,0,7,12,58.3,5,4,2,2,6,18,19,0
125,Hélder Costa,ao ANG,"FW,MF",Estoril,,31.30958904,1994,6.7,7,4,2,1,4,5,11,45.5,6,4,0,4,0,7,8,0
126,João Costa,pt POR,FW,Santa Clara,,25.16164384,2000,8,14,9,5,7,2,5,10,50,5,10,1,9,5,19,7,0
127,João Paulo Santos Costa,pt POR,GK,Estrela,,29.25205479,1996,11,1,0,1,0,0,1,1,100,0,0,0,0,0,1,7,0
128,Michel Costa,br BRA,MF,Estoril,,23.37260274,2001,6.6,8,3,2,5,1,1,9,11.1,8,12,3,9,7,15,9,0
129,Rui Costa,pt POR,"FW,MF",Farense,,29.20273973,1996,5.9,5,3,0,3,2,2,7,28.6,5,2,1,1,2,7,1,0
130,Marco Cruz,pt POR,DF,Vitória,,21.19452055,2004,0.1,0,0,0,0,0,0,0,,0,1,1,0,0,0,0,0
131,Sandro Cruz,ao ANG,DF,Gil Vicente FC,,23.98082192,2001,23.1,62,31,32,26,4,32,48,66.7,16,33,7,26,21,83,75,1
132,Augusto Dabo,gw GNB,DF,Boavista,,21.14520548,2004,6.1,9,6,5,1,3,8,12,66.7,4,9,2,7,2,11,26,1
133,Samuel Dahl,se SWE,"DF,MF",Benfica,,25.16986301,2000,6.5,11,5,3,7,1,9,15,60,6,10,0,10,5,16,6,0
134,Amadou Dante,ml MLI,"DF,MF",Arouca,,24.57534247,2000,11.6,28,19,21,5,2,17,31,54.8,14,12,2,10,17,45,26,4
135,Mathias De Amorim,fr FRA,MF,Famalicão,,20.4,2004,10.8,37,20,14,14,9,14,29,48.3,15,15,1,14,14,51,8,1
136,Zeno Debast,be BEL,"DF,MF",Sporting CP,,21.52876712,2003,22,36,26,14,20,2,15,26,57.7,11,20,4,16,22,58,33,3
137,Depú,ao ANG,FW,Gil Vicente FC,,25.32054795,2000,0.5,0,0,0,0,0,0,0,,0,0,0,0,0,0,0,0
138,Derick,br BRA,"DF,MF",Farense,,31.6739726,1993,15.7,29,14,16,7,6,16,38,42.1,22,21,2,19,10,39,45,1
139,Ángel Di María,ar ARG,FW,Benfica,,37.21917808,1988,17.4,16,7,4,6,6,7,20,35,13,13,0,13,8,24,0,0
140,Abdoulay Diaby,ml MLI,"FW,MF",Boavista,,33.95616438,1991,7,3,3,0,3,0,1,4,25,3,1,0,1,4,7,3,0
141,Matheus Dias,br BRA,"MF,DF",Nacional,,28.23835616,1997,18.1,48,30,25,20,3,25,51,49,26,29,12,17,35,83,62,3
142,Tiago Dias,pt POR,"DF,FW",Casa Pia,,27.00273973,1998,0.6,1,0,0,1,0,0,2,0,2,3,0,3,0,1,0,0
143,Ousmane Diomande,ci CIV,DF,Sporting CP,,21.41643836,2003,26.7,33,20,20,13,0,20,26,76.9,6,14,7,7,30,63,75,2
144,Tiago Djaló,pt POR,DF,Porto,,25.07123288,2000,6.6,12,6,10,2,0,4,5,80,1,3,2,1,3,15,19,3
145,Maxime Dominguez,ch SUI,MF,Gil Vicente FC,,29.25479452,1996,2.8,8,3,4,4,0,3,4,75,1,3,0,3,3,11,1,0
146,Issiar Dramé,ml MLI,DF,Estrela,,26.21369863,1999,14.7,18,10,14,4,0,8,11,72.7,3,21,16,5,21,39,110,3
147,Dudu,br BRA,"FW,MF",Nacional,,25.73424658,1999,14.9,27,18,9,11,7,11,22,50,11,26,0,26,6,33,8,1
148,Carlos Eduardo,br BRA,"FW,MF",Gil Vicente FC,,22.73424658,2002,2.7,1,1,1,0,0,0,1,0,1,0,0,0,0,1,1,0
149,Marcus Edwards,eng ENG,"MF,FW",Sporting CP,,26.41917808,1998,1.2,0,0,0,0,0,0,0,,0,0,0,0,0,0,2,0
150,Marvin Elimbi,fr FRA,DF,Gil Vicente FC,,22.20273973,2003,3.5,6,3,2,3,1,4,4,100,0,5,4,1,3,9,22,0
151,Simon Elisor,fr FRA,FW,Famalicão,,25.78630137,1999,5.6,0,0,0,0,0,0,3,0,3,4,0,4,2,2,3,0
152,Úmaro Embaló,pt POR,"FW,MF",Vitória,,23.99726027,2001,1.6,2,2,1,1,0,2,3,66.7,1,2,1,1,1,3,0,0
153,Rui Encarnação,pt POR,GK,Nacional,,27.08219178,1998,0.5,0,0,0,0,0,0,0,,0,0,0,0,0,0,0,0
154,Ricardo Esgaio,pt POR,DF,Sporting CP,,31.96986301,1993,2.6,4,3,1,2,1,1,4,25,3,3,0,3,2,6,16,0
155,Tiago Esgaio,pt POR,DF,Arouca,,29.75890411,1995,24.2,62,34,41,17,4,35,53,66,18,30,9,21,36,98,110,0
156,Dario Essugo,pt POR,MF,Sporting CP,,20.14246575,2005,0.2,0,0,0,0,0,0,0,,0,0,0,0,0,0,0,0
157,Luís Esteves,pt POR,MF,Nacional,,27.07123288,1998,30.2,45,32,18,21,6,19,60,31.7,41,29,5,24,16,61,13,1
158,Stephen Eustáquio,ca CAN,"MF,DF",Porto,,28.36986301,1996,20.4,53,28,13,27,13,19,39,48.7,20,26,3,23,22,75,39,1
159,Evanilson,br BRA,FW,Porto,,25.57808219,1999,0.1,1,0,0,1,0,0,0,,0,0,0,0,0,1,0,0
160,Claudio Falcão,br BRA,"DF,MF",Farense,,30.83835616,1994,29.7,102,65,54,41,7,46,74,62.2,28,40,21,19,46,148,156,3
161,Eduardo Felicíssimo,pt POR,MF,Sporting CP,,18.32054795,2007,2.2,10,6,3,3,4,4,5,80,1,2,0,2,5,15,2,0
162,Nuno Felix,pt POR,MF,Benfica,,21.1369863,2004,0.2,0,0,0,0,0,0,0,,0,0,0,0,0,0,0,0
163,Vando Félix,gw GNB,"FW,MF",Vitória,,22.66849315,2002,5.3,10,3,5,4,1,5,10,50,5,6,0,6,7,17,5,0
164,Jorge Filipe Oliveira Fernandes,pt POR,DF,Vitória,,28.09041096,1997,4.6,7,7,6,1,0,6,9,66.7,3,3,1,2,4,11,16,0
165,Lucas Fernandes,br BRA,"MF,FW",AVS Futebol,,27.62191781,1997,5.5,5,4,1,4,0,3,6,50,3,5,0,5,1,6,5,0
166,Martim Fernandes,pt POR,DF,Porto,,19.29315068,2006,14,23,13,11,8,4,7,18,38.9,11,17,3,14,11,34,15,0
167,Mateus Fernandes,pt POR,"FW,MF",Sporting CP,,20.81917808,2004,0.3,1,0,0,0,1,1,1,100,0,0,0,0,0,1,0,0
168,Roger Fernandes,gw GNB,"FW,MF",Braga,,19.45205479,2005,17.3,34,15,16,14,4,14,26,53.8,12,19,0,19,18,52,18,1
169,Rúben Fernandes,pt POR,DF,Gil Vicente FC,,38.99726027,1986,27.8,17,11,11,6,0,14,18,77.8,4,22,13,9,29,46,132,1
170,Roberto Férnandez,es ESP,FW,Braga,,22.83835616,2002,5.6,3,1,0,1,2,2,5,40,3,6,0,6,0,3,1,0
171,João Ferreira Barros,pt POR,"MF,FW",Boavista,,19.31506849,2006,2.9,11,9,4,6,1,6,10,60,4,2,0,2,4,15,3,0
172,Filipe Ferreira,pt POR,DF,Boavista,,34.60273973,1990,21.9,27,15,16,9,2,15,24,62.5,9,9,6,3,23,50,69,1
173,Fernando Ferreira Fonseca,pt POR,"DF,MF",AVS Futebol,,28.14246575,1997,18.2,52,33,32,12,8,39,63,61.9,24,29,7,22,31,83,52,0
174,João Ferreira,pt POR,DF,Braga,,24.12054795,2001,14.4,30,21,12,15,3,18,28,64.3,10,15,9,6,13,43,63,0
175,Marcelo dos Santos Ferreira,br BRA,DF,Moreirense,,35.77260274,1989,31,47,28,40,6,1,28,41,68.3,13,40,32,8,29,76,197,2
176,Pedro Ferreira,pt POR,MF,Santa Clara,,27.32876712,1998,19,74,47,30,35,9,26,42,61.9,16,29,3,26,35,109,40,0
177,Tiago Ferreira,pt POR,FW,Estrela,,23.13150685,2002,0.4,3,2,0,1,2,0,0,,0,0,0,0,1,4,0,0
178,Daniel Figueira,pt POR,GK,Estoril,,26.79178082,1998,1,0,0,0,0,0,0,0,,0,0,0,0,0,0,0,0
179,Sidoine Fogning,cm CMR,"DF,MF",Boavista,,23.47945205,2001,10,26,16,18,8,0,13,25,52,12,13,9,4,11,37,77,3
180,Tiago Fonseca Morais,pt POR,"FW,MF",Rio Ave,,21.66849315,2003,15.8,26,18,10,9,7,11,26,42.3,15,16,2,14,12,38,8,1
181,José Fontán,es ESP,DF,Arouca,,25.22739726,2000,27.8,28,13,16,12,0,12,29,41.4,17,44,27,17,26,54,150,1
182,José Fonte,pt POR,DF,Casa Pia,,41.36712329,1983,21.5,19,12,13,5,1,6,12,50,6,28,19,9,22,41,136,4
183,Lucas França,br BRA,GK,Nacional,,29.29041096,1996,31.5,0,0,0,0,0,0,0,,0,2,0,2,0,0,17,1
184,André Franco,pt POR,"MF,FW",Porto,,27.0630137,1998,5.3,2,1,1,1,0,1,6,16.7,5,3,0,3,5,7,2,0
185,Afonso freitas,pt POR,DF,Nacional,,25.07671233,2000,0.2,0,0,0,0,0,0,0,,0,0,0,0,0,0,3,0
186,Iván Fresneda,es ESP,"DF,MF",Sporting CP,,20.6,2004,10.6,26,17,10,10,6,13,24,54.2,11,19,4,15,10,36,13,0
187,Godfried Frimpong,nl NED,DF,Moreirense,,25.7890411,1999,27.2,29,18,19,9,1,16,24,66.7,8,22,7,15,38,67,121,1
188,Kanya Fujimoto,jp JPN,MF,Gil Vicente FC,,25.84383562,1999,24.7,14,10,3,8,3,6,16,37.5,10,19,6,13,10,24,14,1
189,Taichi Fukui,jp JPN,MF,Arouca,,20.80547945,2004,23.3,44,29,14,23,7,21,34,61.8,13,20,8,12,26,70,41,0
190,Rúben Furtado,pt POR,"FW,MF",Braga,,19.42465753,2005,0.6,0,0,0,0,0,0,0,,0,0,0,0,0,0,0,0
191,Tiago Gabriel,pt POR,DF,Estrela,,20.35616438,2004,10.9,19,12,14,5,0,10,14,71.4,4,20,10,10,20,39,64,2
192,Galeno,br BRA,"FW,DF",Porto,,27.53424658,1997,16.1,17,12,9,2,6,8,16,50,8,13,5,8,15,32,22,0
193,Tiago Galletto,uy URU,MF,AVS Futebol,,22.98356164,2002,0.7,1,0,1,0,0,1,1,100,0,2,1,1,0,1,0,0
194,Nino Galović,hr CRO,DF,Arouca,,32.83013699,1992,1,0,0,0,0,0,0,0,,0,2,2,0,1,1,2,0
195,García,br BRA,DF,Nacional,,23.33150685,2002,30.6,64,51,41,18,5,42,68,61.8,26,35,12,23,41,105,79,2
196,Fabrício Garcia,cv CPV,"FW,DF",Estoril,,24.00273973,2001,14.1,24,18,13,8,3,9,18,50,9,13,0,13,6,30,7,0
197,Santiago García,es ESP,MF,Gil Vicente FC,,23.68219178,2001,15.1,36,23,14,16,6,18,41,43.9,23,24,5,19,12,48,27,1
198,Bruno Gaspar,ao ANG,DF,Vitória,,32.03835616,1993,9.6,16,11,8,5,3,6,12,50,6,12,0,12,4,20,13,0
199,Mory Gbane,ci CIV,"MF,DF",Gil Vicente FC,,24.35890411,2000,16.3,43,22,20,23,0,29,37,78.4,8,16,10,6,38,81,62,1
200,Geovanny,pt POR,MF,Farense,,20.80821918,2004,1.8,3,2,1,2,0,2,5,40,3,3,2,1,0,3,1,0
201,André Geraldes,pt POR,"MF,DF",Casa Pia,,34.00821918,1991,12.9,15,6,12,3,0,9,10,90,1,13,4,9,9,24,46,0
202,Ismaël Gharbi,es ESP,"FW,MF",Braga,,21.06849315,2004,11.5,27,16,7,12,8,15,37,40.5,22,14,0,14,5,32,6,0
203,Marco van Ginkel,nl NED,"FW,MF",Boavista,,32.42465753,1992,6.1,10,6,6,3,1,2,9,22.2,7,4,1,3,2,12,7,0
204,José Gomes,pt POR,DF,Nacional,,28.79178082,1996,25,29,20,17,9,3,12,23,52.2,11,25,12,13,21,50,117,1
205,Pedro gomes,pt POR,DF,Boavista,,21.91780822,2003,15.9,41,23,23,15,3,25,36,69.4,11,23,5,18,16,57,51,4
206,Vítor Gomes,pt POR,MF,Rio Ave,,37.35890411,1987,0.4,1,0,0,0,1,0,1,0,1,0,0,0,1,2,6,0
207,William Gomes,br BRA,"MF,FW",Porto,,19.13972603,2006,1.5,5,4,2,2,1,3,5,60,2,3,0,3,1,6,1,0
208,Victor Gomez,es ESP,DF,Braga,,25.09315068,2000,19.3,39,25,18,16,5,22,40,55,18,17,3,14,27,66,65,0
209,Nuno Gonçalo Moreira,pt POR,"FW,MF",Casa Pia,,25.88493151,1999,16.6,28,19,7,13,8,13,28,46.4,15,11,1,10,6,34,14,0
210,João Gonçalves,pt POR,GK,Boavista,,24.49589041,2000,4,0,0,0,0,0,0,0,,0,0,0,0,0,0,2,0
211,Pedro Gonçalves,pt POR,"FW,MF",Sporting CP,,26.85205479,1998,7.9,10,3,1,5,4,3,10,30,7,5,1,4,3,13,0,0
212,Cristo González,es ESP,MF,Arouca,,27.52876712,1997,2,2,1,1,0,1,1,4,25,3,1,1,0,0,2,1,0
213,Juan González,co COL,FW,Estrela,,20.77260274,2004,0.2,0,0,0,0,0,0,0,,0,0,0,0,0,0,0,0
214,Mario González,es ESP,FW,Famalicão,,29.1890411,1996,6.4,2,1,0,1,1,1,3,33.3,2,3,0,3,0,2,5,0
215,Nicolás González,es ESP,MF,Porto,,23.33424658,2002,16,34,19,9,18,7,17,25,68,8,10,2,8,6,40,11,0
216,Jean Gorby,fr FRA,MF,Braga,,22.77808219,2002,13.3,26,11,9,14,3,16,27,59.3,11,12,8,4,21,47,23,0
217,João Goulart Silva,pt POR,DF,Casa Pia,,25.26849315,2000,29.5,38,24,26,8,4,25,37,67.6,12,36,22,14,31,69,152,2
218,Tiago Gouveia,pt POR,"FW,DF",Benfica,,23.87945205,2001,0.9,2,2,1,1,0,0,0,,0,1,0,1,0,2,0,0
219,Pablo Gozalbez,es ESP,MF,Arouca,,24.01369863,2001,7.2,12,6,4,5,3,6,9,66.7,3,8,1,7,3,15,7,0
220,João Graça,pt POR,"MF,FW",Rio Ave,,29.87945205,1995,5.2,15,7,6,7,2,10,21,47.6,11,12,2,10,2,17,8,0
221,Samuel Granada,br BRA,FW,AVS Futebol,,25.23013699,2000,2.7,1,1,1,0,0,0,0,,0,1,0,1,0,1,5,0
222,Jaume Grau,es ESP,MF,AVS Futebol,,28,1997,20.5,54,36,26,25,3,30,53,56.6,23,33,9,24,32,86,38,2
223,Marko Grujić,rs SRB,MF,Porto,,29.06027397,1996,0.4,0,0,0,0,0,0,0,,0,1,1,0,0,0,2,0
224,Marko Gudžulić,rs SRB,GK,Estrela,,22.83287671,2002,2,0,0,0,0,0,0,0,,0,0,0,0,0,0,2,0
225,Rafik Guitane,fr FRA,"FW,MF",Estoril,,25.94246575,1999,8.6,7,5,2,3,2,2,4,50,2,9,0,9,1,8,1,1
226,Rafik Guitane,fr FRA,FW,Braga,,25.94246575,1999,0,0,0,0,0,0,0,0,,0,1,0,1,0,0,0,0
227,Deniz Gül,tr TUR,FW,Porto,,20.84109589,2004,4.6,0,0,0,0,0,0,2,0,2,3,0,3,0,0,1,0
228,Viktor Gyökeres,se SWE,FW,Sporting CP,,26.91780822,1998,29.2,7,3,0,2,5,4,8,50,4,12,2,10,5,12,19,0
229,Justin de Haas,nl NED,DF,Famalicão,,25.25479452,2000,26.4,37,21,27,9,1,21,29,72.4,8,28,21,7,47,84,158,1
230,Habraão,br BRA,FW,Santa Clara,,23.85753425,2001,0,0,0,0,0,0,0,0,,0,0,0,0,0,0,0,0
231,Tomás Händel,pt POR,MF,Vitória,,24.43561644,2000,27,42,23,18,19,5,27,45,60,18,17,2,15,37,79,30,0
232,Conrad Harder,dk DEN,"FW,MF",Sporting CP,,20.07671233,2005,8.6,7,6,0,5,2,4,14,28.6,10,8,0,8,3,10,8,0
233,Thiago Helguera,uy URU,MF,Braga,,19.10958904,2006,0.1,0,0,0,0,0,0,0,,0,0,0,0,0,0,1,0
234,Gustavo Henrique,br BRA,"MF,FW",Estrela,,26.00821918,1999,2.5,7,4,3,4,0,5,9,55.6,4,4,0,4,2,9,6,0
235,Morten Hjulmand,dk DEN,MF,Sporting CP,,25.86027397,1999,23.6,50,34,19,26,5,22,39,56.4,17,19,8,11,26,76,27,2
236,Jordan Holsgrove,sct SCO,MF,Estoril,,25.64931507,1999,24.5,38,22,13,20,5,17,36,47.2,19,26,9,17,30,68,31,1
237,Lukáš Horníček,cz CZE,GK,Braga,,22.8109589,2002,15,0,0,0,0,0,0,0,,0,1,0,1,0,0,8,3
238,André Horta,pt POR,MF,Braga,,28.49041096,1996,5.6,15,10,3,9,3,7,12,58.3,5,3,0,3,3,18,5,0
239,Ricardo Horta,pt POR,"MF,FW",Braga,,30.63561644,1994,29.5,40,25,9,20,11,12,36,33.3,24,20,3,17,8,48,22,0
240,Igor,br BRA,MF,Estrela,,22.16164384,2003,8.9,19,12,7,11,1,12,24,50,12,18,5,13,14,33,8,0
241,André Inácio,br BRA,"MF,FW",Estrela,,23.19452055,2002,7.1,11,4,4,6,1,4,12,33.3,8,8,0,8,2,13,6,0
242,André Inácio,br BRA,"FW,MF",Rio Ave,,23.19452055,2002,10.1,11,5,5,6,0,8,16,50,8,9,0,9,4,15,8,0
243,Gonçalo Inácio,pt POR,DF,Sporting CP,,23.69315068,2001,23.1,36,22,11,18,7,19,31,61.3,12,23,13,10,30,66,60,1
244,Isaac,br BRA,FW,Nacional,,21.10958904,2004,13.7,18,13,4,10,4,3,9,33.3,6,9,1,8,1,19,9,1
245,Ismael,pt POR,MF,Moreirense,,26.11232877,1999,22.5,70,37,32,33,5,24,40,60,16,27,11,16,35,105,49,1
246,Franco Israel,uy URU,GK,Sporting CP,,25.03561644,2000,11,0,0,0,0,0,0,0,,0,0,0,0,0,0,4,1
247,Ivan Jaime Pajuelo,es ESP,FW,Porto,,24.60547945,2000,4.9,2,1,1,1,0,2,6,33.3,4,3,0,3,2,4,3,0
248,Jason,es ESP,"FW,MF",Arouca,,30.83013699,1994,23.1,23,12,10,8,5,12,41,29.3,29,19,4,15,10,33,9,1
249,Jhonatan,br BRA,GK,Rio Ave,,33.99178082,1991,8,0,0,0,0,0,0,1,0,1,0,0,0,0,0,2,3
250,Diederrick Joel,cm CMR,FW,Nacional,,31.4109589,1993,8,4,3,0,1,3,2,3,66.7,1,4,0,4,0,4,5,0
251,Joel Jorquera,es ESP,FW,Moreirense,,24.70958904,2000,3.1,4,2,2,1,1,1,4,25,3,4,2,2,0,4,1,0
252,Luiz Lúcio Reis Júnior,br BRA,GK,Famalicão,,24.30410959,2001,1,0,0,0,0,0,0,0,,0,0,0,0,0,0,1,0
253,Samuel Justo,pt POR,MF,Farense,,21.09041096,2004,0.4,1,1,0,1,0,1,3,33.3,2,0,0,0,0,1,2,0
254,Issa Kaboré,bf BFA,DF,Benfica,,23.98082192,2001,0.1,0,0,0,0,0,0,0,,0,1,0,1,0,0,0,0
255,Kaio,br BRA,FW,Vitória,,21.21643836,2004,14.4,23,15,8,7,8,9,30,30,21,15,1,14,9,32,3,0
256,Kaique,br BRA,GK,Farense,,22.05205479,2003,4,0,0,0,0,0,0,0,,0,0,0,0,0,0,0,0
257,Osman Kakay,sl SLE,"DF,MF",Boavista,,27.69315068,1997,4.4,10,5,5,3,2,8,10,80,2,5,1,4,1,11,15,0
258,Issiaka Kamate,fr FRA,"FW,MF",AVS Futebol,,20.75616438,2004,3.9,7,5,5,2,0,4,5,80,1,1,0,1,5,12,3,0
259,Kazu,br BRA,DF,Gil Vicente FC,,25.13150685,2000,5.9,6,3,1,2,3,4,9,44.4,5,8,0,8,2,8,15,0
260,Keliano,ao ANG,MF,Estrela,,22.29863014,2003,10.6,48,27,16,26,6,27,45,60,18,13,0,13,12,60,22,1
261,Kewin,br BRA,GK,Moreirense,,29.5260274,1995,29,1,1,1,0,0,1,2,50,1,1,0,1,0,1,26,4
262,Kikas,pt POR,FW,Estrela,,26.63013699,1998,20.8,6,3,2,3,1,2,6,33.3,4,10,3,7,1,7,14,0
263,Gustavo Klismahn,br BRA,"MF,FW",Santa Clara,,25.44657534,1999,9.1,19,13,6,9,4,9,20,45,11,10,3,7,8,27,12,0
264,Ruben Kluivert,nl NED,DF,Casa Pia,,23.95616438,2001,13.7,25,15,20,4,1,10,14,71.4,4,18,9,9,11,36,66,2
265,Koka,eg EGY,"FW,MF",Rio Ave,,32.16712329,1993,1.9,0,0,0,0,0,0,2,0,2,2,0,2,0,0,6,0
266,Orkun Kökçü,tr TUR,MF,Benfica,,24.34794521,2000,27.3,39,27,14,20,5,18,36,50,18,22,0,22,13,52,10,2
267,Moussa Koné,sn SEN,"MF,FW",Boavista,,28.34520548,1996,3.3,3,2,1,1,1,0,2,0,2,3,0,3,0,3,1,0
268,Konstantinos Kostoulas,gr GRE,DF,Rio Ave,,20.23561644,2005,1.1,1,0,1,0,0,1,1,100,0,2,1,1,2,3,8,0
269,Vladen Kovačević,ba BIH,GK,Sporting CP,,27.06575342,1998,6,0,0,0,0,0,0,0,,0,0,0,0,0,0,3,0
270,Andrian Kraev,bg BUL,MF,Casa Pia,,26.21917808,1999,16.5,36,20,13,15,8,18,36,50,18,15,6,9,19,55,25,3
271,Layvin Kurzawa,fr FRA,"DF,MF",Boavista,,32.66575342,1992,1.9,4,1,3,0,1,4,8,50,4,3,0,3,4,8,5,1
272,Chiheb Labidi,tn TUN,"MF,FW",Nacional,,23.9260274,2001,4.1,13,8,5,4,4,5,11,45.5,6,6,0,6,7,20,6,1
273,André Lacximicant,pt POR,FW,Estoril,,23.96164384,2001,10,6,4,1,3,2,1,8,12.5,7,8,2,6,4,10,12,0
274,Chico Lamba,pt POR,DF,Arouca,,22.15342466,2003,23.3,33,17,25,6,2,23,26,88.5,3,31,26,5,11,44,128,1
275,Larra,es ESP,"MF,DF",Casa Pia,,27.38082192,1997,23.1,31,23,18,12,1,18,24,75,6,25,6,19,31,62,46,3
276,Leonardo Lelo,pt POR,"MF,DF",Casa Pia,,25.09863014,2000,31.6,58,35,24,21,13,35,59,59.3,24,34,4,30,25,83,83,1
277,Marcos Leonardo,br BRA,MF,Benfica,,22.00821918,2003,0.9,0,0,0,0,0,0,0,,0,0,0,0,0,0,0,0
278,Guilherme Liberato,br BRA,MF,Moreirense,,23.88493151,2001,0.5,1,0,0,1,0,1,1,100,0,0,0,0,0,1,1,0
279,Otso Liimatta,fi FIN,"FW,MF",Famalicão,,20.81917808,2004,1.3,3,2,1,1,1,2,2,100,0,2,0,2,1,4,0,0
280,Rúben Lima,pt POR,DF,Estrela,,35.58630137,1989,19.8,29,18,16,13,0,14,27,51.9,13,16,9,7,27,56,82,1
281,Yan Lincon,br BRA,FW,Moreirense,,22.64109589,2002,2.6,1,0,0,1,0,1,2,50,1,3,1,2,0,1,3,0
282,Jérémy Livolant,fr FRA,"FW,MF",Casa Pia,,27.31780822,1998,18,11,10,5,5,1,3,11,27.3,8,18,2,16,0,11,13,0
283,Danny Loader,cm CMR,"FW,MF",Porto,,24.68493151,2000,11.2,9,6,1,4,4,4,13,30.8,9,9,1,8,6,15,7,0
284,Samuel Lobato,pt POR,"FW,MF",Famalicão,,23.54246575,2001,0.8,3,2,2,1,0,2,4,50,2,1,1,0,0,3,1,0
285,Tom van de Looi,nl NED,MF,Famalicão,,25.84109589,1999,17.5,33,22,14,14,5,12,27,44.4,15,13,6,7,13,46,46,1
286,Miguel Lopes,pt POR,DF,Estrela,,38.37534247,1986,12.2,21,16,14,7,0,15,28,53.6,13,14,8,6,17,38,96,2
287,Rony Lopes,pt POR,"MF,FW",Farense,,29.35068493,1995,10.9,10,8,2,6,2,3,9,33.3,6,9,0,9,5,15,9,0
288,Vasco Lopes,cv CPV,"FW,MF",AVS Futebol,,25.67123288,1999,11.1,14,5,8,4,2,6,12,50,6,15,0,15,5,19,5,0
289,Mamadou Loum,sn SEN,"MF,DF",Arouca,,28.34520548,1996,7.7,15,8,8,6,1,11,21,52.4,10,7,4,3,10,25,37,1
290,Jonatan Lucca,br BRA,MF,AVS Futebol,,30.92328767,1994,3,2,1,1,1,0,1,3,33.3,2,6,2,4,2,4,8,1
291,Florentino Luís,pt POR,MF,Benfica,,25.70958904,1999,20.2,74,40,24,38,12,30,55,54.5,25,28,4,24,48,122,31,4
292,Zé Luís,cv CPV,FW,AVS Futebol,,34.27671233,1991,13.5,7,6,4,2,1,2,7,28.6,5,12,3,9,0,7,16,0
293,Luismi,gq EQG,FW,Moreirense,,23.82191781,2001,15,16,10,4,10,2,9,20,45,11,22,3,19,3,19,21,0
294,Vitali Lystsov,ru RUS,DF,Boavista,,29.81643836,1995,5.2,18,10,14,4,0,11,20,55,9,8,5,3,8,26,33,0
295,Rúben Macedo,pt POR,"FW,MF",Nacional,,29.15616438,1996,12,9,7,4,2,3,4,12,33.3,8,11,0,11,3,12,9,0
296,Tiago Machado,pt POR,"FW,MF",Boavista,,21.09041096,2004,1.4,1,1,0,1,0,0,1,0,1,1,0,1,0,1,0,0
297,Madson,br BRA,FW,Moreirense,,25.69041096,1999,13,18,15,8,9,1,9,19,47.4,10,12,0,12,11,29,17,0
298,Miguel Maga,pt POR,DF,Vitória,,22.46575342,2002,14,27,19,13,14,0,17,25,68,8,16,4,12,10,37,41,1
299,Otar Mamageishvili,ge GEO,MF,Famalicão,,22.30136986,2003,0.5,1,1,0,1,0,0,0,,0,0,0,0,0,1,0,0
300,Eliaquim Mangala,fr FRA,DF,Estoril,,34.22191781,1991,4.7,7,6,5,2,0,5,8,62.5,3,7,6,1,8,15,22,0
301,Ricardo Mangas,pt POR,FW,Vitória,,27.12876712,1998,3.8,3,3,2,0,1,3,4,75,1,2,0,2,0,3,8,0
302,Brian Mansilla,uy URU,"FW,MF",Arouca,,22.97534247,2002,3.1,7,3,4,3,0,4,8,50,4,11,1,10,1,8,3,0
303,Nico Mantl,de GER,GK,Arouca,,25.24109589,2000,29,0,0,0,0,0,0,0,,0,0,0,0,1,1,19,5
304,Manú,ao ANG,"FW,DF",Estrela,,19.48493151,2005,0.5,1,1,1,0,0,1,3,33.3,2,0,0,0,0,1,1,0
305,Manuel Manu,pt POR,MF,Vitória,,23.89589041,2001,7.6,22,16,11,7,4,16,24,66.7,8,6,0,6,11,33,16,0
306,Manuel Manu,pt POR,MF,Benfica,,23.89589041,2001,1.5,8,4,2,5,1,6,8,75,2,0,0,0,6,14,2,1
307,Maracás,br BRA,DF,Moreirense,,31.02191781,1994,26.6,31,18,24,7,0,17,25,68,8,33,26,7,27,58,167,1
308,Iván Marcano,es ESP,DF,Porto,,37.86575342,1987,8.5,8,4,4,3,1,4,5,80,1,5,3,2,10,18,31,0
309,Adrián Marín,es ESP,DF,Braga,,28.31780822,1997,7.9,18,6,11,7,0,8,16,50,8,9,1,8,13,31,29,0
310,João Mário,pt POR,"FW,MF",Benfica,,32.29041096,1993,1.7,3,2,3,0,0,3,3,100,0,3,0,3,0,3,0,0
311,João Mário Lopes,pt POR,DF,Porto,,25.33424658,2000,17.4,26,16,12,9,5,16,36,44.4,20,13,1,12,8,34,17,1
312,Uładzisłaŭ Marozaŭ,by BLR,FW,Arouca,,24.56164384,2000,3.1,2,2,0,2,0,0,2,0,2,2,1,1,1,3,4,0
313,Alejandro Marqués,ve VEN,FW,Estoril,,24.75068493,2000,18.3,6,4,1,2,3,0,4,0,4,15,1,14,8,14,18,0
314,Alex Marques,pt POR,DF,Boavista,,19.53150685,2005,1.1,1,1,0,1,0,0,1,0,1,2,2,0,1,2,3,0
315,João Marques,pt POR,"MF,FW",Braga,,23.22191781,2002,0.4,2,1,1,1,0,1,1,100,0,4,0,4,0,2,0,0
316,João Marques,pt POR,"FW,MF",Gil Vicente FC,,23.22191781,2002,4.8,11,9,6,4,1,3,7,42.9,4,5,0,5,3,14,6,0
317,Gabri Martínez,es ESP,"FW,MF",Braga,,22.28219178,2003,17,46,29,22,13,11,32,52,61.5,20,25,1,24,7,53,24,2
318,Toni Martínez,es ESP,FW,Porto,,27.84657534,1997,0,2,0,0,2,0,1,1,100,0,0,0,0,0,2,0,0
319,Bernardo Martins,pt POR,"FW,MF",Moreirense,,27.41643836,1997,16.2,32,19,11,15,6,14,46,30.4,32,20,1,19,10,42,19,2
320,Matheus,br BRA,GK,Braga,,32.79452055,1992,17,2,1,2,0,0,2,5,40,3,1,0,1,0,2,5,0
321,Matheusinho,br BRA,"FW,MF",Santa Clara,,27.22739726,1998,0.8,2,2,2,0,0,0,1,0,1,0,0,0,0,2,1,0
322,Marco Matias,pt POR,"FW,MF",Farense,,35.98630137,1989,12.1,15,10,10,5,0,2,14,14.3,12,11,1,10,8,23,8,1
323,Jordi Mboula,es ESP,"FW,MF",Gil Vicente FC,,26.1369863,1999,12.8,17,9,4,8,5,9,22,40.9,13,12,0,12,7,24,10,0
324,Tobías Medina,ar ARG,"MF,FW",Rio Ave,,21.17260274,2004,0.3,0,0,0,0,0,0,0,,0,1,0,1,0,0,0,0
325,Mauro Meireles Couto,pt POR,DF,Sporting CP,,19.46849315,2005,0,0,0,0,0,0,0,0,,0,0,0,0,0,0,0,0
326,Francisco Meixedo,pt POR,GK,Estrela,,23.96164384,2001,0.5,0,0,0,0,0,0,0,,0,0,0,0,0,0,0,0
327,Yair Mena Palacios,co COL,"MF,FW",AVS Futebol,,24.85205479,2000,1,2,2,0,2,0,0,3,0,3,0,0,0,1,3,2,0
328,João Mendes,pt POR,"MF,FW",Vitória,,30.5369863,1994,18.3,24,17,3,14,7,13,30,43.3,17,19,1,18,4,28,10,0
329,João Mendes,pt POR,DF,Vitória,,25.06027397,2000,26.9,63,37,36,22,5,40,65,61.5,25,26,2,24,20,83,80,2
330,Joe Mendes,se SWE,DF,Braga,,22.34246575,2002,2,2,1,0,2,0,2,2,100,0,2,0,2,1,3,4,0
331,Gustavo Mendonça,pt POR,MF,AVS Futebol,,22.15068493,2003,7.2,18,15,7,10,1,7,13,53.8,6,9,1,8,7,25,9,1
332,Miguel Menino,pt POR,MF,Farense,,22.31506849,2003,20.3,34,21,13,19,2,13,29,44.8,16,21,1,20,24,58,26,0
333,John Mercado,ec ECU,"FW,MF",AVS Futebol,,22.92054795,2002,23.3,34,20,15,14,5,15,32,46.9,17,26,3,23,13,47,24,2
334,Mehdi Merghem,fr FRA,"MF,FW",Farense,,27.79452055,1997,5.1,17,11,10,4,3,7,14,50,7,9,0,9,4,21,1,0
335,Bruno Messi,pt POR,"FW,MF",Santa Clara,,28.65205479,1996,1.3,2,2,2,0,0,1,4,25,3,1,1,0,0,2,1,0
336,Michel,br BRA,DF,Moreirense,,21.95890411,2003,1.1,1,1,0,1,0,1,2,50,1,3,2,1,1,2,16,0
337,Dieu-Merci Michel,ca CAN,FW,Vitória,,21.23287671,2004,3.9,1,0,0,0,1,0,0,,0,2,0,2,0,1,0,0
338,Enea Mihaj,al ALB,DF,Famalicão,,26.83287671,1998,28.1,33,18,20,12,1,17,26,65.4,9,40,24,16,40,73,127,2
339,Álex Millán,es ESP,"FW,MF",Farense,,25.49041096,1999,4.5,3,0,0,2,1,0,2,0,2,7,0,7,1,4,7,0
340,Cezary Miszta,pl POL,GK,Rio Ave,,23.51232877,2001,23,0,0,0,0,0,0,1,0,1,0,0,0,0,0,13,1
341,Iyad Mohamed,km COM,MF,Casa Pia,,24.16712329,2001,4.6,9,4,2,6,1,6,7,85.7,1,8,3,5,2,11,7,0
342,Rodrigo Mora,pt POR,MF,Porto,,18,2007,13.9,18,13,3,6,9,7,20,35,13,11,0,11,8,26,3,0
343,Morato,br BRA,DF,Benfica,,23.84657534,2001,1,3,2,1,2,0,1,3,33.3,2,1,0,1,3,6,1,0
344,Paulo Moreira,pt POR,MF,Estrela,,25.2109589,2000,12.1,33,19,13,14,6,14,25,56,11,17,3,14,12,45,8,0
345,Marco Moreno,es ESP,DF,Farense,,24.20273973,2001,20.7,18,12,14,4,0,10,18,55.6,8,16,15,1,29,47,109,0
346,Dani Morer,es ESP,DF,Moreirense,,27.24383562,1998,0.1,0,0,0,0,0,0,0,,0,1,0,1,0,0,4,0
347,Hidemasa Morita,jp JPN,MF,Sporting CP,,29.98630137,1995,13.2,29,18,9,17,3,13,21,61.9,8,15,3,12,9,38,17,1
348,Moura,pt POR,DF,Famalicão,,25.71780822,1999,4,10,7,6,3,1,6,7,85.7,1,4,0,4,1,11,6,0
349,Moura,pt POR,DF,Porto,,25.71780822,1999,22.6,32,17,12,13,7,17,33,51.5,16,36,6,30,16,48,37,0
350,João Moutinho,pt POR,MF,Braga,,38.65479452,1986,16.8,40,20,15,21,4,20,42,47.6,22,21,4,17,20,60,21,0
351,MT,br BRA,"DF,MF",Santa Clara,,24.17808219,2001,30,58,30,44,12,2,29,49,59.2,20,25,6,19,36,94,161,1
352,Jonathan Mutombo,fr FRA,DF,Gil Vicente FC,,22.68767123,2002,6.5,27,18,21,4,2,20,24,83.3,4,2,0,2,7,34,26,0
353,Manuel Namora,pt POR,"MF,FW",Boavista,,27.22465753,1998,3.4,4,3,1,1,2,0,1,0,1,2,0,2,4,8,6,0
354,Dylan Nandín,uy URU,FW,Arouca,,23.18082192,2002,6.6,10,5,2,4,4,1,6,16.7,5,8,1,7,1,11,4,0
355,Nani,pt POR,"FW,MF",Estrela,,38.4630137,1986,5.2,4,1,1,3,0,1,6,16.7,5,3,2,1,3,7,2,0
356,Fran Navarro,es ESP,FW,Porto,,27.24931507,1998,1,2,0,0,0,2,2,2,100,0,1,0,1,0,2,0,0
357,Fran Navarro,es ESP,FW,Braga,,27.24931507,1998,6.7,3,2,0,2,1,1,2,50,1,3,0,3,1,4,3,0
358,Christian Neiva Afonso,pt POR,"DF,MF",AVS Futebol,,30.4,1994,16.7,31,25,15,11,5,18,26,69.2,8,26,9,17,12,43,49,3
359,Nenê,br BRA,FW,AVS Futebol,,41.76986301,1983,8.2,8,3,2,4,2,0,2,0,2,4,0,4,0,8,4,0
360,Neto,br BRA,MF,Farense,,33.67123288,1991,17.8,41,22,15,25,1,22,47,46.8,25,26,6,20,28,69,31,2
361,Martim Neto,pt POR,MF,Rio Ave,,22.30410959,2003,12.9,26,11,6,18,2,13,32,40.6,19,11,2,9,7,33,6,2
362,Renato Nhaga,gw GNB,MF,Casa Pia,,18.10684932,2007,0,0,0,0,0,0,0,0,,0,1,0,1,0,0,0,0
363,Sikou Niakaté,ml MLI,DF,Braga,,25.81917808,1999,20,14,8,8,6,0,6,12,50,6,12,9,3,31,45,85,3
364,Yusupha Njie,gm GAM,"FW,MF",Farense,,31.33424658,1994,6.7,3,1,0,2,1,1,6,16.7,5,13,0,13,2,5,4,0
365,Miguel Nóbrega,pt POR,DF,Rio Ave,,25.04931507,2000,1,3,2,3,0,0,3,5,60,2,3,3,0,0,3,2,0
366,Jonatás Noro,pt POR,DF,Braga,,19.82191781,2005,0.1,0,0,0,0,0,0,0,,0,0,0,0,0,0,1,0
367,João Novais,pt POR,MF,Rio Ave,,31.81917808,1993,14.4,21,9,10,7,4,13,21,61.9,8,9,1,8,8,29,6,1
368,Andreas Ntoi,gr GRE,DF,Rio Ave,,22.25205479,2003,13.2,18,13,12,5,1,12,21,57.1,9,17,10,7,11,29,101,1
369,Samuel Obeng,gh GHA,FW,Casa Pia,,27.97260274,1997,4.1,1,1,0,1,0,1,2,50,1,2,0,2,0,1,9,0
370,Guillermo Ochoa,mx MEX,GK,AVS Futebol,,39.8109589,1985,20,1,1,1,0,0,1,1,100,0,1,0,1,0,1,14,2
371,Lawrence Ofori,gh GHA,MF,Moreirense,,26.85205479,1998,19.8,30,18,14,14,2,13,33,39.4,20,11,1,10,21,51,23,3
372,Leonardo Oliveira,pt POR,FW,Famalicão,,20.23561644,2005,0.3,0,0,0,0,0,0,0,,0,1,0,1,0,0,0,0
373,Nélson Oliveira,pt POR,FW,Vitória,,33.73972603,1991,18.6,3,1,0,0,3,1,6,16.7,5,7,1,6,2,5,6,0
374,Paulo Oliveira,pt POR,DF,Braga,,33.32054795,1992,17,22,12,15,7,0,7,10,70,3,21,13,8,24,46,114,1
375,Talys Oliveira,br BRA,DF,Farense,,26.23013699,1999,2.8,6,2,2,3,1,3,6,50,3,3,0,3,3,9,6,0
376,Samu Omorodion,es ESP,FW,Porto,,21,2004,23.2,4,2,0,1,3,2,3,66.7,1,13,1,12,6,10,11,0
377,Bruno Onyemaechi,ng NGA,"DF,MF",Boavista,,26.08767123,1999,17.4,29,18,17,10,2,14,26,53.8,12,19,6,13,19,48,59,2
378,Jandro Orellana,es ESP,MF,Estoril,,24.74246575,2000,11.3,19,10,5,11,3,11,16,68.8,5,6,1,5,10,29,7,1
379,Korede Osundina,us USA,FW,Casa Pia,,21.22191781,2004,1.9,3,1,0,0,3,0,2,0,2,0,0,0,0,3,3,0
380,Nicolás Otamendi,ar ARG,DF,Benfica,,37.22465753,1988,28.1,47,28,24,18,5,25,38,65.8,13,27,14,13,55,102,106,5
381,Amine El Ouazzani,ma MAR,FW,Braga,,23.80547945,2001,17.4,17,10,4,7,6,6,12,50,6,18,2,16,5,22,8,0
382,Amine Oudrhiri,ma MAR,MF,Estrela,,32.49863014,1992,5.9,11,4,9,2,0,7,13,53.8,6,7,1,6,8,19,8,0
383,Amine Oudrhiri,ma MAR,MF,Rio Ave,,32.49863014,1992,7.2,10,8,8,1,1,5,14,35.7,9,10,4,6,16,26,7,0
384,Pablo,br BRA,"FW,MF",Gil Vicente FC,,21.3369863,2004,7.3,15,10,5,7,3,10,14,71.4,4,6,1,5,4,19,9,0
385,Renato Pantalon,hr CRO,DF,Estrela,,27.52054795,1997,5.3,4,4,4,0,0,3,4,75,1,5,5,0,6,10,45,0
386,Renato Pantalon,hr CRO,DF,Rio Ave,,27.52054795,1997,7.7,13,5,9,4,0,9,11,81.8,2,8,5,3,12,25,36,2
387,Jonathan Panzo,eng ENG,DF,Rio Ave,,24.5260274,2000,12.2,18,11,11,6,1,10,20,50,10,17,7,10,14,32,73,1
388,David Pastor,br BRA,"DF,MF",Farense,,25.20273973,2000,26.9,55,40,30,20,5,29,51,56.9,22,29,3,26,42,97,60,3
389,Afonso Patrão,pt POR,FW,Braga,,18.24931507,2007,1.9,2,0,0,1,1,0,0,,0,1,0,1,0,2,1,0
390,Patrick,br BRA,DF,Rio Ave,,27.92054795,1997,11.1,11,8,10,1,0,5,12,41.7,7,13,10,3,15,26,54,3
391,Vangelis Pavlidis,gr GRE,FW,Benfica,,26.45205479,1998,23.1,16,10,1,4,11,7,13,53.8,6,13,1,12,5,21,10,1
392,Zé Pedro Figueiredo,pt POR,DF,Porto,,27.91232877,1997,14.6,24,16,12,10,2,17,30,56.7,13,12,8,4,19,43,69,1
393,João Pedro,br BRA,DF,Rio Ave,,22.14246575,2003,1.1,4,3,2,2,0,2,4,50,2,3,1,2,0,4,5,1
394,Daniel Penha,br BRA,MF,Nacional,,26.54794521,1998,15.9,25,16,6,16,3,12,37,32.4,25,18,4,14,11,36,12,0
395,Pepê,br BRA,"FW,MF",Porto,,28.19178082,1997,21.8,23,14,3,7,13,8,25,32,17,18,0,18,11,34,5,0
396,Pereira,pt POR,"FW,MF",Casa Pia,,23.21643836,2002,8.1,4,4,3,1,0,2,7,28.6,5,4,0,4,4,8,3,0
397,Diogo Pereira,pt POR,MF,Gil Vicente FC,,22.00273973,2003,0.2,0,0,0,0,0,0,0,,0,1,1,0,1,1,1,0
398,Francisco Pereira,pt POR,MF,Estoril,,23.24109589,2002,0.1,0,0,0,0,0,0,0,,0,0,0,0,0,0,1,0
399,Matheus Pereira,br BRA,"MF,DF",Santa Clara,,24.36986301,2000,18.1,32,18,13,15,4,16,35,45.7,19,22,4,18,12,44,46,0
400,Sebastián Pérez Cardona,co COL,"MF,DF",Boavista,,32.10136986,1993,19.6,46,28,28,14,4,25,50,50,25,23,9,14,29,75,35,1
401,Nehuén Pérez,ar ARG,DF,Porto,,24.8630137,2000,22.1,26,16,14,11,1,14,19,73.7,5,18,9,9,24,50,62,2
402,Tomás Pérez,ar ARG,"DF,MF",Porto,,19.69041096,2005,1.2,2,1,1,1,0,0,0,,0,5,1,4,4,6,2,0
403,Francisco Petrasso,ar ARG,DF,Rio Ave,,23.18082192,2002,3.7,3,3,3,0,0,0,5,0,5,5,5,0,2,5,21,1
404,Petterson,br BRA,"MF,FW",Estrela,,21.33150685,2004,0.8,1,0,0,1,0,1,2,50,1,0,0,0,1,2,0,0
405,Lucas Piazon,br BRA,"MF,FW",AVS Futebol,,31.28767123,1994,24.1,53,33,17,26,10,27,50,54,23,30,4,26,21,74,10,0
406,Wagner Pina,cv CPV,"DF,MF",Estoril,,22.50136986,2002,25.7,69,46,29,31,9,33,57,57.9,24,39,8,31,32,101,65,1
407,Rodrigo Pinheiro,pt POR,DF,Famalicão,,22.68493151,2002,20.2,44,28,25,14,5,26,42,61.9,16,23,5,18,24,68,64,2
408,Rodrigo Pinho,br BRA,FW,Estrela,,33.93150685,1991,17.6,13,7,7,3,3,5,15,33.3,10,7,0,7,6,19,19,0
409,Alexandre Pinto,pt POR,DF,Arouca,,26.82465753,1998,7.1,12,11,9,2,1,8,12,66.7,4,5,2,3,11,23,24,1
410,Dinis Pinto,pt POR,DF,Moreirense,,24.69589041,2000,22.1,57,35,34,18,5,35,53,66,18,22,6,16,23,80,80,0
411,Jaime Pinto,pt POR,"MF,FW",Farense,,27.6,1997,2.6,3,2,0,2,1,0,4,0,4,4,2,2,1,4,2,0
412,João Pinto,pt POR,MF,Gil Vicente FC,,22.67671233,2002,0,0,0,0,0,0,0,0,,0,0,0,0,0,0,0,0
413,Ole Pohlmann,de GER,"MF,FW",Rio Ave,,24.08219178,2001,16.8,18,8,3,5,10,10,17,58.8,7,14,6,8,2,20,14,0
414,Carlos Ponck,cv CPV,DF,Moreirense,,30.30684932,1995,5.4,9,8,5,3,1,4,6,66.7,2,3,2,1,6,15,37,0
415,Boris Popović,rs SRB,DF,Arouca,,25.18630137,2000,9,11,7,7,3,1,4,6,66.7,2,13,9,4,12,23,41,1
416,Darío Poveda,es ESP,"FW,MF",Farense,,28.14520548,1997,10.2,5,1,1,3,1,1,7,14.3,6,4,1,3,4,9,9,0
417,Gianluca Prestianni,ar ARG,"MF,FW",Benfica,,19.25753425,2006,3.2,3,2,1,0,2,2,7,28.6,5,5,0,5,0,3,2,0
418,Diogo Prioste,pt POR,MF,Benfica,,21.10958904,2004,0.1,0,0,0,0,0,0,0,,0,0,0,0,0,0,0,0
419,Miguel Puche García,es ESP,"FW,MF",Arouca,,24.01369863,2001,4.1,7,5,4,2,1,5,11,45.5,6,6,1,5,7,14,5,0
420,Quaresma,br BRA,DF,Arouca,,28.70136986,1996,0.9,2,1,1,1,0,0,0,,0,0,0,0,2,4,1,0
421,Eduardo Quaresma,pt POR,DF,Sporting CP,,23.17534247,2002,13.6,39,21,17,19,3,27,32,84.4,5,15,4,11,10,49,33,3
422,Geovany Quenda,pt POR,"MF,DF",Sporting CP,,18.01369863,2007,24.7,22,14,10,8,4,13,29,44.8,16,21,1,20,11,33,21,0
423,Uroš Račić,rs SRB,MF,Braga,,27.13424658,1998,6.5,15,13,6,8,1,7,12,58.3,5,10,2,8,6,21,16,0
424,Rafinha,pt POR,MF,Farense,,19.29315068,2006,0,0,0,0,0,0,0,0,,0,0,0,0,0,0,0,0
425,Jesús Ramírez,ve VEN,FW,Vitória,,27.00273973,1998,7.3,3,3,1,0,2,0,2,0,2,0,0,0,0,3,4,0
426,Cláudio Ramos,pt POR,GK,Porto,,33.46575342,1991,2,0,0,0,0,0,0,0,,0,0,0,0,0,0,0,0
427,Guilherme Ramos,pt POR,DF,Santa Clara,,27.73150685,1997,2.7,2,0,0,1,1,1,2,50,1,1,1,0,1,3,17,0
428,Leonardo Realpe,ec ECU,DF,Famalicão,,24.18630137,2001,3,7,3,7,0,0,4,5,80,1,2,1,1,6,13,22,0
429,João Rêgo,pt POR,FW,Benfica,,19.8739726,2005,0.2,2,0,0,2,0,1,3,33.3,2,0,0,0,0,2,0,0
430,Francisco Reis Ferreira,pt POR,DF,Estrela,,28.10958904,1997,15.2,44,26,31,13,0,28,38,73.7,10,14,4,10,24,68,91,4
431,Matheus Reis,br BRA,DF,Sporting CP,,30.20821918,1995,14.5,18,11,9,7,2,10,16,62.5,6,11,2,9,9,27,39,0
432,Tiago Reis,br BRA,FW,Nacional,,25.72328767,1999,2.6,1,0,1,0,0,0,0,,0,2,0,2,0,1,0,0
433,Miguel Reisinho,pt POR,"MF,FW",Boavista,,26.07123288,1999,22.1,48,22,16,25,7,26,39,66.7,13,24,5,19,30,78,31,2
434,Filipe Relvas,pt POR,DF,Vitória,,25.62191781,1999,8.4,12,7,11,1,0,7,8,87.5,1,7,3,4,12,24,62,0
435,Marco Ribeiro,pt POR,"MF,DF",Boavista,,19.89041096,2005,3.8,10,6,3,5,2,4,8,50,4,7,1,6,1,11,9,0
436,Rodrigo Ribeiro,pt POR,FW,Sporting CP,,20.01917808,2005,0,0,0,0,0,0,0,0,,0,0,0,0,0,0,0,0
437,Rodrigo Ribeiro,pt POR,FW,AVS Futebol,,20.01917808,2005,10.9,5,2,0,4,1,1,3,33.3,2,11,2,9,5,10,19,0
438,Tomás Ribeiro,pt POR,DF,Vitória,,26.01369863,1999,3.5,6,4,4,2,0,4,6,66.7,2,7,5,2,6,12,15,0
439,Tomás Ribeiro,pt POR,DF,Farense,,26.01369863,1999,7.2,13,8,12,1,0,7,13,53.8,6,10,8,2,5,18,50,0
440,Yuri Ribeiro,pt POR,"DF,MF",Braga,,28.27671233,1997,5.1,3,2,2,1,0,3,5,60,2,5,1,4,1,4,15,0
441,Ricardinho,pt POR,"FW,MF",Santa Clara,,26.74520548,1998,13.2,15,11,6,5,4,4,22,18.2,18,16,1,15,11,26,11,1
442,Riccieli,br BRA,DF,Famalicão,,26.63013699,1998,6.5,4,3,4,0,0,4,5,80,1,5,3,2,6,10,24,0
443,Omar Richards,eng ENG,DF,Rio Ave,,27.21643836,1998,21.1,61,36,41,17,3,33,47,70.2,14,31,8,23,18,79,80,3
444,Rivaldo,,"DF,MF",Farense,,24.62739726,2000,5,15,9,6,8,1,6,10,60,4,7,3,4,7,22,20,0
445,Óscar Rivas,es ESP,DF,Vitória,,25.10684932,2000,8.9,9,6,6,2,1,7,13,53.8,6,6,6,0,13,22,47,0
446,Pablo Roberto,br BRA,"MF,FW",Casa Pia,,25.47123288,1999,11.5,15,9,4,9,2,8,16,50,8,12,2,10,8,23,6,2
447,Joel Robles,es ESP,GK,Estoril,,34.88219178,1990,28,1,0,1,0,0,1,2,50,1,1,0,1,0,1,23,3
448,Matí­as Rocha,uy URU,DF,Arouca,,24.22191781,2001,3.2,4,3,3,1,0,3,3,100,0,3,1,2,2,6,17,0
449,Rochinha,pt POR,FW,Famalicão,,30.00547945,1995,10,10,8,7,2,1,8,13,61.5,5,2,1,1,5,15,3,0
450,Afonso Rodrigues,pt POR,"MF,FW",Famalicão,,22.70958904,2002,0.1,0,0,0,0,0,0,0,,0,1,0,1,0,0,0,0
451,Diego Rodrigues,pt POR,MF,Braga,,19.94794521,2005,1.8,5,3,1,3,1,2,6,33.3,4,1,0,1,1,6,0,0
452,Gerson Rodrigues,lu LUX,FW,AVS Futebol,,29.8739726,1995,2.1,2,0,0,1,1,2,2,100,0,0,0,0,1,3,2,0
453,Ivo Rodrigues,pt POR,"MF,FW",Arouca,,30.09863014,1995,7.1,17,11,9,7,1,10,17,58.8,7,10,1,9,6,23,10,0
454,Ivo Rodrigues,pt POR,"MF,FW",Moreirense,,30.09863014,1995,6.4,12,6,6,5,1,6,12,50,6,11,4,7,6,18,10,0
455,Luís Carlos Rocha Rodrigues,pt POR,DF,Santa Clara,,38.7260274,1986,27.6,30,16,20,10,0,13,28,46.4,15,20,17,3,17,47,141,2
456,Rafael Rodrigues,pt POR,"DF,MF",AVS Futebol,,23.18356164,2002,10.6,26,12,18,6,2,13,22,59.1,9,11,1,10,19,45,42,0
457,Ignacio Rodríguez,uy URU,DF,AVS Futebol,,21.48219178,2003,13.2,18,15,11,6,1,12,24,50,12,11,5,6,19,37,95,3
458,Benjamín Rollheiser,ar ARG,"MF,FW",Benfica,,25.11506849,2000,1.5,4,4,0,3,1,2,4,50,2,1,0,1,0,4,0,0
459,Baptiste Roux,fr FRA,"DF,MF",AVS Futebol,,25.43835616,1999,18.2,33,18,21,10,2,20,38,52.6,18,25,12,13,22,55,78,0
460,Alan Ruiz,ar ARG,"MF,FW",Estrela,,31.70958904,1993,15.3,31,19,8,20,3,10,26,38.5,16,16,2,14,1,32,27,2
461,Gustavo sá,pt POR,MF,Famalicão,,20.47945205,2004,26,39,25,19,11,9,11,46,23.9,35,22,3,19,12,51,23,2
462,Josué Sá,pt POR,DF,Gil Vicente FC,,32.88219178,1992,14.3,15,11,9,6,0,13,20,65,7,18,13,5,5,20,59,1
463,Safira,br BRA,FW,Santa Clara,,30.13424658,1995,11,8,3,1,3,4,2,8,25,6,6,1,5,3,11,12,0
464,Sala,es ESP,"FW,MF",Estoril,,21.98630137,2003,1.7,1,1,0,1,0,0,6,0,6,1,0,1,1,2,4,0
465,Samu,pt POR,MF,Vitória,,29.03835616,1996,19.4,50,30,14,24,12,19,33,57.6,14,35,5,30,2,52,14,0
466,Renato Sanches,pt POR,MF,Benfica,,27.71232877,1997,2.2,2,2,0,2,0,2,2,100,0,1,0,1,1,3,0,0
467,Caio Santana,br BRA,"FW,MF",Estrela,,21.12054795,2004,2,11,7,6,5,0,7,11,63.6,4,4,0,4,1,12,3,0
468,Aderlan Santos,br BRA,DF,AVS Futebol,,36.07123288,1989,6.5,7,6,5,2,0,2,5,40,3,13,9,4,4,11,59,2
469,Aderlan Santos,br BRA,DF,Rio Ave,,36.07123288,1989,17.6,35,19,23,12,0,21,28,75,7,17,11,6,23,58,138,0
470,Bruno Santos,pt POR,FW,Farense,,22.05205479,2003,0.6,1,0,0,1,0,0,1,0,1,0,0,0,1,2,0,0
471,Gabriel Santos,br BRA,"FW,MF",Nacional,,26.1369863,1999,1,2,1,1,0,1,0,1,0,1,1,0,1,0,2,0,0
472,Hevertton Santos,br BRA,DF,Vitória,,24.25479452,2001,2.8,7,4,3,4,0,5,11,45.5,6,5,1,4,0,7,12,0
473,Leandro Santos,pt POR,"DF,MF",Benfica,,19.6,2005,2.9,7,4,4,3,0,5,7,71.4,2,2,1,1,2,9,5,1
474,Léo Santos,br BRA,DF,Nacional,,26.40273973,1998,6.6,6,4,5,0,1,5,6,83.3,1,6,4,2,8,14,52,1
475,Nuno Santos,pt POR,"MF,DF",Sporting CP,,30.22191781,1995,3.9,4,0,1,1,2,2,4,50,2,5,0,5,4,8,4,0
476,Nuno Santos,pt POR,"FW,MF",Vitória,,26.17534247,1999,19.7,22,14,7,6,9,8,24,33.3,16,20,0,20,16,38,23,1
477,Pedro Santos,pt POR,MF,Arouca,,24.56164384,2000,15,29,26,11,14,4,20,39,51.3,19,9,3,6,20,49,14,2
478,Pedro Santos,pt POR,"FW,MF",Moreirense,,22.23013699,2003,6.2,11,6,4,6,1,4,16,25,12,5,2,3,3,14,4,2
479,Zaidu Sanusi,ng NGA,DF,Porto,,27.89315068,1997,0.6,0,0,0,0,0,0,0,,0,0,0,0,0,0,2,0
480,Guilherme Schettine,br BRA,FW,Moreirense,,29.56712329,1995,17.2,9,5,2,4,3,4,10,40,6,10,2,8,1,10,20,0
481,Andreas Schjelderup,no NOR,"FW,MF",Benfica,,20.9260274,2004,4.7,3,2,1,1,1,2,11,18.2,9,4,0,4,0,3,3,0
482,Caio Secco,br BRA,GK,Moreirense,,34.36712329,1990,3,0,0,0,0,0,0,0,,0,0,0,0,0,0,1,0
483,Telasco Segovia,ve VEN,MF,Casa Pia,,22.09041096,2003,10.1,28,17,8,14,6,13,31,41.9,18,10,3,7,8,36,14,1
484,Václav Sejk,cz CZE,FW,Famalicão,,22.96438356,2002,9,3,3,0,2,1,2,8,25,6,7,1,6,0,3,8,0
485,Patrick Sequeira,cr CRC,GK,Casa Pia,,26.17808219,1999,31,0,0,0,0,0,0,1,0,1,1,0,1,0,0,24,4
486,Serginho,pt POR,MF,Santa Clara,,25.42465753,1999,12.9,15,9,7,7,1,10,20,50,10,20,2,18,12,27,15,0
487,Guilherme Serrão,pt POR,"MF,DF",Estrela,,21.63835616,2003,6.5,18,12,9,9,0,9,17,52.9,8,5,1,4,11,29,17,0
488,André Seruca,pt POR,"MF,DF",Farense,,24.51506849,2000,0.2,0,0,0,0,0,0,1,0,1,0,0,0,0,0,1,0
489,Naziru Shuabiu,ng NGA,FW,Rio Ave,,21.23013699,2004,0,0,0,0,0,0,0,1,0,1,0,0,0,0,0,0,0
490,Sidney,br BRA,DF,Santa Clara,,28.29589041,1997,25.6,40,25,24,12,4,21,34,61.8,13,33,14,19,41,81,108,1
491,Alysson Silva,br BRA,DF,Santa Clara,,22.60547945,2002,1.8,3,3,2,1,0,1,1,100,0,0,0,0,0,3,2,0
492,António Silva,pt POR,DF,Benfica,,21.51232877,2003,20.6,31,15,20,9,2,18,24,75,6,18,10,8,20,51,86,2
493,Gustavo da Silva,br BRA,FW,Vitória,,25.9260274,1999,8.4,6,3,4,0,2,5,8,62.5,3,12,2,10,4,10,15,0
494,Joel silva,pt POR,"MF,DF",Boavista,,22.22739726,2003,23.6,66,37,29,31,6,38,90,42.2,52,35,7,28,32,98,46,0
495,José Silva,pt POR,DF,Sporting CP,,19.70684932,2005,0.1,1,1,0,1,0,0,1,0,1,0,0,0,0,1,0,0
496,Luís Manuel Costa Silva,pt POR,MF,AVS Futebol,,32.59726027,1992,5.2,9,6,5,2,2,4,6,66.7,2,4,2,2,3,12,9,0
497,Raul Silva,br BRA,DF,Farense,,35.49863014,1989,5.2,7,4,3,3,1,3,4,75,1,7,3,4,5,12,23,0
498,Rui Silva,pt POR,GK,Sporting CP,,31.23835616,1994,15,0,0,0,0,0,0,0,,0,0,0,0,0,0,5,0
499,Tiago Silva,pt POR,MF,Vitória,,31.92328767,1993,24.8,42,24,18,20,4,12,26,46.2,14,19,5,14,25,67,29,4
500,Tomás Silva,pt POR,"DF,MF",Boavista,,18.94520548,2006,1,0,0,0,0,0,0,1,0,1,1,0,1,1,1,3,0
501,David Simão,pt POR,MF,Arouca,,34.97260274,1990,19.7,41,30,13,20,8,24,50,48,26,19,3,16,25,66,24,1
502,João Simões,pt POR,MF,Sporting CP,,18.3260274,2007,4.4,7,4,2,3,2,3,4,75,1,7,1,6,4,11,6,1
503,Sphephelo Sithole,za RSA,"FW,MF",Gil Vicente FC,,26.17260274,1999,0.6,2,2,2,0,0,2,3,66.7,1,1,1,0,0,2,1,0
504,Filipe Soares,pt POR,MF,Farense,,25.95890411,1999,6.5,10,7,3,6,1,3,9,33.3,6,9,3,6,6,16,5,0
505,Lucas Soares,br BRA,"MF,DF",Santa Clara,,27.00273973,1998,16.4,28,19,13,14,1,13,34,38.2,21,17,3,14,15,43,57,0
506,Rafa Soares,pt POR,DF,Famalicão,,29.9890411,1995,21.9,40,28,24,11,5,26,41,63.4,15,21,2,19,17,57,72,2
507,Samuel Soares,pt POR,GK,Benfica,,22.88767123,2002,2,0,0,0,0,0,0,0,,0,0,0,0,0,0,0,0
508,Alexandre Sola,ad AND,MF,Estrela,,21.3890411,2003,0.2,0,0,0,0,0,0,0,,0,1,1,0,0,0,2,0
509,Djibril Soumaré,sn SEN,MF,Nacional,,22.32328767,2003,19.4,60,40,29,27,4,20,36,55.6,16,25,7,18,17,77,41,1
510,André Sousa,pt POR,MF,Nacional,,34.82191781,1990,1.2,2,1,1,0,1,0,3,0,3,6,2,4,1,3,2,0
511,Dyego Sousa,pt POR,FW,Nacional,,35.63835616,1989,1.4,0,0,0,0,0,0,0,,0,0,0,0,0,0,3,0
512,Gerson Sousa,pt POR,"FW,MF",Estrela,,22.98630137,2002,0.7,1,0,1,0,0,1,2,50,1,1,0,1,0,1,2,0
513,Miguel Sousa,pt POR,"MF,FW",Casa Pia,,26.62465753,1998,11.7,25,12,11,11,3,9,17,52.9,8,19,3,16,11,36,16,0
514,Valentim Sousa,pt POR,FW,Rio Ave,,20.21917808,2005,0.9,2,1,0,2,0,1,2,50,1,0,0,0,1,3,1,0
515,Vasco Sousa,pt POR,MF,Porto,,22.08767123,2003,4.3,16,9,7,8,1,10,14,71.4,4,3,0,3,2,18,2,1
516,Fabiano Souza,br BRA,DF,Moreirense,,25.14246575,2000,7.8,12,9,8,3,1,9,12,75,3,8,2,6,12,24,26,2
517,Gabriel Airton de Souza,br BRA,"FW,MF",Moreirense,,29.10136986,1996,10.1,17,10,5,11,1,5,12,41.7,7,9,1,8,3,20,4,0
518,Jerry St. Juste,nl NED,DF,Sporting CP,,28.54246575,1996,5.6,12,9,9,3,0,8,8,100,0,8,4,4,4,16,26,0
519,Max Svensson,es ESP,"FW,MF",Casa Pia,,0,,9.4,11,10,3,5,3,8,16,50,8,9,0,9,4,15,0,0
520,Morlaye Sylla,gn GUI,"FW,MF",Arouca,,26.77260274,1998,25.3,30,22,12,12,6,9,31,29,22,32,2,30,11,41,14,0
521,Sidnei Tavares,pt POR,MF,Moreirense,,23.59726027,2001,14.4,28,16,16,10,2,12,27,44.4,15,12,6,6,17,45,19,0
522,Tomás Tavares,pt POR,DF,AVS Futebol,,24.16164384,2001,8.8,24,14,14,9,1,12,22,54.5,10,9,0,9,13,37,20,1
523,Duplexe Tchamba,cm CMR,DF,Casa Pia,,26.81917808,1998,18.2,27,16,22,4,1,18,31,58.1,13,21,13,8,26,53,100,1
524,Cédric Teguia,es ESP,FW,Moreirense,,23.59178082,2001,8.3,13,6,3,5,5,6,11,54.5,5,16,1,15,7,20,8,0
525,João Teixeira,pt POR,MF,Gil Vicente FC,,31.24109589,1994,3.5,16,10,2,9,5,4,11,36.4,7,4,0,4,4,20,3,0
526,Jorge Teixeira,pt POR,DF,AVS Futebol,,38.68767123,1986,7.9,7,5,7,0,0,3,6,50,3,6,4,2,4,11,40,0
527,Nigel Thomas,nl NED,"FW,MF",Nacional,,24.25479452,2001,7,8,3,4,3,1,5,15,33.3,10,6,1,5,2,10,8,0
528,Demir Tıknaz,tr TUR,MF,Rio Ave,,20.71506849,2004,20.1,57,37,25,29,3,35,58,60.3,23,32,12,20,43,100,48,2
529,Tomané,pt POR,FW,Farense,,32.53150685,1992,18.3,14,8,2,8,4,3,8,37.5,5,18,2,16,1,15,23,0
530,Tomé,pt POR,GK,Boavista,,18.38356164,2006,2,0,0,0,0,0,0,0,,0,0,0,0,0,0,2,0
531,João Tomé,pt POR,"DF,MF",Rio Ave,,22.22465753,2003,6.6,18,13,13,5,0,11,15,73.3,4,5,2,3,7,25,32,0
532,Mirko Topić,rs SRB,MF,Famalicão,,24.24383562,2001,25.3,57,40,22,28,7,23,41,56.1,18,26,5,21,40,97,57,2
533,Diogo Travassos,pt POR,"MF,DF",Estrela,,21.09589041,2004,17.2,29,18,13,11,5,12,27,44.4,15,27,7,20,16,45,36,0
534,Alfonso Trezza,uy URU,"FW,MF",Arouca,,25.86849315,1999,25.9,45,30,20,16,9,17,48,35.4,31,33,2,31,14,59,26,0
535,Francisco Trincão,pt POR,"MF,FW",Sporting CP,,25.34794521,1999,30.8,51,29,13,26,12,16,32,50,16,27,2,25,12,63,29,1
536,Anatolii Trubin,ua UKR,GK,Benfica,,23.75890411,2001,30,0,0,0,0,0,0,2,0,2,1,0,1,0,0,9,1
537,Ulisses,br BRA,DF,Nacional,,25.6,1999,28.4,50,33,37,11,2,30,38,78.9,8,46,31,15,36,86,127,4
538,Tomáš Vaclík,cz CZE,GK,Boavista,,36.10136986,1989,9,0,0,0,0,0,0,0,,0,1,0,1,0,0,3,1
539,João Valido,pt POR,GK,Arouca,,25.17260274,2000,3,0,0,0,0,0,0,0,,0,0,0,0,0,0,2,0
540,Alan Varela,ar ARG,MF,Porto,,23.83561644,2001,23.3,40,20,11,25,4,22,41,53.7,19,17,3,14,19,59,28,0
541,Bruno Varela,cv CPV,GK,Vitória,,30.49863014,1994,32,1,0,1,0,0,1,1,100,0,0,0,0,0,1,17,3
542,Nilton Varela,pt POR,"DF,MF",Estrela,,23.94520548,2001,22.5,38,24,24,11,3,24,33,72.7,9,27,3,24,19,57,71,1
543,João Vasconcelos,pt POR,MF,Braga,,20.18630137,2005,0,0,0,0,0,0,0,0,,0,0,0,0,0,0,0,0
544,Danilo Veiga,pt POR,"DF,MF",Estrela,,22.60821918,2002,14.2,28,19,13,9,6,15,25,60,10,20,5,15,17,45,55,2
545,Eric Veiga,lu LUX,"DF,MF",AVS Futebol,,28.20821918,1997,3.3,3,2,2,1,0,1,4,25,3,4,3,1,1,4,4,0
546,Jhon Velásquez,co COL,"FW,MF",Farense,,30.00821918,1995,0.2,0,0,0,0,0,0,0,,0,1,0,1,0,0,0,0
547,Ricardo Velho,pt POR,GK,Farense,,26.70684932,1998,28,0,0,0,0,0,0,1,0,1,1,0,1,0,0,15,2
548,Frederico Venâncio,pt POR,DF,Santa Clara,,32.24657534,1993,19.1,29,14,16,10,3,12,19,63.2,7,10,5,5,26,55,101,1
549,Paulo Victor,br BRA,"DF,MF",Farense,,24.06027397,2001,16,54,36,33,15,6,39,57,68.4,18,25,4,21,25,79,63,0
550,Fabio Vieira,pt POR,"MF,FW",Porto,,24.93150685,2000,18.2,36,23,11,18,7,17,26,65.4,9,14,3,11,10,46,12,0
551,Gabriel Vieira,br BRA,FW,Santa Clara,,23.12054795,2002,29.7,28,19,6,15,7,9,26,34.6,17,17,0,17,6,34,8,0
552,Mikel Villanueva,ve VEN,DF,Vitória,,32.05753425,1993,13.9,21,13,14,5,2,13,20,65,7,5,2,3,12,33,60,1
553,Marcos Vinicios Sorriso,br BRA,"FW,MF",Famalicão,,24.19452055,2001,20.9,31,16,13,11,7,12,32,37.5,20,30,6,24,18,49,18,0
554,Vinícius,br BRA,"FW,MF",Santa Clara,,25.99452055,1999,23.2,35,19,13,16,6,15,35,42.9,20,34,3,31,10,45,24,0
555,Bernardo Vital,pt POR,MF,Estoril,,24.34794521,2000,0.3,2,2,1,0,1,1,2,50,1,2,1,1,0,2,0,0
556,Zé Vitor,br BRA,DF,Nacional,,24.23287671,2001,28.7,44,34,30,14,0,26,41,63.4,15,37,25,12,36,80,207,9
557,Steven Vitória,ca CAN,DF,Boavista,,38.31232877,1987,2.3,1,1,1,0,0,1,1,100,0,3,2,1,1,2,19,0
558,Marious Vrousai,gr GRE,"DF,MF",Rio Ave,,26.84109589,1998,27.3,69,44,44,18,7,39,79,49.4,40,37,5,32,36,105,94,2
559,Ilija Vukotić,me MNE,MF,Boavista,,26.32328767,1999,19.5,38,19,10,22,6,15,37,40.5,22,22,8,14,17,55,27,1
560,Wendel,br BRA,FW,Santa Clara,,24.75616438,2000,0.9,0,0,0,0,0,0,0,,0,0,0,0,0,0,1,0
561,Wendell,br BRA,DF,Porto,,31.79178082,1993,0.3,0,0,0,0,0,0,0,,0,0,0,0,0,0,0,0
562,Weverson,br BRA,DF,Arouca,,24.83287671,2000,18.9,37,22,18,17,2,18,29,62.1,11,20,5,15,20,57,70,2
563,Xeka,pt POR,MF,Estoril,,30.48219178,1994,10.4,29,16,6,19,4,15,24,62.5,9,10,2,8,14,43,16,0
564,Güven Yalçın,tr TUR,FW,Arouca,,26.29315068,1999,8.3,10,7,2,3,5,0,4,0,4,3,0,3,3,13,7,0
565,Fūki Yamada,jp JPN,"FW,MF",Nacional,,23.81917808,2001,5,5,4,1,4,0,5,8,62.5,3,5,0,5,0,5,6,0
566,Zaydou Youssouf,km COM,MF,Famalicão,,25.81643836,1999,14.8,35,21,19,14,2,17,30,56.7,13,12,3,9,16,51,12,0
567,Yassir Zabiri,ma MAR,"FW,MF",Famalicão,,20.19452055,2005,0.6,2,1,0,2,0,1,2,50,1,1,0,1,0,2,0,0
568,Rodrigo Zalazar,uy URU,"MF,FW",Braga,,25.72876712,1999,13.7,32,16,10,14,8,10,24,41.7,14,21,0,21,5,37,11,0
569,Vinícius Zanocelo,br BRA,MF,Estoril,,24.26027397,2001,21.3,53,26,21,28,4,33,58,56.9,25,26,8,18,16,69,49,0
570,Ivan Zlobin,ru RUS,GK,Famalicão,,28.16164384,1997,13,0,0,0,0,0,0,0,,0,0,0,0,0,0,9,0
571,Karem Zoabi,il ISR,"FW,MF",Rio Ave,,19.00547945,2006,2.5,3,2,1,2,0,2,5,40,3,2,0,2,0,3,1,0
572,Nermin Zolotić,ba BIH,DF,Casa Pia,,31.82739726,1993,7,15,9,12,3,0,9,10,90,1,9,6,3,5,20,20,1
1,Liel Abada,il ISR,"FW,MF",Charlotte,,23.58630137,2001,7.3,11,5,2,7,2,6,18,33.3,12,4,0,4,4,15,7,0
2,Luis Abram,pe PER,DF,Atlanta Utd,,29.18356164,1996,6.8,5,2,4,1,0,4,8,50,4,5,2,3,1,6,32,0
3,Lalas Abubakar,gh GHA,DF,FC Dallas,,30.35890411,1994,2,5,4,2,2,1,3,4,75,1,2,1,1,5,10,16,0
4,Kellyn Acosta,us USA,MF,Chicago Fire,,29.78082192,1995,4.3,4,2,2,2,0,2,4,50,2,3,0,3,5,9,6,0
5,Luciano Acosta,ar ARG,MF,FC Dallas,,30.92876712,1994,10.2,15,12,3,6,6,6,18,33.3,12,8,0,8,3,18,10,0
6,Sam Adekugbe,ca CAN,DF,Vancouver W'caps,,30.29863014,1995,1.9,1,1,0,1,0,1,1,100,0,1,0,1,3,4,4,0
7,Leonardo Afonso,br BRA,FW,Inter Miami,,23.8109589,2001,0.8,2,0,0,1,1,0,0,,0,1,0,1,0,2,1,0
8,Stephen Afrifa,ca CAN,"FW,MF",Sporting KC,,24.20547945,2001,0.1,0,0,0,0,0,0,0,,0,0,0,0,0,0,1,0
9,William Agada,ng NGA,FW,Sporting KC,,25.63013699,1999,1.1,0,0,0,0,0,0,1,0,1,0,0,0,0,0,1,0
10,William Agada,ng NGA,FW,Real Salt Lake,,25.63013699,1999,0.8,1,0,0,1,0,0,0,,0,1,1,0,0,1,2,0
11,Patrick Agyemang,us USA,FW,Charlotte,,24.49041096,2000,8.6,3,2,0,3,0,1,4,25,3,4,0,4,1,4,13,0
12,Ali Ahmed,ca CAN,FW,Vancouver W'caps,,24.56712329,2000,5.9,8,7,2,2,4,4,7,57.1,3,12,0,12,1,9,7,0
13,Forster Ajago,gh GHA,FW,Real Salt Lake,,23.71780822,2001,2.9,5,3,2,2,1,1,2,50,1,2,0,2,0,5,3,0
14,Jordi Alba,es ESP,DF,Inter Miami,,36.12328767,1989,8.4,6,5,2,4,0,2,5,40,3,10,4,6,5,11,15,1
15,Noah Allen,us USA,DF,Inter Miami,,21.01917808,2004,7.3,15,11,11,4,0,6,9,66.7,3,9,0,9,6,21,26,0
16,Tadeo Allende,ar ARG,"FW,MF",Inter Miami,,26.20273973,1999,4.5,2,1,1,0,1,2,4,50,2,2,1,1,1,3,6,0
17,Miguel Almirón,py PAR,"FW,MF",Atlanta Utd,,31.23013699,1994,9.9,14,8,3,9,2,2,6,33.3,4,7,0,7,3,17,0,1
18,Alejandro Alvarado Jr.,us USA,MF,San Diego FC,,21.76712329,2003,2.1,8,4,3,3,2,4,8,50,4,2,0,2,5,13,0,0
19,Fernando Álvarez,co COL,DF,CF Montréal,,21.69589041,2003,4.6,8,5,2,3,3,4,6,66.7,2,6,1,5,6,14,23,2
20,Pedro Amador,pt POR,DF,Atlanta Utd,,26.37808219,1998,6.7,6,1,2,4,0,4,7,57.1,3,8,3,5,6,12,19,0
21,Frankie Amaya,us USA,MF,LAFC,,24.60547945,2000,0.2,1,1,1,0,0,1,1,100,0,0,0,0,1,2,1,0
22,Malte Amundsen,dk DEN,DF,Columbus Crew,,27.22739726,1998,7.2,12,9,6,4,2,4,5,80,1,13,7,6,7,19,31,0
23,Tomas Ángel,co COL,"FW,MF",San Diego FC,,22.20273973,2003,3.3,1,0,0,0,1,1,4,25,3,0,0,0,1,2,1,0
24,Iván Angulo,co COL,"FW,MF",Orlando City,,26.12054795,1999,9.4,17,10,9,7,1,7,16,43.8,9,16,2,14,6,23,5,1
25,Conner Antley,us USA,"DF,MF",D.C. United,,30.12054795,1995,0.8,0,0,0,0,0,0,1,0,1,1,0,1,3,3,4,0
26,Antony,br BRA,"FW,MF",Portland Timbers,,23.65479452,2001,9.9,24,13,9,5,10,9,20,45,11,12,1,11,6,30,12,0
27,Brian Anunga,cm CMR,MF,FC Cincinnati,,28.73424658,1996,7,16,11,7,8,1,5,8,62.5,3,19,8,11,5,21,5,1
28,Chris Applewhite,us USA,DF,Nashville SC,,17.69863014,2007,0.2,0,0,0,0,0,0,0,,0,1,0,1,0,0,1,0
29,Cristian Arango,co COL,"MF,FW",SJ Earthquakes,,30.15616438,1995,10.8,13,8,1,8,4,8,16,50,8,8,0,8,5,18,8,0
30,César Araujo,uy URU,MF,Orlando City,,24.09041096,2001,6,13,9,4,6,3,6,10,60,4,7,1,6,5,18,10,0
31,Maximilian Arfsten,us USA,"MF,DF",Columbus Crew,,24.04383562,2001,10,24,13,5,13,6,12,23,52.2,11,10,0,10,9,33,15,0
32,Daniel Armando Ríos,mx MEX,FW,Vancouver W'caps,,30.19726027,1995,4.6,0,0,0,0,0,0,1,0,1,0,0,0,2,2,8,0
33,Paul Arriola,us USA,"FW,DF",Seattle Sounders,,30.24383562,1995,0.8,0,0,0,0,0,0,1,0,1,1,0,1,0,0,0,0
34,Artur,br BRA,MF,Houston Dynamo,,29.15068493,1996,11,25,13,12,9,4,10,20,50,10,8,1,7,19,44,14,2
35,Joshua Atencio,us USA,MF,Colorado Rapids,,23.25753425,2002,8.4,22,9,6,13,3,14,23,60.9,9,14,0,14,13,35,8,0
36,Eduard Atuesta,co COL,MF,Orlando City,,27.87945205,1997,6.8,12,7,7,2,3,5,14,35.7,9,9,2,7,6,18,10,0
37,Julián Aude,ar ARG,DF,LA Galaxy,,22.11506849,2003,5.6,12,4,6,5,1,8,16,50,8,8,1,7,5,17,18,0
38,Tomás Avilés,ar ARG,"DF,MF",Inter Miami,,21.24931507,2004,4.6,11,5,4,5,2,8,11,72.7,3,9,5,4,7,18,12,1
39,Chidozie Awaziem,ng NGA,DF,Colorado Rapids,,28.33972603,1997,10.7,13,8,10,2,1,8,11,72.7,3,10,3,7,12,25,54,0
40,Obafemi Awodesu,us USA,DF,Houston Dynamo,,24.08219178,2001,11,9,4,8,1,0,6,8,75,2,14,4,10,9,18,83,0
41,David Ayala,ar ARG,MF,Portland Timbers,,22.77534247,2002,9.5,30,20,16,9,5,15,20,75,5,15,3,12,14,44,16,0
42,Dominique Badji,sn SEN,"FW,MF",D.C. United,,32.55068493,1992,3.6,2,2,0,1,1,1,1,100,0,0,0,0,0,2,4,0
43,Jeevan Badwal,ca CAN,"MF,FW",Vancouver W'caps,,19.15068493,2006,1.4,4,4,2,2,0,2,3,66.7,1,0,0,0,3,7,0,0
44,Corey Baird,us USA,"FW,MF",FC Cincinnati,,29.26027397,1996,3.3,5,4,2,3,0,2,6,33.3,4,2,0,2,1,6,3,0
45,Cody Baker,us USA,MF,Seattle Sounders,,21.32328767,2004,0.2,1,1,1,0,0,1,1,100,0,1,0,1,0,1,1,0
46,Reed Baker-Whiting,us USA,"FW,MF",Seattle Sounders,,20.09589041,2005,0.3,0,0,0,0,0,0,1,0,1,2,0,2,0,0,2,0
47,Monsef Bakrar,dz ALG,"FW,MF",NYCFC,,24.30684932,2001,3.2,6,4,2,3,1,5,10,50,5,3,0,3,3,9,9,0
48,Jonathan Bamba,ci CIV,FW,Chicago Fire,,29.10958904,1996,9.6,7,3,3,2,2,4,10,40,6,6,1,5,8,15,6,0
49,Fidel Barajas,mx MEX,FW,D.C. United,,19.08219178,2006,0.2,1,1,0,0,1,0,0,,0,0,0,0,0,1,0,0
50,Jesús Barea,es ESP,FW,Real Salt Lake,,23.01917808,2002,2,2,2,0,1,1,1,1,100,0,2,1,1,0,2,1,0
51,Tai Baribo,il ISR,FW,Philadelphia Union,,27.30136986,1998,7.9,7,4,0,7,0,1,2,50,1,11,0,11,5,12,4,0
52,Tom Barlow,us USA,"FW,MF",Chicago Fire,,29.82465753,1995,2.1,0,0,0,0,0,0,0,,0,2,1,1,1,1,3,0
53,Luis Barraza,us USA,GK,D.C. United,,28.48767123,1996,4,0,0,0,0,0,0,0,,0,0,0,0,0,0,6,0
54,Leonardo Barroso,pt POR,DF,Chicago Fire,,19.89589041,2005,3,6,5,3,2,1,2,4,50,2,2,0,2,2,8,9,0
55,Jacob Bartlett,us USA,MF,Sporting KC,,19.57534247,2005,6.5,11,4,4,7,0,3,6,50,3,7,3,4,13,24,14,0
56,Lucas Bartlett,us USA,DF,D.C. United,,27.77534247,1997,10,14,8,10,4,0,10,10,100,0,10,7,3,16,30,60,1
57,Ethan Bartlow,us USA,DF,Houston Dynamo,,25.25205479,2000,4.3,7,5,4,1,2,4,4,100,0,4,0,4,1,8,28,1
58,Cole Bassett,us USA,"MF,FW",Colorado Rapids,,23.76986301,2001,9.4,14,7,5,5,4,7,17,41.2,10,12,2,10,1,15,12,0
59,Sam Bassett,us USA,MF,Colorado Rapids,,22.06027397,2003,0.1,0,0,0,0,0,0,1,0,1,0,0,0,1,1,0,0
60,Amine Bassi,fr FRA,"MF,FW",Houston Dynamo,,27.43561644,1997,10,11,8,3,7,1,3,10,30,7,5,0,5,7,18,1,0
61,Zorhan Bassong,ca CAN,MF,Sporting KC,,25.99452055,1999,3.5,7,4,3,4,0,2,4,50,2,5,1,4,4,11,7,0
62,Andy Batioja,co COL,FW,Houston Dynamo,,19.25753425,2006,0.1,0,0,0,0,0,0,0,,0,0,0,0,0,0,0,0
63,Josh Bauer,us USA,DF,Nashville SC,,26.78630137,1998,2.4,3,2,1,2,0,1,2,50,1,3,0,3,4,7,8,0
64,Timo Baumgartl,de GER,DF,St. Louis,,29.16986301,1996,4.2,8,5,7,1,0,3,3,100,0,8,5,3,2,10,23,0
65,Tanner Beason,us USA,DF,NE Revolution,,28.11780822,1997,4.6,9,7,4,4,1,5,8,62.5,3,12,10,2,5,14,38,0
66,Adam Beaudry,us USA,GK,Colorado Rapids,,19.04657534,2006,1,0,0,0,0,0,0,0,,0,0,0,0,0,0,0,0
67,Simon Becher,us USA,"FW,MF",St. Louis,,25.79178082,1999,5,1,1,1,0,0,1,2,50,1,6,1,5,3,4,7,0
68,Alejandro Bedoya,us USA,"MF,FW",Philadelphia Union,,38.01643836,1987,0.8,3,3,2,1,0,0,1,0,1,1,0,1,2,5,1,0
69,Jon Bell,jm JAM,DF,Seattle Sounders,,27.69041096,1997,4.1,1,1,0,1,0,0,0,,0,4,2,2,6,7,23,0
70,Ramiro Benetti,br BRA,MF,FC Dallas,,31.95342466,1993,10,26,12,7,13,6,10,26,38.5,16,18,1,17,19,45,21,0
71,Christian Benteke,be BEL,FW,D.C. United,,34.41917808,1990,9,4,2,0,3,1,2,3,66.7,1,8,1,7,1,5,10,1
72,Sebastian Berhalter,us USA,MF,Vancouver W'caps,,23.96712329,2001,8.4,31,17,15,10,6,11,14,78.6,3,9,1,8,13,44,16,0
73,Federico Bernardeschi,it ITA,"FW,MF",Toronto FC,,31.21369863,1994,10.8,10,7,4,5,1,2,6,33.3,4,5,1,4,2,12,7,1
74,Miguel Berry,es ESP,FW,LA Galaxy,,27.63287671,1997,3.8,1,1,0,1,0,0,0,,0,0,0,0,2,3,3,0
75,Pep Biel,es ESP,"FW,MF",Charlotte,,28.6630137,1996,8.5,4,3,1,2,1,2,7,28.6,5,7,0,7,6,10,4,0
76,Guilherme Biro,br BRA,DF,Austin,,25.0109589,2000,10.1,17,10,11,3,3,12,17,70.6,5,19,7,12,17,34,32,0
77,Tristan Blackmon,us USA,DF,Vancouver W'caps,,28.72876712,1996,9.1,7,1,3,3,1,3,3,100,0,10,6,4,16,23,51,2
78,Andre Blake,jm JAM,GK,Philadelphia Union,,34.45205479,1990,9,0,0,0,0,0,0,0,,0,0,0,0,0,0,3,2
79,Emmanuel Boateng,gh GHA,FW,San Diego FC,,31.29589041,1994,0.8,2,2,1,1,0,0,0,,0,0,0,0,0,2,0,0
80,Wiktor Bogacz,pl POL,"DF,FW",NY Red Bulls,,20.80821918,2004,0.5,0,0,0,0,0,0,0,,0,0,0,0,0,0,1,0
81,Luca Bombino,us USA,DF,San Diego FC,,18.81917808,2006,3.5,10,6,5,4,1,4,6,66.7,2,1,0,1,3,13,9,0
82,Jonathan Bond,eng ENG,GK,Houston Dynamo,,31.96164384,1993,3,0,0,0,0,0,0,0,,0,0,0,0,0,0,1,1
83,Denis Bouanga,ga GAB,FW,LAFC,,30.47945205,1994,9.4,6,3,1,3,2,3,11,27.3,8,4,0,4,1,7,4,0
84,Ousseni Bouda,bf BFA,"FW,MF",SJ Earthquakes,,25.01917808,2000,4.7,4,2,1,1,2,3,8,37.5,5,4,0,4,4,8,1,0
85,Giuseppe Bovalina,au AUS,DF,Vancouver W'caps,,20.47945205,2004,1.3,1,1,0,1,0,1,3,33.3,2,2,1,1,1,2,3,0
86,Michael Boxall,nz NZL,DF,Minnesota Utd,,36.71232877,1988,9,6,3,5,0,1,5,5,100,0,7,4,3,12,18,69,0
87,Christopher Brady,us USA,GK,Chicago Fire,,21.17260274,2004,10.4,0,0,0,0,0,0,1,0,1,0,0,0,0,0,9,1
88,Claudio Bravo,ar ARG,DF,Portland Timbers,,28.14520548,1997,1.4,5,4,2,3,0,2,4,50,2,6,0,6,1,6,8,0
89,David Brekalo,si SVN,DF,Orlando City,,26.41917808,1998,6.4,14,7,8,4,2,9,13,69.2,4,8,2,6,4,18,35,0
90,Luke Brennan,us USA,FW,Atlanta Utd,,20.19178082,2005,0,0,0,0,0,0,0,0,,0,0,0,0,0,0,0,0
91,Sebastian Breza,ca CAN,GK,CF Montréal,,27.13972603,1998,1,0,0,0,0,0,0,0,,0,0,0,0,0,0,0,0
92,Yannick Bright,it ITA,MF,Inter Miami,,23.66849315,2001,5.7,30,20,18,11,1,12,20,60,8,16,4,12,12,42,17,0
93,Andrew Brody,us USA,DF,Sporting KC,,30.00547945,1995,0.9,3,3,2,1,0,1,1,100,0,1,0,1,0,3,4,0
94,Brandt Bronico,us USA,MF,Charlotte,,29.8739726,1995,9.2,13,11,6,7,0,5,14,35.7,9,12,6,6,11,24,16,0
95,Lachlan Brook,au AUS,FW,Real Salt Lake,,24.23561644,2001,1.1,2,1,1,1,0,1,2,50,1,2,0,2,0,2,0,0
96,Javain Brown,jm JAM,DF,Real Salt Lake,,26.15616438,1999,2.2,6,4,2,3,1,2,3,66.7,1,0,0,0,1,7,8,0
97,Tristan Brown,us USA,DF,Columbus Crew,,17.54794521,2007,0.2,0,0,0,0,0,0,0,,0,0,0,0,0,0,1,0
98,Gastón Brugman,uy URU,MF,Nashville SC,,32.65753425,1992,4,9,4,6,3,0,3,10,30,7,8,1,7,10,19,5,1
99,Ola Brynhildsen,no NOR,"FW,MF",Toronto FC,,26.02191781,1999,2.7,2,2,0,1,1,0,1,0,1,1,1,0,0,2,2,0
100,Pavel Bucha,cz CZE,MF,FC Cincinnati,,27.15068493,1998,9.4,16,8,8,6,2,11,15,73.3,4,10,1,9,12,28,13,1
101,Noel Buck,eng ENG,"MF,DF",NE Revolution,,20.08219178,2005,0.3,1,1,1,0,0,0,1,0,1,3,0,3,0,1,1,0
102,Noel Buck,eng ENG,MF,SJ Earthquakes,,20.08219178,2005,0,0,0,0,0,0,0,0,,0,0,0,0,0,0,0,0
103,Dawid Bugaj,pl POL,DF,CF Montréal,,20.82191781,2004,2.5,5,2,4,1,0,2,5,40,3,0,0,0,3,8,2,0
104,Osman Bukari,gh GHA,"MF,FW",Austin,,26.39178082,1998,8.2,11,6,4,6,1,4,12,33.3,8,6,0,6,2,13,10,0
105,Teal Bunbury,us USA,"FW,MF",Nashville SC,,35.18356164,1990,0.6,1,1,1,0,0,1,1,100,0,0,0,0,0,1,0,0
106,Roman Bürki,ch SUI,GK,St. Louis,,34.47123288,1990,3,0,0,0,0,0,0,0,,0,0,0,0,0,0,2,0
107,Evan Bush,us USA,GK,Columbus Crew,,39.16438356,1986,1,0,0,0,0,0,0,0,,0,0,0,0,0,0,0,0
108,Sergio Busquets,es ESP,MF,Inter Miami,,36.80273973,1988,8.9,21,14,6,15,0,13,22,59.1,9,11,2,9,11,32,13,1
109,Brandon Bye,us USA,DF,NE Revolution,,29.43013699,1995,3.1,7,2,6,0,1,5,8,62.5,3,7,4,3,2,9,15,1
110,Nathan Byrne,eng ENG,DF,Charlotte,,32.91506849,1992,8,14,10,10,3,1,10,17,58.8,7,6,3,3,4,18,31,0
111,Kevin Cabral,fr FRA,"FW,MF",Colorado Rapids,,25.81917808,1999,6.3,9,5,1,3,5,3,7,42.9,4,9,1,8,3,12,4,0
112,Rafael Cabral,br BRA,GK,Real Salt Lake,,34.95890411,1990,11,1,1,1,0,0,1,2,50,1,0,0,0,0,1,6,0
113,Noel Caliskan,de GER,"DF,MF",Real Salt Lake,,24.68219178,2000,0.2,1,1,0,1,0,1,1,100,0,0,0,0,0,1,2,0
114,Drake Callender,us USA,GK,Inter Miami,,27.57534247,1997,2.1,0,0,0,0,0,0,0,,0,0,0,0,0,0,3,0
115,Leonardo Campana,ec ECU,FW,NE Revolution,,24.78082192,2000,4.9,7,5,2,4,1,2,8,25,6,8,1,7,1,8,9,0
116,George Campbell,us USA,DF,CF Montréal,,23.86849315,2001,8.9,18,13,10,8,0,8,10,80,2,11,7,4,13,31,41,2
117,Reggie Cannon,us USA,DF,Colorado Rapids,,26.89863014,1998,7.3,11,7,5,5,1,5,7,71.4,2,7,3,4,19,30,17,0
118,Gustavo Caraballo,us USA,"MF,FW",Orlando City,,16.68219178,2008,0.2,1,0,1,0,0,0,0,,0,1,1,0,0,1,0,0
119,Felipe Carballo,uy URU,MF,NY Red Bulls,,28.58356164,1996,5.9,16,10,8,5,3,7,18,38.9,11,11,2,9,8,24,9,0
120,Wikelman Carmona,ve VEN,"FW,MF",NY Red Bulls,,22.19178082,2003,4.9,7,5,1,3,3,3,3,100,0,12,0,12,3,10,3,1
121,Maximo Carrizo,us USA,FW,NYCFC,,17.18082192,2008,0.2,1,1,1,0,0,0,1,0,1,2,0,2,1,2,0,0
122,Julio Cascante,cr CRC,DF,Austin,,31.58630137,1993,3.5,1,1,1,0,0,0,1,0,1,6,6,0,3,4,15,0
123,Nico Cavallo,us USA,"DF,MF",NYCFC,,23.35342466,2001,1.4,10,7,9,1,0,5,8,62.5,3,2,0,2,2,12,5,0
124,Brayan Ceballos,co COL,DF,NE Revolution,,23.94794521,2001,9,19,11,13,6,0,7,11,63.6,4,14,8,6,13,32,66,0
125,Roman Celentano,us USA,GK,FC Cincinnati,,24.63835616,2000,11,0,0,0,0,0,0,0,,0,0,0,0,0,0,6,1
126,Edwin Cerrillo,us USA,MF,LA Galaxy,,24.58630137,2000,9.6,10,6,3,6,1,6,9,66.7,3,10,1,9,6,16,7,0
127,Dylan Chambost,fr FRA,"MF,FW",Columbus Crew,,27.70958904,1997,10.8,14,11,4,7,3,4,14,28.6,10,14,3,11,14,28,11,1
128,Tomás Chancalay,ar ARG,FW,NE Revolution,,26.33972603,1999,0.8,2,1,0,2,0,0,0,,0,1,0,1,0,2,1,0
129,Maxime Chanot,lu LUX,DF,LAFC,,35.45205479,1989,0.7,2,2,1,1,0,1,1,100,0,2,2,0,3,5,7,0
130,Diego Chará,co COL,MF,Portland Timbers,,39.08219178,1986,6.9,19,15,9,7,3,7,13,53.8,6,7,5,2,11,30,17,1
131,Gabriel Chaves,br BRA,"FW,MF",LA Galaxy,,24.22739726,2001,9.8,8,5,2,4,2,3,14,21.4,11,4,0,4,5,13,2,0
132,Yevhen Cheberko,ua UKR,DF,Columbus Crew,,27.27945205,1998,8.5,14,12,7,7,0,8,9,88.9,1,12,8,4,9,23,28,0
133,Ștefan Chirilă,ro ROU,MF,FC Cincinnati,,18.30136986,2007,0.1,0,0,0,0,0,0,0,,0,0,0,0,0,0,0,0
134,Dominik Chong Qui,us USA,DF,Atlanta Utd,,17.34794521,2007,0.7,2,1,1,1,0,2,3,66.7,1,0,0,0,0,2,0,1
135,Léo Chú,br BRA,"FW,MF",FC Dallas,,25.07945205,2000,2.3,0,0,0,0,0,0,3,0,3,1,0,1,2,2,1,0
136,Markus Cimermancic,ca CAN,"DF,MF",Toronto FC,,20.59178082,2004,2.4,11,10,5,5,1,5,6,83.3,1,4,1,3,1,12,6,0
137,Caden Clark,us USA,"FW,MF",CF Montréal,,21.93972603,2003,7.6,16,9,6,7,3,6,10,60,4,7,0,7,4,20,4,1
138,Noah Cobb,us USA,"DF,FW",Atlanta Utd,,19.79178082,2005,2.8,5,3,3,2,0,3,4,75,1,1,1,0,3,8,7,2
139,Alonso Coello,es ESP,MF,Toronto FC,,25.56164384,1999,6,20,8,8,11,1,9,15,60,6,11,1,10,8,28,12,0
140,Michael Collodi,us USA,GK,FC Dallas,,23.94520548,2001,1,0,0,0,0,0,0,0,,0,0,0,0,0,0,1,0
141,Theo Corbeanu,ca CAN,"FW,MF",Toronto FC,,22.96712329,2002,6.6,5,0,0,3,2,2,8,25,6,7,1,6,1,6,6,0
142,Matthew Corcoran,us USA,MF,Nashville SC,,19.2109589,2006,1.6,6,3,4,2,0,3,4,75,1,1,0,1,2,8,1,0
143,Carlos Coronel,py PAR,GK,NY Red Bulls,,28.34794521,1996,10,0,0,0,0,0,0,0,,0,0,0,0,0,0,17,0
144,David Costa,pt POR,"MF,FW",Portland Timbers,,24.32876712,2001,10.3,4,2,2,2,0,1,9,11.1,8,6,0,6,3,7,4,0
145,Vitor Costa,br BRA,DF,SJ Earthquakes,,30.84383562,1994,4.8,13,8,5,4,4,5,12,41.7,7,9,1,8,7,20,24,0
146,Brandan Craig,us USA,DF,CF Montréal,,21.07671233,2004,1.2,4,2,0,4,0,1,2,50,1,1,1,0,0,4,6,0
147,Ben Cremaschi,us USA,"MF,FW",Inter Miami,,20.17534247,2005,6.5,11,4,2,8,1,4,12,33.3,8,9,1,8,6,17,3,0
148,Maxime Crépeau,ca CAN,GK,Portland Timbers,,30.98356164,1994,2,0,0,0,0,0,0,0,,0,0,0,0,0,0,1,1
149,Andrés Cubas,py PAR,MF,Vancouver W'caps,,28.95342466,1996,7.9,19,15,8,7,4,6,12,50,6,10,3,7,14,33,13,0
150,Mauricio Cuevas,us USA,"MF,DF",LA Galaxy,,22.23013699,2003,0.3,1,1,1,0,0,1,1,100,0,1,1,0,1,2,0,0
151,Christopher Cupps,us USA,DF,Chicago Fire,,16.94246575,2008,1.2,0,0,0,0,0,0,0,,0,0,0,0,1,1,10,0
152,Hugo Cuypers,be BEL,FW,Chicago Fire,,28.23835616,1997,9.9,13,10,3,8,2,5,10,50,5,16,0,16,5,18,10,0
153,Bruno Damiani,uy URU,FW,Philadelphia Union,,23.04657534,2002,5.3,4,2,1,3,0,0,1,0,1,8,0,8,5,9,7,0
154,Dagur Dan Þórhallsson,is ISL,"MF,DF",Orlando City,,25.00821918,2000,4.4,10,8,8,1,1,4,8,50,4,7,5,2,1,11,15,0
155,Daniel,br BRA,GK,SJ Earthquakes,,30.99726027,1994,9.2,0,0,0,0,0,0,1,0,1,0,0,0,0,0,5,2
156,Jesús Daniel Bueno,ve VEN,MF,Philadelphia Union,,26.05479452,1999,0.9,3,1,1,1,1,0,2,0,2,1,0,1,0,3,0,0
157,Héctor David Martínez,py PAR,"DF,FW",Inter Miami,,27.28493151,1998,1.1,3,1,3,0,0,1,3,33.3,2,1,0,1,1,4,10,0
158,Juan David Mosquera,co COL,DF,Portland Timbers,,22.6630137,2002,5.8,2,2,2,0,0,1,10,10,9,7,0,7,2,4,18,0
159,Bode Davis,us USA,DF,Real Salt Lake,,23.19726027,2002,5.8,12,6,8,4,0,6,14,42.9,8,7,4,3,6,18,20,1
160,Jake Davis,us USA,"DF,MF",Sporting KC,,23.33424658,2002,8,24,14,11,8,5,10,26,38.5,16,10,1,9,9,33,19,0
161,Pedro De la Vega,ar ARG,"MF,FW",Seattle Sounders,,24.23835616,2001,3.9,7,3,2,5,0,3,8,37.5,5,5,1,4,3,10,0,0
162,Osaze De Rosario,gy GUY,FW,Seattle Sounders,,23.79452055,2001,0.1,0,0,0,0,0,0,0,,0,0,0,0,0,0,0,0
163,Jonathan Dean,us USA,DF,Chicago Fire,,27.97260274,1997,4.3,7,2,3,2,2,2,2,100,0,9,4,5,8,15,15,0
164,Marky Delgado,us USA,MF,LAFC,,29.96986301,1995,8.2,15,12,3,10,2,9,19,47.4,10,9,2,7,10,25,13,0
165,Patrickson Delgado,ec ECU,"FW,MF",FC Dallas,,21.54794521,2003,3.3,8,6,4,3,1,2,6,33.3,4,2,0,2,1,9,4,0
166,Kévin Denkey,tg TOG,FW,FC Cincinnati,,24.42739726,2000,9.2,7,4,0,4,3,1,6,16.7,5,2,1,1,2,9,6,0
167,Mikkel Desler,dk DEN,DF,Austin,,30.20547945,1995,2.6,4,1,4,0,0,2,5,40,3,4,0,4,1,5,12,0
168,Djibril Diani,fr FRA,MF,Charlotte,,27.22739726,1998,2.4,11,7,5,5,1,2,6,33.3,4,5,1,4,9,20,5,0
169,Jefferson Díaz,co COL,DF,Minnesota Utd,,24.41369863,2000,6.7,8,5,3,3,2,5,9,55.6,4,12,5,7,5,13,31,1
170,Luis Díaz,cr CRC,"FW,MF",NE Revolution,,26.4109589,1998,1,5,1,1,3,1,0,1,0,1,0,0,0,2,7,0,0
171,Hamady Diop,sn SEN,DF,San Diego FC,,22.91232877,2002,2.2,2,2,0,1,1,1,4,25,3,3,1,2,1,3,8,0
172,Innocent Dje,ci CIV,MF,Chicago Fire,,22,2003,1.1,10,5,6,3,1,4,8,50,4,0,0,0,2,12,1,0
173,Derek Dodson,us USA,"DF,MF",D.C. United,,26.50136986,1998,2,9,5,4,4,1,6,8,75,2,1,0,1,3,12,7,0
174,Maxime Dominguez,ch SUI,MF,Toronto FC,,29.25479452,1996,1.4,5,4,1,3,1,4,6,66.7,2,2,0,2,2,7,1,0
175,Ronald Donkor,ml MLI,MF,NY Red Bulls,,20.45479452,2004,1.1,6,5,3,2,1,2,6,33.3,4,2,0,2,5,11,0,0
176,Christopher Donovan,us USA,FW,Philadelphia Union,,24.73972603,2000,1.5,2,2,1,0,1,1,1,100,0,4,0,4,0,2,2,0
177,Griffin Dorsey,us USA,DF,Houston Dynamo,,26.16712329,1999,10.9,15,7,8,6,1,11,18,61.1,7,6,0,6,10,25,20,0
178,C.J. dos Santos,us USA,GK,San Diego FC,,24.69589041,2000,11,1,1,1,0,0,1,3,33.3,2,1,0,1,0,1,8,1
179,Hassani Dotson,us USA,MF,Minnesota Utd,,27.74520548,1997,4.1,6,5,3,2,1,1,3,33.3,2,5,2,3,4,10,8,0
180,Souleyman Doumbia,ci CIV,DF,Charlotte,,28.6109589,1996,3.5,7,6,5,2,0,2,2,100,0,8,4,4,3,10,8,0
181,Anders Dreyer,dk DEN,FW,San Diego FC,,27.00821918,1998,10.6,5,3,2,1,2,5,5,100,0,6,0,6,1,6,3,0
182,Nicolás Dubersarsky,ar ARG,MF,Austin,,20.36986301,2004,0.8,4,1,3,1,0,2,2,100,0,1,0,1,1,5,2,0
183,Erik Duenas,us USA,"MF,FW",Houston Dynamo,,20.54520548,2004,0.8,4,2,3,1,0,0,0,,0,0,0,0,1,5,1,0
184,Morris Duggan,de GER,DF,Minnesota Utd,,24.52876712,2000,6.4,4,1,2,2,0,0,3,0,3,5,5,0,3,7,66,0
185,Bryce Duke,us USA,"MF,FW",CF Montréal,,24.18082192,2001,4.7,7,4,2,4,1,3,6,50,3,5,0,5,0,7,3,0
186,Kyle Duncan,us USA,DF,NY Red Bulls,,27.73972603,1997,2,3,3,2,0,1,3,4,75,1,3,2,1,2,5,7,0
187,Chris Durkin,us USA,"MF,FW",St. Louis,,25.23561644,2000,3.8,6,4,2,3,1,4,7,57.1,3,6,3,3,6,12,12,0
188,Jeremy Ebobisse,us USA,FW,LAFC,,28.21917808,1997,2.8,1,0,0,0,1,0,2,0,2,1,0,1,0,1,1,0
189,Daniel Edelman,us USA,MF,NY Red Bulls,,22.01917808,2003,6.9,13,7,2,9,2,11,23,47.8,12,8,2,6,8,21,12,0
190,Earl Edwards Jr.,us USA,GK,SJ Earthquakes,,33.27671233,1992,1.8,0,0,0,0,0,0,0,,0,0,0,0,0,0,1,1
191,Matthew Edwards,us USA,DF,Atlanta Utd,,22.2109589,2003,4.8,7,4,3,4,0,3,5,60,2,5,2,3,4,11,10,0
192,Michael Edwards,us USA,DF,Colorado Rapids,,24.43561644,2000,0.3,0,0,0,0,0,0,0,,0,0,0,0,1,1,5,0
193,Raheem Edwards,ca CAN,DF,NY Red Bulls,,29.80547945,1995,3.9,6,5,2,3,1,1,10,10,9,5,1,4,7,13,7,0
194,Noah Eile,se SWE,DF,NY Red Bulls,,22.79452055,2002,10.5,23,12,11,12,0,12,13,92.3,1,14,7,7,12,35,67,0
195,Jack Elliott,eng ENG,DF,Chicago Fire,,29.69315068,1995,10,9,5,6,3,0,7,13,53.8,6,11,8,3,8,17,75,4
196,Emeka Eneli,us USA,MF,Real Salt Lake,,25.54520548,1999,9.5,17,10,10,6,1,6,14,42.9,8,17,7,10,12,29,14,0
197,Lukas Engel,dk DEN,DF,FC Cincinnati,,26.3890411,1998,10.3,16,12,9,3,4,12,15,80,3,25,4,21,15,31,43,2
198,Boris Enow,cm CMR,MF,D.C. United,,25.09863014,2000,5.6,8,4,4,3,1,4,8,50,4,7,0,7,11,19,3,2
199,Ramiro Enrique,ar ARG,"FW,MF",Orlando City,,24.00273973,2001,2.3,1,1,1,0,0,0,1,0,1,1,0,1,2,3,4,0
200,Franco Escobar,ar ARG,DF,Houston Dynamo,,30.2,1995,8.9,27,20,20,6,1,19,26,73.1,7,11,4,7,15,42,35,0
201,Cristian Espinoza,ar ARG,"DF,MF",SJ Earthquakes,,30.08767123,1995,11,19,11,6,10,3,13,24,54.2,11,5,0,5,10,29,12,1
202,Derrick Etienne,ht HAI,FW,Toronto FC,,28.44109589,1996,3.1,2,2,2,0,0,1,3,33.3,2,3,0,3,1,3,3,0
203,Evander,br BRA,"MF,FW",FC Cincinnati,,26.90410959,1998,8,12,7,6,4,2,7,14,50,7,10,2,8,2,14,2,0
204,Diego Fagúndez,uy URU,"FW,MF",LA Galaxy,,30.21917808,1995,9.9,13,6,7,4,2,5,11,45.5,6,8,0,8,0,13,6,1
205,Maximiliano Falcón,uy URU,DF,Inter Miami,,28.0109589,1997,4.2,5,2,4,1,0,4,7,57.1,3,11,7,4,6,11,20,0
206,Marco Farfan,us USA,DF,FC Dallas,,26.47671233,1998,5.2,11,4,6,2,3,5,10,50,5,2,1,1,3,14,25,1
207,Logan Farrington,us USA,FW,FC Dallas,,23.3890411,2001,5.7,10,7,3,4,3,6,8,75,2,5,3,2,2,12,19,0
208,Mohamed Farsi,dz ALG,"DF,MF",Columbus Crew,,25.38356164,1999,8.9,13,5,5,6,2,7,9,77.8,2,8,0,8,4,17,13,0
209,Ilay Feingold,il ISR,"DF,FW",NE Revolution,,20.69863014,2004,9,12,7,6,5,1,7,15,46.7,8,19,5,14,8,20,27,1
210,Joaquín Fernández,es ESP,DF,Sporting KC,,28.92876712,1996,6.2,7,4,5,2,0,3,4,75,1,8,3,5,1,8,37,0
211,Julián Fernández,ar ARG,"FW,MF",NYCFC,,21.33424658,2004,5.6,10,4,3,7,0,5,12,41.7,7,10,1,9,2,12,5,0
212,Omir Fernandez,us USA,"MF,FW",Colorado Rapids,,26.23561644,1999,2,1,1,1,0,0,0,3,0,3,3,0,3,2,3,3,0
213,Omir Fernandez,us USA,"FW,MF",Portland Timbers,,26.23561644,1999,0.4,1,1,0,1,0,0,1,0,1,1,0,1,0,1,1,0
214,Jesús Ferreira,us USA,"FW,MF",Seattle Sounders,,24.36164384,2000,7.3,12,9,5,3,4,3,7,42.9,4,4,1,3,6,18,2,0
215,Nicolas Fleuriau,ca CAN,"DF,FW",Vancouver W'caps,,22.95616438,2002,0.1,1,1,0,1,0,0,1,0,1,1,0,1,0,1,0,0
216,Deybi Flores,hn HON,MF,Toronto FC,,28.88493151,1996,7.7,23,11,12,9,2,8,22,36.4,14,10,3,7,18,41,39,0
217,Gilberto Flores,py PAR,DF,FC Cincinnati,,22.09315068,2003,6.6,13,12,8,4,1,8,19,42.1,11,15,10,5,6,19,51,1
218,Max Floriani,us USA,DF,SJ Earthquakes,,22.24109589,2003,1.8,0,0,0,0,0,0,2,0,2,4,3,1,2,2,5,0
219,CJ Fodrey,us USA,"FW,MF",Austin,,21.23013699,2004,0.7,4,2,3,1,0,0,2,0,2,0,0,0,0,4,2,0
220,Mamadou Fofana,ml MLI,DF,NE Revolution,,27.28493151,1998,9.9,26,14,21,4,1,14,24,58.3,10,15,9,6,15,41,69,1
221,Emil Forsberg,se SWE,MF,NY Red Bulls,,33.53150685,1991,10.7,7,6,1,4,2,4,7,57.1,3,4,0,4,1,8,2,0
222,Ajani Fortune,tt TRI,"MF,FW",Atlanta Utd,,22.34520548,2002,4,10,8,6,4,0,4,6,66.7,2,6,1,5,8,18,7,0
223,Jimer Fory,co COL,"DF,MF",Portland Timbers,,22.94794521,2002,8.6,14,9,8,5,1,7,10,70,3,21,5,16,12,26,44,1
224,Kobe Franklin,ca CAN,DF,Toronto FC,,21.98630137,2003,0.6,2,2,2,0,0,1,1,100,0,1,0,1,0,2,0,0
225,Ian Fray,us USA,DF,Inter Miami,,22.67671233,2002,4.7,17,10,15,2,0,12,16,75,4,11,2,9,9,26,9,1
226,Wayne Frederick,tt TRI,MF,Colorado Rapids,,20.89315068,2004,1.5,3,0,1,2,0,0,1,0,1,2,1,1,6,9,7,0
227,Alexander Freeman,us USA,DF,Orlando City,,20.7369863,2004,10.4,18,12,12,6,0,8,15,53.3,7,15,3,12,7,25,46,0
228,Matt Freese,us USA,GK,NYCFC,,26.67123288,1998,11,0,0,0,0,0,0,0,,0,1,0,1,0,0,2,1
229,Stefan Frei,ch SUI,GK,Seattle Sounders,,39.04109589,1986,10,0,0,0,0,0,0,0,,0,0,0,0,0,0,3,1
230,Julian Gaines,us USA,FW,Nashville SC,,22.49589041,2002,0.1,2,0,1,0,1,0,0,,0,0,0,0,0,2,0,0
231,Jeffrey Gal,us USA,GK,Chicago Fire,,32.07945205,1993,0.6,0,0,0,0,0,0,0,,0,0,0,0,0,0,0,0
232,Jon Gallagher,ie IRL,DF,Austin,,29.19452055,1996,8.4,12,7,9,2,1,6,10,60,4,8,3,5,4,16,36,0
233,Pedro Gallese,pe PER,GK,Orlando City,,35.19452055,1990,10,0,0,0,0,0,0,0,,0,0,0,0,0,0,6,0
234,Ignatius Ganago,cm CMR,"FW,MF",NE Revolution,,26.21369863,1999,9.3,10,9,4,4,2,4,12,33.3,8,9,2,7,1,11,14,0
235,Carlos Garcés,co COL,DF,LA Galaxy,,23.56438356,2001,7.6,21,13,16,5,0,11,16,68.8,5,9,1,8,10,31,21,3
236,Manu García,es ESP,MF,Sporting KC,,27.3369863,1998,10.4,16,10,2,7,7,7,17,41.2,10,9,1,8,3,19,6,1
237,Ryan Gauld,sct SCO,FW,Vancouver W'caps,,29.38356164,1995,2.2,5,3,0,3,2,3,7,42.9,4,4,0,4,3,8,0,0
238,Dániel Gazdag,hu HUN,"MF,FW",Philadelphia Union,,29.17534247,1996,5.5,13,9,3,6,4,7,12,58.3,5,4,0,4,1,14,1,1
239,Dániel Gazdag,hu HUN,"FW,MF",Columbus Crew,,29.17534247,1996,2.5,2,1,1,0,1,2,5,40,3,2,0,2,2,4,0,0
240,Owen Géne,fr FRA,"MF,FW",Minnesota Utd,,22.12876712,2003,1.1,1,1,0,1,0,1,3,33.3,2,2,2,0,1,2,0,0
241,Joran Gerbet,fr FRA,MF,Orlando City,,23.84657534,2001,4.3,13,10,4,7,2,4,6,66.7,2,8,5,3,6,19,4,0
242,Carles Gil,es ESP,MF,NE Revolution,,32.44931507,1992,10,11,9,1,7,3,8,16,50,8,3,0,3,5,16,3,0
243,Blake Gillingham,us USA,GK,Houston Dynamo,,22.56438356,2002,3.3,1,0,1,0,0,1,1,100,0,0,0,0,0,1,0,0
244,Olivier Giroud,fr FRA,FW,LAFC,,38.59452055,1986,4.6,4,2,1,3,0,1,2,50,1,4,1,3,0,4,6,0
245,Dennis Gjengaar,no NOR,"FW,MF",NY Red Bulls,,21.19178082,2004,3.3,4,3,1,1,2,4,9,44.4,5,4,0,4,1,5,4,0
246,Justen Glad,us USA,DF,Real Salt Lake,,28.18082192,1997,10,12,5,5,6,1,4,8,50,4,16,10,6,14,26,53,0
247,Omari Glasgow,gy GUY,"DF,FW",Chicago Fire,,21.44931507,2003,5.3,10,5,5,2,3,6,12,50,6,11,1,10,2,12,12,0
248,Ian Glavinovich,ar ARG,DF,Philadelphia Union,,23.52054795,2001,2.9,3,2,2,1,0,0,1,0,1,4,1,3,5,8,18,0
249,Jakob Glesnes,no NOR,DF,Philadelphia Union,,31.11232877,1994,11,16,10,13,3,0,8,13,61.5,5,11,7,4,15,31,71,0
250,Aníbal Godoy,pa PAN,MF,San Diego FC,,35.23013699,1990,8,12,7,4,7,1,4,10,40,6,1,1,0,8,20,5,0
251,Yeimar Gómez Andrade,co COL,DF,Seattle Sounders,,32.84657534,1992,9.9,26,15,10,15,1,15,21,71.4,6,7,3,4,19,45,56,1
252,Nicksoen Gomis,fr FRA,DF,Toronto FC,,23.13972603,2002,5.3,10,4,6,2,2,6,8,75,2,4,2,2,4,14,11,1
253,Diogo Gonçalves,pt POR,"FW,MF",Real Salt Lake,,28.24109589,1997,9.2,3,2,1,2,0,0,3,0,3,10,0,10,7,10,7,0
254,Omar Gonzalez,us USA,"DF,MF",Chicago Fire,,36.56438356,1988,0.8,1,1,1,0,0,1,1,100,0,0,0,0,0,1,7,0
255,Zavier Gozo,us USA,FW,Real Salt Lake,,18.12054795,2007,2.9,15,8,5,6,4,6,12,50,6,5,0,5,1,16,7,0
256,Owen Graham Roache,ca CAN,FW,CF Montréal,,17.22739726,2008,0.5,0,0,0,0,0,0,0,,0,0,0,0,0,0,0,0
257,Tayvon Gray,jm JAM,DF,NYCFC,,22.70958904,2002,2.4,7,4,3,4,0,6,7,85.7,1,4,2,2,2,9,12,0
258,Julian Gressel,us USA,MF,Minnesota Utd,,31.38356164,1993,0.3,1,1,0,1,0,0,0,,0,1,1,0,1,2,0,0
259,Yuri Guboglo,ht HAI,"DF,MF",CF Montréal,,18.1260274,2007,5.1,7,5,4,2,1,5,11,45.5,6,3,2,1,1,8,15,0
260,Colin Guske,us USA,"FW,MF",Orlando City,,18.2630137,2007,0.1,0,0,0,0,0,0,0,,0,0,0,0,0,0,0,0
261,Brian Gutiérrez,us USA,MF,Chicago Fire,,21.88219178,2003,6.1,8,4,4,3,1,4,8,50,4,12,1,11,10,18,2,0
262,Andrew Gutman,us USA,DF,Chicago Fire,,28.5890411,1996,9.7,18,9,10,6,2,9,13,69.2,4,12,8,4,15,33,42,0
263,Brad Guzan,us USA,GK,Atlanta Utd,,40.65205479,1984,11,0,0,0,0,0,0,0,,0,0,0,0,0,0,4,1
264,Justin Haak,us USA,"DF,MF",NYCFC,,23.64383562,2001,10.7,13,7,8,4,1,5,13,38.5,8,22,9,13,15,28,58,0
265,Taha Habroune,us USA,"MF,FW",Columbus Crew,,19.24383562,2006,0.4,3,1,1,1,1,1,2,50,1,2,0,2,1,4,0,0
266,Alexander Hack,de GER,DF,NY Red Bulls,,31.65479452,1993,5.4,13,6,6,7,0,8,15,53.3,7,9,4,5,12,25,37,0
267,Teenage Hadebe,zw ZIM,DF,FC Cincinnati,,29.63013699,1995,3.3,8,5,5,3,0,4,5,80,1,3,2,1,10,18,21,0
268,Nick Hagglund,us USA,DF,FC Cincinnati,,32.63835616,1992,5.5,2,1,2,0,0,1,1,100,0,10,8,2,0,2,44,0
269,Maren Haile-Selassie,ch SUI,"FW,MF",Chicago Fire,,26.14520548,1999,1.8,1,1,0,0,1,1,1,100,0,5,0,5,1,2,0,0
270,Belal Halbouni,sy SYR,DF,Vancouver W'caps,,25.34794521,1999,0.1,0,0,0,0,0,0,0,,0,0,0,0,0,0,0,0
271,Julian Hall,us USA,"MF,FW",NY Red Bulls,,17.11506849,2008,1.9,1,0,1,0,0,0,2,0,2,3,0,3,2,3,1,0
272,Bret Halsey,us USA,DF,FC Cincinnati,,24.9260274,2000,0.4,3,1,3,0,0,2,2,100,0,0,0,0,1,4,3,0
273,Nicholas Hansen,dk DEN,GK,Colorado Rapids,,23.81917808,2001,1,0,0,0,0,0,0,0,,0,0,0,0,0,0,1,0
274,Ian Harkes,us USA,MF,SJ Earthquakes,,30.09863014,1995,9.3,14,6,4,7,3,10,20,50,10,12,3,9,9,23,14,0
275,Cameron Harper,us USA,"DF,FW",NY Red Bulls,,23.45753425,2001,3.5,7,6,4,2,1,3,8,37.5,5,2,0,2,0,7,0,0
276,Nathan Harriel,us USA,"DF,MF",Philadelphia Union,,24.03287671,2001,6.5,17,6,7,7,3,7,9,77.8,2,8,1,7,15,32,34,0
277,Alex Harris,us USA,MF,Colorado Rapids,,20.21369863,2005,0,0,0,0,0,0,0,0,,0,0,0,0,0,0,0,0
278,Calvin Harris,eng ENG,"FW,MF",Colorado Rapids,,25.1260274,2000,1.6,4,2,1,2,1,2,6,33.3,4,3,2,1,2,6,3,0
279,Marcel Hartel,de GER,MF,St. Louis,,29.29041096,1996,10.9,10,7,5,3,2,6,11,54.5,5,6,1,5,10,20,10,0
280,Carlos Harvey,pa PAN,"DF,MF",Minnesota Utd,,25.24931507,2000,5.2,18,11,12,4,2,10,19,52.6,9,4,2,2,11,29,28,0
281,Thomas Hasal,ca CAN,GK,LAFC,,25.82191781,1999,1,0,0,0,0,0,0,0,,0,0,0,0,0,0,3,0
282,Kobi Henry,us USA,"DF,FW",Real Salt Lake,,21.02465753,2004,0.5,0,0,0,0,0,0,0,,0,0,0,0,1,1,1,0
283,Fabian Herbers,de GER,"MF,FW",CF Montréal,,31.71506849,1993,2.9,6,5,2,4,0,1,2,50,1,1,0,1,5,11,4,0
284,Ronald Hernández,ve VEN,"DF,FW",Atlanta Utd,,27.61917808,1997,1.5,1,0,1,0,0,1,4,25,3,0,0,0,4,5,4,0
285,Aaron Herrera,gt GUA,"DF,MF",D.C. United,,27.91232877,1997,9.7,20,13,12,8,0,15,18,83.3,3,11,3,8,8,28,32,0
286,Marcelo Herrera,ar ARG,DF,Columbus Crew,,26.50136986,1998,3.4,6,3,2,2,2,3,7,42.9,4,7,0,7,4,10,11,0
287,Kyle Hiebert,ca CAN,DF,St. Louis,,27.76438356,1997,10.6,13,4,9,4,0,6,9,66.7,3,16,7,9,2,15,57,0
288,Brendan Hines-Ike,us USA,DF,Austin,,30.42739726,1994,10,8,5,8,0,0,3,4,75,1,8,8,0,5,13,68,1
289,Bongokuhle Hlongwane,za RSA,DF,Minnesota Utd,,24.8739726,2000,10.5,22,15,17,4,1,17,26,65.4,9,11,1,10,14,36,35,0
290,Ryan Hollingshead,us USA,"DF,MF",LAFC,,34.05205479,1991,8,16,9,11,3,2,9,16,56.3,7,9,4,5,11,27,29,0
291,Jannes Horn,de GER,DF,St. Louis,,28.24109589,1997,7.2,12,7,7,5,0,8,9,88.9,1,5,1,4,4,16,18,0
292,Jung Hoyeon,kr KOR,MF,Minnesota Utd,,24.6,2000,0.2,1,0,0,1,0,0,1,0,1,1,0,1,0,1,0,0
293,Keegan Hughes,us USA,FW,NE Revolution,,24.78630137,2000,0,0,0,0,0,0,0,0,,0,0,0,0,0,0,0,0
294,Sebastien Ibeagha,us USA,DF,FC Dallas,,33.28493151,1992,10.5,6,3,3,2,1,2,4,50,2,12,9,3,13,19,66,0
295,Aliyu Ibrahim,ng NGA,"MF,FW",Houston Dynamo,,23.29863014,2002,2,8,6,4,3,1,2,3,66.7,1,4,0,4,2,10,2,0
296,Aliyu Ibrahim,ng NGA,FW,Columbus Crew,,23.29863014,2002,0.1,0,0,0,0,0,0,0,,0,0,0,0,0,0,0,0
297,Sunusi Ibrahim,ng NGA,FW,CF Montréal,,22.59178082,2002,0.6,0,0,0,0,0,0,0,,0,0,0,0,0,0,0,0
298,Igor,br BRA,MF,LAFC,,22.16164384,2003,8.7,23,11,5,12,6,12,18,66.7,6,12,2,10,9,32,13,0
299,Mitja Ilenič,si SVN,DF,NYCFC,,20.35616438,2004,8.2,5,3,4,1,0,5,9,55.6,4,8,1,7,10,15,27,0
300,Milan Iloski,us USA,"MF,FW",San Diego FC,,25.76712329,1999,0.8,0,0,0,0,0,0,1,0,1,0,0,0,0,0,1,0
301,Bjørn Inge Utvik,no NOR,DF,Vancouver W'caps,,29.18082192,1996,2.9,3,3,2,0,1,3,3,100,0,1,1,0,1,4,20,0
302,Marcus Ingvartsen,dk DEN,FW,San Diego FC,,29.33150685,1996,3.5,0,0,0,0,0,0,0,,0,3,0,3,2,2,1,0
303,Lorenzo Insigne,it ITA,"MF,FW",Toronto FC,,33.91780822,1991,5.2,6,3,3,1,2,1,4,25,3,6,1,5,4,10,4,0
304,Aljaž Ivačič,si SVN,GK,NE Revolution,,31.34794521,1993,10,0,0,0,0,0,0,0,,0,0,0,0,0,0,7,0
305,Ousman jabang,us USA,DF,CF Montréal,,24.10136986,2001,1,1,1,0,0,1,1,1,100,0,1,0,1,0,1,3,0
306,Aziel Jackson,us USA,"MF,FW",Columbus Crew,,23.52876712,2001,4.7,8,5,3,3,2,3,7,42.9,4,6,0,6,4,12,3,0
307,Robin Jansson,se SWE,DF,Orlando City,,33.46849315,1991,9,5,4,4,1,0,4,5,80,1,10,6,4,7,12,41,1
308,Danley Jean-Jacques,ht HAI,MF,Philadelphia Union,,24.95890411,2000,9.4,16,8,11,4,1,5,11,45.5,6,9,1,8,22,38,18,0
309,Julio Joao Ortíz,ec ECU,MF,Portland Timbers,,29.0109589,1996,4.5,4,2,3,1,0,2,3,66.7,1,2,0,2,0,4,4,0
310,Sean Johnson,us USA,GK,Toronto FC,,35.92876712,1989,11,1,1,1,0,0,1,3,33.3,2,0,0,0,0,1,7,1
311,Tate Johnson,us USA,DF,Vancouver W'caps,,19.81917808,2005,6.5,10,8,6,3,1,5,9,55.6,4,3,1,2,6,16,27,0
312,DeJuan Jones,us USA,DF,Columbus Crew,,27.8630137,1997,2.7,3,1,1,1,1,2,3,66.7,1,1,0,1,5,8,3,0
313,DeJuan Jones,us USA,DF,SJ Earthquakes,,27.8630137,1997,1.3,2,2,1,1,0,1,6,16.7,5,5,0,5,3,5,1,0
314,Derrick Jones,us USA,MF,Columbus Crew,,28.17260274,1997,0,0,0,0,0,0,0,0,,0,0,0,0,0,0,1,0
315,Kim Joonhong,kr KOR,GK,D.C. United,,21.92054795,2003,7,0,0,0,0,0,0,0,,0,0,0,0,0,0,5,1
316,Dejan Joveljić,rs SRB,FW,Sporting KC,,25.74246575,1999,10.1,10,6,2,2,6,1,4,25,3,4,1,3,1,11,8,0
317,Mykhi Joyner,us USA,"MF,FW",St. Louis,,18.67945205,2006,0.8,2,2,1,1,0,0,1,0,1,0,0,0,0,2,5,0
318,Preston Judd,us USA,"FW,MF",SJ Earthquakes,,25.9369863,1999,2.5,2,1,0,0,2,1,1,100,0,6,0,6,1,3,1,0
319,Anderson Julio,ec ECU,"FW,DF",FC Dallas,,28.92876712,1996,6.9,8,6,4,3,1,2,12,16.7,10,5,0,5,7,15,7,0
320,Sam Junqua,us USA,DF,Real Salt Lake,,28.48493151,1996,5.8,11,6,5,3,3,6,7,85.7,1,8,5,3,5,16,15,0
321,Mathias Jørgensen,dk DEN,DF,LA Galaxy,,35.03287671,1990,6.3,7,6,5,1,1,6,7,85.7,1,12,7,5,5,12,24,1
322,Kristijan Kahlina,hr CRO,GK,Charlotte,,32.78082192,1992,11,0,0,0,0,0,0,0,,0,0,0,0,0,0,4,3
323,Kaick,br BRA,MF,FC Dallas,,19.43013699,2005,3.9,14,9,6,7,1,7,15,46.7,8,4,1,3,4,18,8,0
324,Bernard Kamungo,us USA,FW,FC Dallas,,23.33972603,2002,2.2,2,0,1,0,1,1,1,100,0,1,0,1,4,6,0,0
325,Bibi Karamoko,us USA,FW,D.C. United,,19.50684932,2005,0.2,0,0,0,0,0,0,0,,0,0,0,0,0,0,0,0
326,Alexandros Katranis,gr GRE,DF,Real Salt Lake,,27.00273973,1998,6.9,11,6,8,2,1,8,10,80,2,4,0,4,3,14,15,0
327,Mark-Anthony Kaye,ca CAN,MF,SJ Earthquakes,,30.42191781,1994,3.3,14,7,7,6,1,10,14,71.4,4,7,0,7,5,19,1,0
328,Kim Kee-hee,kr KOR,DF,Seattle Sounders,,35.8109589,1989,3.5,4,2,4,0,0,1,2,50,1,4,1,3,4,8,16,0
329,Kevin Kelsy,ve VEN,FW,Portland Timbers,,20.77260274,2004,4.8,1,1,0,0,1,0,1,0,1,2,2,0,1,2,5,0
330,Ryan Kent,eng ENG,"MF,FW",Seattle Sounders,,28.47945205,1996,0.7,2,2,1,1,0,1,2,50,1,0,0,0,1,3,0,0
331,Deandre Kerr,ca CAN,FW,Toronto FC,,22.45753425,2002,2.5,1,1,1,0,0,0,1,0,1,3,0,3,1,2,0,0
332,Henry Kessler,us USA,DF,St. Louis,,26.86027397,1998,8,12,9,11,1,0,7,8,87.5,1,13,12,1,2,14,58,0
333,Hosei Kijima,jp JPN,"MF,FW",D.C. United,,22.84383562,2002,9.1,13,7,5,4,4,8,19,42.1,11,14,0,14,9,22,10,1
334,Klauss,br BRA,FW,St. Louis,,28.17808219,1997,7,9,4,4,5,0,2,5,40,3,4,1,3,4,13,11,0
335,Mateusz Klich,pl POL,MF,Atlanta Utd,,34.89315068,1990,4.2,9,7,2,6,1,4,10,40,6,4,0,4,7,16,3,0
336,Žan Kolmanič,si SVN,"DF,MF",Austin,,25.17260274,2000,2,6,3,4,1,1,3,3,100,0,5,3,2,2,8,5,1
337,Rominigue Kouamé,ml MLI,MF,Chicago Fire,,28.38082192,1996,1.3,1,1,1,0,0,0,0,,0,1,0,1,0,1,2,0
338,Sebastian Kowalczyk,pl POL,"FW,MF",Houston Dynamo,,26.70136986,1998,9,16,11,11,3,2,8,18,44.4,10,14,0,14,6,22,7,0
339,Damir Kreilach,hr CRO,FW,Vancouver W'caps,,36.05205479,1989,0,0,0,0,0,0,0,1,0,1,0,0,0,0,0,1,0
340,Theodore Ku-Dipietro,us USA,"MF,FW",Colorado Rapids,,23.26575342,2002,0.4,0,0,0,0,0,0,0,,0,0,0,0,0,0,0,0
341,Yuya Kubo,jp JPN,"MF,FW",FC Cincinnati,,31.36164384,1993,4.6,5,2,1,2,2,2,4,50,2,4,1,3,1,6,5,0
342,Willy Kumado,gh GHA,DF,San Diego FC,,22.55068493,2002,4.8,9,6,6,1,2,4,5,80,1,4,0,4,3,12,12,1
343,Luca de la Torre,us USA,MF,San Diego FC,,26.95068493,1998,9.2,17,9,3,6,8,7,11,63.6,4,12,3,9,3,20,6,1
344,Mathías Laborda,uy URU,DF,Vancouver W'caps,,25.63561644,1999,5.9,17,4,9,7,1,8,11,72.7,3,9,4,5,7,24,13,0
345,Luca Langoni,ar ARG,"FW,MF",NE Revolution,,23.23287671,2002,4.8,8,6,4,3,1,4,8,50,4,5,1,4,4,12,8,0
346,Lassi Lappalainen,fi FIN,MF,Columbus Crew,,26.69589041,1998,0,0,0,0,0,0,0,0,,0,0,0,0,1,1,0,0
347,Oliver Larraz,us USA,"MF,FW",Colorado Rapids,,23.63287671,2001,9.6,30,16,11,15,4,11,20,55,9,22,2,20,15,45,7,0
348,Richie Laryea,ca CAN,DF,Toronto FC,,30.32328767,1995,1.2,4,0,3,0,1,2,3,66.7,1,0,0,0,2,6,2,0
349,Ariel Lassiter,cr CRC,"FW,MF",Portland Timbers,,30.60273973,1994,2.1,0,0,0,0,0,0,0,,0,2,1,1,0,0,1,0
350,Emmanuel Latte Lath,ci CIV,FW,Atlanta Utd,,26.33972603,1999,9.5,9,6,3,3,3,0,3,0,3,9,3,6,3,12,7,0
351,Randall Leal,cr CRC,MF,D.C. United,,28.30410959,1997,0.5,3,3,1,0,2,3,4,75,1,0,0,0,0,3,1,0
352,Tim Leibold,de GER,DF,Sporting KC,,31.42739726,1993,1.9,5,4,2,3,0,3,4,75,1,3,0,3,3,8,4,0
353,Brooks Lennon,us USA,DF,Atlanta Utd,,27.61643836,1997,7.7,7,4,4,2,1,1,7,14.3,6,9,0,9,8,15,18,0
354,Tucker Lepley,us USA,MF,LA Galaxy,,23.29589041,2002,3.8,3,0,0,2,1,2,5,40,3,3,0,3,2,5,7,0
355,Beau Leroux,us USA,MF,SJ Earthquakes,,21.67671233,2003,8.7,21,11,8,11,2,14,17,82.4,3,11,1,10,17,38,25,0
356,Danny Leyva,us USA,"MF,FW",Seattle Sounders,,22,2003,2.9,3,1,0,2,1,2,3,66.7,1,2,0,2,4,7,3,0
357,Nick Lima,us USA,DF,SJ Earthquakes,,30.4630137,1994,1.9,4,3,2,1,1,4,5,80,1,4,2,2,1,5,4,0
358,Ondřej Lingr,cz CZE,"FW,MF",Houston Dynamo,,26.57534247,1998,1.9,1,1,0,1,0,0,1,0,1,2,0,2,0,1,3,0
359,Sebastian Lletget,us USA,MF,FC Dallas,,32.66849315,1992,6.2,8,3,5,1,2,2,2,100,0,8,4,4,5,13,9,0
360,Hugo Lloris,fr FRA,GK,LAFC,,38.35616438,1986,10,0,0,0,0,0,0,0,,0,0,0,0,0,0,5,1
361,Saba Lobzhanidze,ge GEO,FW,Atlanta Utd,,30.37808219,1994,8.5,8,4,4,2,2,2,9,22.2,7,4,0,4,5,13,3,1
362,Robin Lod,fi FIN,"MF,FW",Minnesota Utd,,32.04931507,1993,8.4,15,11,10,3,2,7,14,50,7,13,2,11,6,21,9,0
363,Nicolás Lodeiro,uy URU,"FW,MF",Houston Dynamo,,36.12328767,1989,4.3,4,4,2,1,1,3,10,30,7,6,1,5,1,5,2,0
364,Jasper Löffelsend,de GER,DF,San Diego FC,,27.64931507,1997,6.3,19,12,10,7,2,10,19,52.6,9,5,0,5,7,26,13,0
365,Aaron Long,us USA,DF,LAFC,,32.56164384,1992,8.3,11,8,9,2,0,5,9,55.6,4,16,5,11,1,12,55,0
366,Kevin Long,ie IRL,DF,Toronto FC,,34.71232877,1990,7.5,11,6,10,1,0,5,8,62.5,3,4,2,2,6,17,47,0
367,Matthew Longstaff,eng ENG,MF,Toronto FC,,25.12328767,2000,3.9,10,7,6,2,2,5,8,62.5,3,5,0,5,5,15,2,0
368,Hernán López Muñoz,ar ARG,MF,SJ Earthquakes,,24.65753425,2000,1.3,1,1,1,0,0,0,2,0,2,1,0,1,1,2,1,0
369,Victor Loturi,ca CAN,MF,CF Montréal,,23.95616438,2001,6.6,12,7,5,5,2,5,7,71.4,2,4,3,1,5,17,12,0
370,Daniel Lovitz,us USA,DF,Nashville SC,,33.68767123,1991,11,29,20,18,8,3,13,20,65,7,11,2,9,12,41,30,0
371,Eduard Löwen,de GER,MF,St. Louis,,28.26575342,1997,4.1,13,7,6,6,1,7,13,53.8,6,4,1,3,6,19,4,0
372,Hirving Lozano,mx MEX,FW,San Diego FC,,29.76438356,1995,6.1,10,4,4,2,4,1,3,33.3,2,6,0,6,2,12,0,0
373,Gonzalo Luján,ar ARG,DF,Inter Miami,,24.02191781,2001,8.4,17,13,11,5,1,11,13,84.6,2,9,3,6,8,25,34,0
374,Jovan Lukić,rs SRB,MF,Philadelphia Union,,23.28767123,2002,9.1,24,15,7,14,3,14,30,46.7,16,14,2,12,17,41,15,1
375,Diego Luna,us USA,"MF,FW",Real Salt Lake,,21.65753425,2003,9.3,10,7,2,4,4,3,13,23.1,10,7,1,6,4,14,2,0
376,Benjamin Lundt,de GER,GK,St. Louis,,29.6109589,1995,8,0,0,0,0,0,0,0,,0,0,0,0,0,0,7,0
377,Liam MacKenzie,ca CAN,FW,Vancouver W'caps,,18.13972603,2007,0.7,2,1,0,1,1,0,1,0,1,1,0,1,0,2,0,0
378,Lukas MacNaughton,ca CAN,DF,D.C. United,,30.15890411,1995,4.5,3,1,2,1,0,0,0,,0,4,4,0,8,11,24,0
379,Jack Maher,us USA,DF,Nashville SC,,25.51780822,1999,11,7,5,4,2,1,2,5,40,3,7,4,3,6,13,49,0
380,Olwethu Makhanya,za RSA,DF,Philadelphia Union,,21.01369863,2004,6.4,14,11,7,7,0,12,16,75,4,12,6,6,15,29,54,1
381,Adilson Malanda,fr FRA,DF,Charlotte,,23.51506849,2001,11,8,6,7,1,0,3,3,100,0,21,18,3,6,14,69,0
382,AJ Marcucci,us USA,GK,NY Red Bulls,,25.76164384,1999,1,0,0,0,0,0,0,0,,0,0,0,0,0,0,0,0
383,Dominik Marczuk,pl POL,FW,Real Salt Lake,,21.50684932,2003,5.3,5,4,3,2,0,4,7,57.1,3,3,0,3,4,9,3,0
384,Anthony Markanich,ph PHI,DF,Minnesota Utd,,25.35616438,1999,5.1,16,9,8,5,3,9,15,60,6,15,6,9,10,26,21,0
385,Idan Markovich,il ISR,"FW,MF",Charlotte,,20.7369863,2004,2.8,4,2,0,3,1,2,3,66.7,1,1,0,1,0,4,4,0
386,Marlon,br BRA,DF,LAFC,,29.65753425,1995,4.8,4,3,4,0,0,3,6,50,3,6,5,1,7,11,29,0
387,Jahkeele Marshall-Rutty,ca CAN,DF,Charlotte,,20.88493151,2004,0.3,1,1,1,0,0,1,1,100,0,0,0,0,0,1,0,0
388,Jahkeele Marshall-Rutty,ca CAN,"MF,DF",CF Montréal,,20.88493151,2004,2.6,3,3,1,2,0,1,3,33.3,2,3,2,1,2,5,5,0
389,Alonso Martínez,cr CRC,FW,NYCFC,,26.55342466,1998,9.7,5,0,3,1,1,1,5,20,4,3,0,3,1,6,3,0
390,David Martínez,ve VEN,FW,LAFC,,19.23835616,2006,5.9,11,8,6,4,1,7,10,70,3,3,0,3,1,12,3,1
391,Josef Martínez,ve VEN,FW,SJ Earthquakes,,31.96164384,1993,7.1,0,0,0,0,0,0,3,0,3,0,0,0,0,0,0,0
392,Thiago Martins,br BRA,DF,NYCFC,,30.13424658,1995,9.2,13,10,10,2,1,4,5,80,1,15,11,4,8,21,65,2
393,Jimmy Maurer,us USA,GK,Houston Dynamo,,36.55616438,1988,1.3,0,0,0,0,0,0,0,,0,0,0,0,0,0,3,0
394,Eric Maxim Choupo-Moting,cm CMR,FW,NY Red Bulls,,36.11780822,1989,10.7,14,12,1,8,5,4,7,57.1,3,7,1,6,0,14,7,0
395,Andreas Maxsø,dk DEN,DF,Colorado Rapids,,31.13150685,1994,9,6,2,1,5,0,2,3,66.7,1,11,9,2,9,15,55,0
396,Olivier Mbaizo,cm CMR,DF,Philadelphia Union,,27.72054795,1997,1,0,0,0,0,0,0,0,,0,0,0,0,0,0,0,0
397,Kenji Mboma Dem,fr FRA,DF,FC Cincinnati,,23.28219178,2002,0.1,1,1,0,0,1,1,1,100,0,0,0,0,0,1,0,0
398,John McCarthy,us USA,GK,LA Galaxy,,32.83561644,1992,8,0,0,0,0,0,0,0,,0,0,0,0,0,0,3,3
399,Jack McGlynn,us USA,"MF,FW",Houston Dynamo,,21.82739726,2003,9.8,17,12,4,10,3,9,14,64.3,5,5,0,5,6,23,7,2
400,Zac McGraw,ca CAN,DF,Portland Timbers,,27.90684932,1997,2.7,6,4,4,2,0,2,2,100,0,6,2,4,4,10,14,1
401,Duncan McGuire,us USA,FW,Orlando City,,24.24383562,2001,3,0,0,0,0,0,0,0,,0,0,0,0,0,0,7,0
402,Paddy McNair,nir NIR,DF,San Diego FC,,30.02191781,1995,9.6,10,3,8,2,0,6,9,66.7,3,7,3,4,6,16,32,2
403,Christopher McVey,se SWE,DF,San Diego FC,,28.0630137,1997,11,20,13,17,3,0,15,21,71.4,6,9,6,3,12,32,33,2
404,Loïc Mesanvi,tg TOG,"FW,DF",Minnesota Utd,,21.57808219,2003,0.1,0,0,0,0,0,0,1,0,1,0,0,0,0,0,0,0
405,Lionel Messi,ar ARG,"FW,MF",Inter Miami,,37.8630137,1987,6.4,5,3,2,1,2,2,4,50,2,3,0,3,0,5,1,1
406,Wyatt Meyer,us USA,MF,Nashville SC,,24.31232877,2001,1.6,1,1,1,0,0,0,0,,0,0,0,0,3,4,3,0
407,Matt Miazga,us USA,DF,FC Cincinnati,,29.79452055,1995,2,3,2,2,1,0,3,3,100,0,2,1,1,2,5,11,0
408,Novak Mićović,rs SRB,GK,LA Galaxy,,23.5260274,2001,3,0,0,0,0,0,0,0,,0,0,0,0,0,0,1,1
409,Alex Mighten,eng ENG,"FW,MF",San Diego FC,,23.06575342,2002,3,3,2,0,2,1,1,3,33.3,2,0,0,0,0,3,0,0
410,Djordje Mihailovic,us USA,"MF,FW",Colorado Rapids,,26.48219178,1998,10.8,4,2,0,3,1,2,6,33.3,4,7,0,7,5,9,7,1
411,Eric Miller,us USA,DF,Portland Timbers,,32.30136986,1993,3.2,4,1,2,1,1,1,5,20,4,3,1,2,2,6,16,0
412,Harbor Miller,us USA,DF,LA Galaxy,,17.87123288,2007,2.7,1,1,1,0,0,0,3,0,3,8,2,6,1,2,9,0
413,Jansen Miller,us USA,DF,Sporting KC,,23.23013699,2002,7.5,15,11,7,7,1,10,13,76.9,3,12,9,3,7,22,55,1
414,Kamal Miller,ca CAN,DF,Portland Timbers,,27.96986301,1997,8.1,3,1,2,1,0,2,5,40,3,7,5,2,12,15,37,1
415,Peyton Miller,us USA,"DF,FW",NE Revolution,,17.97260274,2007,4.8,9,6,6,2,1,5,9,55.6,4,10,2,8,8,17,14,0
416,Georgi Minoungou,ci CIV,"FW,MF",Seattle Sounders,,22.77808219,2002,3.8,7,4,1,2,4,2,3,66.7,1,3,0,3,2,9,2,0
417,Aleksei Miranchuk,ru RUS,"MF,FW",Atlanta Utd,,29.54794521,1995,10.1,12,8,2,7,3,4,10,40,6,1,0,1,6,18,10,1
418,Zane Monlouis,eng ENG,DF,Toronto FC,,21.55068493,2003,3.2,2,0,1,1,0,1,1,100,0,2,1,1,3,5,16,0
419,Shaq Moore,us USA,DF,FC Dallas,,28.50410959,1996,11,20,16,15,2,3,10,16,62.5,6,9,4,5,6,26,46,0
420,Felipe Mora,cl CHI,FW,Portland Timbers,,31.75616438,1993,6.7,2,0,0,1,1,1,1,100,0,1,1,0,2,4,7,0
421,Alfredo Morales,us USA,MF,St. Louis,,34.98082192,1990,5.8,11,2,4,7,0,5,11,45.5,6,8,2,6,7,18,11,0
422,Santi Morales,us USA,"MF,FW",Inter Miami,,18.23287671,2007,0.2,1,1,0,0,1,1,2,50,1,0,0,0,0,1,0,0
423,Maximiliano Moralez,ar ARG,MF,NYCFC,,38.18356164,1987,10.2,15,11,4,9,2,7,18,38.9,11,6,0,6,4,19,2,0
424,Steven Moreira,cv CPV,DF,Columbus Crew,,30.7260274,1994,7.2,6,5,1,2,3,1,9,11.1,8,7,3,4,8,14,14,0
425,Santiago Moreno,co COL,FW,Portland Timbers,,25.03835616,2000,7.9,13,7,7,6,0,6,19,31.6,13,16,0,16,4,17,3,0
426,Lewis Morgan,sct SCO,"MF,FW",NY Red Bulls,,28.59452055,1996,1,1,1,0,1,0,0,1,0,1,6,0,6,0,1,0,0
427,Jordan Morris,us USA,FW,Seattle Sounders,,30.52328767,1994,3.2,3,1,1,1,1,1,2,50,1,1,0,1,1,4,1,0
428,Edwin Mosquera,co COL,FW,Atlanta Utd,,23.85479452,2001,1.1,2,2,1,1,0,0,2,0,2,0,0,0,0,2,0,0
429,Cole Mrowka,us USA,MF,Columbus Crew,,19.07945205,2006,0.3,0,0,0,0,0,0,0,,0,0,0,0,0,0,0,0
430,Hany Mukhtar,de GER,"FW,MF",Nashville SC,,30.12328767,1995,10.8,6,3,2,3,1,2,12,16.7,10,4,0,4,2,8,4,0
431,Daniel Munie,us USA,DF,SJ Earthquakes,,25.23013699,2000,3.4,8,5,5,3,0,2,3,66.7,1,6,2,4,1,9,21,1
432,Luis Muriel,co COL,"FW,MF",Orlando City,,34.05205479,1991,9,9,7,3,3,3,5,6,83.3,1,3,1,2,2,11,12,1
433,Ian Murphy,us USA,DF,Colorado Rapids,,25.29863014,2000,5.1,6,4,5,1,0,4,7,57.1,3,3,3,0,5,11,17,0
434,Jacob Murrell,us USA,"FW,MF",D.C. United,,21.10136986,2004,3.7,5,3,3,1,1,4,5,80,1,3,0,3,1,6,6,0
435,Petar Musa,hr CRO,FW,FC Dallas,,27.16986301,1998,7.5,5,3,2,3,0,3,7,42.9,4,4,2,2,1,6,10,0
436,Daniel Musovski,us USA,FW,Seattle Sounders,,29.42739726,1995,4.7,4,4,0,3,1,0,2,0,2,1,1,0,0,4,2,0
437,Alex Muyl,us USA,"MF,FW",Nashville SC,,29.59452055,1995,9.2,9,6,2,6,1,5,23,21.7,18,12,1,11,9,18,4,0
438,Tristan Muyumba,,MF,Atlanta Utd,,28.16164384,1997,4.7,16,9,7,9,0,7,9,77.8,2,9,1,8,7,23,9,1
439,Darlington Nagbe,us USA,MF,Columbus Crew,,34.79452055,1990,9.7,8,5,2,5,1,2,6,33.3,4,4,0,4,5,13,9,0
440,Andy Najar,hn HON,DF,Nashville SC,,32.1369863,1993,9.1,18,8,5,9,4,8,14,57.1,6,10,2,8,16,34,22,2
441,Matheus Nascimento,br BRA,"FW,MF",LA Galaxy,,21.17260274,2004,1.1,0,0,0,0,0,0,1,0,1,1,1,0,1,1,0,0
442,Rafael Navarro,br BRA,FW,Colorado Rapids,,25.05753425,2000,11,16,13,5,9,2,1,11,9.1,10,12,2,10,7,23,6,0
443,Logan Ndenbe,be BEL,DF,Sporting KC,,25.23287671,2000,9.1,27,20,15,11,1,16,22,72.7,6,9,2,7,11,38,20,0
444,Jalen Neal,us USA,DF,CF Montréal,,21.69589041,2003,0.1,0,0,0,0,0,0,0,,0,0,0,0,0,0,0,0
445,Dylan Nealis,us USA,DF,NY Red Bulls,,26.76438356,1998,6.7,13,11,9,4,0,11,18,61.1,7,4,2,2,3,16,17,0
446,Sean Nealis,us USA,DF,NY Red Bulls,,28.30684932,1997,8,10,6,7,3,0,8,12,66.7,4,3,3,0,10,20,62,0
447,Franco Negri,ar ARG,DF,San Diego FC,,30.20273973,1995,4.5,6,4,2,3,1,2,2,100,0,6,2,4,5,11,7,1
448,Jayden Nelson,ca CAN,FW,Vancouver W'caps,,22.60547945,2002,4.4,7,6,3,2,2,4,8,50,4,4,0,4,2,9,2,0
449,John Nelson,us USA,DF,LA Galaxy,,26.81643836,1998,6.3,10,6,5,5,0,8,10,80,2,7,4,3,2,12,25,0
450,Jean-Claude Ngando,cm CMR,"MF,FW",Vancouver W'caps,,25.45479452,1999,6.7,12,7,5,5,2,6,9,66.7,3,12,4,8,3,15,4,0
451,Serge Ngoma,us USA,"FW,DF",NY Red Bulls,,19.82191781,2005,2.9,3,1,1,2,0,1,3,33.3,2,2,0,2,1,4,3,0
452,Joakim Nilsson,se SWE,"DF,MF",St. Louis,,31.24109589,1994,1.5,5,1,3,2,0,3,6,50,3,3,2,1,3,8,7,0
453,Nolan Norris,us USA,DF,FC Dallas,,20.2109589,2005,4.3,11,9,5,6,0,9,13,69.2,4,7,2,5,5,16,24,0
454,Tsiki Ntsabeleng,za RSA,MF,FC Dallas,,27.23287671,1998,2.1,7,5,3,4,0,3,6,50,3,1,0,1,2,9,2,0
455,Obinna Nwobodo,ng NGA,MF,FC Cincinnati,,28.43013699,1996,4.9,14,10,6,7,1,4,14,28.6,10,5,2,3,8,22,8,0
456,Kevin O'Toole,us USA,DF,NYCFC,,26.3890411,1998,8.2,19,12,5,12,2,12,24,50,12,19,6,13,16,35,35,1
457,Allen Obando,ec ECU,FW,Inter Miami,,18.89315068,2006,1.3,1,1,1,0,0,0,2,0,2,0,0,0,0,1,1,0
458,Jáder Obrian,co COL,"MF,FW",Austin,,29.96438356,1995,4.3,5,4,3,2,0,1,7,14.3,6,2,0,2,1,6,2,0
459,Édier Ocampo,co COL,DF,Vancouver W'caps,,21.58630137,2003,6.6,17,12,12,3,2,11,14,78.6,3,15,3,12,6,23,22,0
460,Agustin Ojeda,ar ARG,FW,NYCFC,,20.87671233,2004,4.7,10,7,3,6,1,6,10,60,4,4,1,3,4,14,4,0
461,Braian Ojeda,py PAR,MF,Real Salt Lake,,24.85479452,2000,9.8,18,11,9,6,3,6,12,50,6,6,1,5,9,27,19,2
462,Martín Ojeda,ar ARG,"MF,FW",Orlando City,,26.43561644,1998,8.9,8,4,2,5,1,2,9,22.2,7,3,0,3,3,11,1,0
463,Tani Oluwaseyi,ca CAN,FW,Minnesota Utd,,24.97260274,2000,9.1,13,8,4,2,7,3,6,50,3,10,4,6,3,16,12,0
464,Wyatt Omsberg,us USA,DF,NE Revolution,,29.61917808,1995,0.4,2,1,1,1,0,0,0,,0,0,0,0,0,2,4,0
465,Kwadwo Opoku,gh GHA,"FW,MF",CF Montréal,,23.8109589,2001,1.6,3,3,0,1,2,1,1,100,0,1,0,1,0,3,2,0
466,Nathan Ordaz,sv SLV,FW,LAFC,,21.30958904,2004,6.1,3,1,0,2,1,2,6,33.3,4,11,1,10,2,5,5,0
467,Sergio Oregel,us USA,MF,Chicago Fire,,19.96986301,2005,9.2,8,2,4,2,2,7,15,46.7,8,9,2,7,10,18,5,3
468,Luca Orellano,ar ARG,"FW,MF",FC Cincinnati,,25.12054795,2000,7.9,5,2,3,2,0,5,7,71.4,2,4,0,4,0,5,5,1
469,Prince Osei Owusu,de GER,FW,CF Montréal,,28.32328767,1997,10.3,8,6,2,4,2,3,5,60,2,5,2,3,2,10,14,0
470,Harold Osorio,sv SLV,MF,Chicago Fire,,21.70684932,2003,0,0,0,0,0,0,0,0,,0,0,0,0,0,0,0,0
471,Jonathan Osorio,ca CAN,MF,Toronto FC,,32.89589041,1992,9,21,8,4,12,5,10,18,55.6,8,4,1,3,6,27,13,0
472,Tomáš Ostrák,cz CZE,"MF,DF",St. Louis,,25.24383562,2000,2.4,8,3,6,0,2,5,9,55.6,4,5,1,4,1,9,3,0
473,Javier Otero,ve VEN,GK,Orlando City,,22.46027397,2002,1,0,0,0,0,0,0,0,,0,0,0,0,0,0,1,0
474,Devin Padelford,us USA,DF,Minnesota Utd,,22.33424658,2003,0,0,0,0,0,0,0,0,,0,0,0,0,0,0,0,0
475,Maarten Paes,id IDN,GK,FC Dallas,,26.97534247,1998,10,1,1,1,0,0,0,1,0,1,0,0,0,0,1,3,0
476,Joseph Paintsil,gh GHA,FW,LA Galaxy,,27.25479452,1998,4.8,3,1,1,2,0,0,0,,0,2,0,2,2,5,1,0
477,Nelson Palacio,co COL,MF,Real Salt Lake,,23.88493151,2001,2.2,4,2,2,1,1,2,7,28.6,5,1,1,0,6,10,2,0
478,Jeison Palacios,co COL,DF,Nashville SC,,31.1260274,1994,4,10,5,6,4,0,6,9,66.7,3,3,2,1,4,14,22,0
479,Sergi Palencia,es ESP,"DF,MF",LAFC,,29.11780822,1996,9.3,31,23,11,15,5,16,25,64,9,13,2,11,13,44,25,1
480,James Pantemis,ca CAN,GK,Portland Timbers,,28.2,1997,9,1,0,1,0,0,1,1,100,0,0,0,0,0,1,7,0
481,Cristhian Paredes,py PAR,MF,Portland Timbers,,26.96438356,1998,1.3,7,3,2,5,0,5,8,62.5,3,3,3,0,6,13,3,0
482,Isaiah Parente,us USA,MF,LA Galaxy,,25.1369863,2000,5.9,11,9,5,5,1,4,13,30.8,9,5,3,2,2,13,3,0
483,Tim Parker,us USA,DF,NY Red Bulls,,32.19452055,1993,2.6,3,3,2,1,0,3,5,60,2,0,0,0,1,4,19,0
484,Keaton Parks,us USA,MF,NYCFC,,27.74520548,1997,9.1,20,10,8,9,3,15,20,75,5,12,4,8,11,31,28,0
485,Marco Pašalić,hr CRO,"FW,MF",Orlando City,,24.63835616,2000,9.4,13,9,5,6,2,5,17,29.4,12,15,0,15,6,19,11,0
486,João Paulo Mior,br BRA,MF,Seattle Sounders,,34.15890411,1991,2.5,6,5,1,5,0,2,4,50,2,5,1,4,4,10,2,0
487,Tom Pearce,eng ENG,"MF,DF",CF Montréal,,27.0630137,1998,3.5,5,1,2,3,0,1,3,33.3,2,4,0,4,1,6,15,0
488,Pedrinho,br BRA,"MF,FW",FC Dallas,,22.04657534,2003,3.5,10,9,4,4,2,3,10,30,7,4,1,3,2,12,3,0
489,Peglow,br BRA,"FW,MF",D.C. United,,23.32328767,2002,6.1,16,11,3,11,2,7,17,41.2,10,7,0,7,1,17,3,0
490,Amahl Pellegrino,no NOR,"MF,FW",SJ Earthquakes,,34.87945205,1990,2.8,5,3,3,2,0,2,4,50,2,1,0,1,5,10,0,1
491,Matti Peltola,fi FIN,"MF,DF",D.C. United,,22.83835616,2002,3.6,11,7,5,4,2,8,9,88.9,1,4,1,3,4,15,4,0
492,Andrés Perea,us USA,MF,NYCFC,,24.47123288,2000,1.5,2,2,0,2,0,1,4,25,3,2,0,2,1,3,2,0
493,Daniel Pereira,ve VEN,MF,Austin,,24.80821918,2000,8.4,14,9,9,3,2,5,11,45.5,6,13,5,8,9,23,8,2
494,Joaquín Pereyra,ar ARG,MF,Minnesota Utd,,26.42465753,1998,8.9,27,13,12,9,6,17,29,58.6,12,12,1,11,9,36,8,0
495,Jonathan Perez,mx MEX,"FW,MF",Nashville SC,,22.29315068,2003,1.8,2,2,0,1,1,1,1,100,0,4,1,3,0,2,1,0
496,Luca Petrasso,ca CAN,DF,CF Montréal,,24.88493151,2000,10.3,14,9,5,7,2,5,13,38.5,8,9,1,8,7,21,31,1
497,Raoul Petretta,it ITA,DF,Toronto FC,,28.11506849,1997,6.9,22,17,13,8,1,13,24,54.2,11,12,3,9,5,27,30,0
498,Fafà Picault,ht HAI,"FW,MF",Inter Miami,,34.19452055,1991,3.6,9,8,2,6,1,3,4,75,1,1,0,1,0,9,6,0
499,Samuel Piette,ca CAN,MF,CF Montréal,,30.47671233,1994,6.3,11,7,1,8,2,6,15,40,9,4,0,4,15,26,16,0
500,Ian Pilcher,us USA,DF,San Diego FC,,22.12328767,2003,1.4,0,0,0,0,0,0,0,,0,0,0,0,1,1,7,0
501,Mauricio Pineda,us USA,MF,Chicago Fire,,27.54794521,1997,7.3,16,7,12,3,1,10,16,62.5,6,9,1,8,8,24,13,1
502,Ariath Piol,au AUS,FW,Real Salt Lake,,20.56438356,2004,5.6,0,0,0,0,0,0,0,,0,4,0,4,1,1,3,0
503,Gabriel Pirani,br BRA,"MF,FW",D.C. United,,23.0630137,2002,6.9,3,2,1,1,1,2,6,33.3,4,0,0,0,3,6,1,0
504,Matt Polster,us USA,MF,NE Revolution,,31.90684932,1993,6.8,16,5,4,9,3,6,11,54.5,5,7,2,5,10,26,14,0
505,Célio Pompeu,br BRA,"MF,FW",St. Louis,,25.4,1999,3.6,4,3,2,1,1,1,3,33.3,2,1,0,1,1,5,5,0
506,Ezequiel Ponce,ar ARG,FW,Houston Dynamo,,28.10136986,1997,10.9,4,4,2,2,0,1,6,16.7,5,1,0,1,2,6,5,0
507,Alvas Powell,jm JAM,DF,FC Cincinnati,,30.79726027,1994,2.7,10,5,7,1,2,6,10,60,4,4,0,4,2,12,16,0
508,Ralph Priso-Mbongue,ca CAN,MF,Vancouver W'caps,,22.75616438,2002,3.7,11,7,4,5,2,5,10,50,5,1,1,0,5,16,8,1
509,Andrew Privett,us USA,DF,Charlotte,,24.75616438,2000,9,11,7,8,2,1,6,10,60,4,11,5,6,8,19,48,2
510,John Pulskamp,us USA,GK,Sporting KC,,24.04383562,2001,11,0,0,0,0,0,0,0,,0,1,0,1,0,0,9,1
511,Ahmed Qasem,se SWE,"MF,FW",Nashville SC,,21.81369863,2003,5.6,6,5,2,4,0,3,5,60,2,6,3,3,5,11,3,0
512,Philip Quinton,us USA,DF,Real Salt Lake,,25.46575342,1999,6,3,3,1,2,0,1,5,20,4,11,8,3,5,8,39,0
513,Nemanja Radoja,rs SRB,MF,Sporting KC,,32.24109589,1993,7.2,19,14,8,9,2,9,13,69.2,4,9,2,7,8,27,11,0
514,Jeremy Rafanello,us USA,MF,Philadelphia Union,,25.05753425,2000,0.3,0,0,0,0,0,0,2,0,2,1,0,1,0,0,2,0
515,Jackson Ragen,us USA,DF,Seattle Sounders,,26.6109589,1998,6.7,8,6,5,1,2,6,6,100,0,14,5,9,3,11,18,1
516,Brooklyn Raines,us USA,MF,Houston Dynamo,,20.15068493,2005,3.7,7,6,2,4,1,7,10,70,3,3,1,2,4,11,2,0
517,Christian Ramirez,us USA,FW,LA Galaxy,,34.08493151,1991,6.6,4,2,0,2,2,2,4,50,2,3,0,3,2,6,6,0
518,Rubén Ramos,us USA,MF,LA Galaxy,,18.28219178,2007,0.7,0,0,0,0,0,0,0,,0,1,0,1,0,0,0,0
519,Tim Ream,us USA,DF,Charlotte,,37.58082192,1987,9.3,18,10,10,6,2,11,22,50,11,12,6,6,11,29,31,0
520,Federico Redondo,ar ARG,MF,Inter Miami,,22.29315068,2003,4.1,5,3,2,1,2,4,7,57.1,3,2,1,1,6,11,7,0
521,Seymour Reid,jm JAM,FW,NYCFC,,17.16986301,2008,0.2,0,0,0,0,0,0,0,,0,0,0,0,0,0,0,0
522,William Reilly,us USA,MF,Atlanta Utd,,22.41917808,2002,1,3,2,1,2,0,3,5,60,2,4,3,1,4,7,2,0
523,Marco Reus,de GER,"MF,FW",LA Galaxy,,35.92876712,1989,3.6,5,3,1,2,2,2,2,100,0,1,1,0,0,5,3,0
524,Andrés Reyes,co COL,DF,San Diego FC,,25.65479452,1999,0.5,0,0,0,0,0,0,0,,0,1,1,0,0,0,1,0
525,Justin Reynolds,us USA,DF,Chicago Fire,,20.75068493,2004,1.2,1,1,1,0,0,1,1,100,0,3,1,2,1,2,4,0
526,Andrew Rick,us USA,GK,Philadelphia Union,,19.26027397,2006,2,0,0,0,0,0,0,1,0,1,0,0,0,0,0,1,1
527,Jamar Ricketts,us USA,"DF,MF",SJ Earthquakes,,23.52876712,2001,4.4,11,6,2,9,0,4,9,44.4,5,6,1,5,9,20,14,0
528,Kalani Rienzi,us USA,"MF,DF",Seattle Sounders,,22.85479452,2002,4.6,15,10,7,3,5,10,17,58.8,7,4,1,3,9,24,9,0
529,Rocco Ríos Novo,ar ARG,GK,Inter Miami,,22.91780822,2002,1.6,0,0,0,0,0,0,0,,0,0,0,0,0,0,1,0
530,Birk Risa,no NOR,"DF,MF",NYCFC,,27.22191781,1998,5.1,6,3,4,2,0,5,8,62.5,3,8,8,0,6,12,30,0
531,Reid Roberts,us USA,DF,SJ Earthquakes,,21.40273973,2003,1.1,5,3,2,3,0,2,2,100,0,0,0,0,1,6,5,0
532,Miles Robinson,us USA,DF,FC Cincinnati,,28.14246575,1997,8.2,16,11,9,6,1,9,11,81.8,2,14,10,4,15,31,61,0
533,Stian Rode Gregersen,no NOR,DF,Atlanta Utd,,29.96712329,1995,6.8,13,10,5,8,0,4,7,57.1,3,6,4,2,10,23,27,0
534,Rodrigues,br BRA,DF,SJ Earthquakes,,27.56712329,1997,7.5,25,17,15,8,2,16,25,64,9,16,7,9,21,46,28,0
535,Jonathan Rodríguez,uy URU,FW,Portland Timbers,,31.83013699,1993,1,0,0,0,0,0,0,1,0,1,0,0,0,0,0,1,0
536,Memo Rodriguez,us USA,MF,Sporting KC,,29.35342466,1995,3,10,7,4,4,2,6,12,50,6,0,0,0,0,10,1,0
537,Nicolás Rodríguez,co COL,"DF,FW",Orlando City,,21.02739726,2004,0.3,0,0,0,0,0,0,0,,0,1,0,1,0,0,0,0
538,Sam Rogers,us USA,DF,Chicago Fire,,25.96712329,1999,7,5,4,4,1,0,2,6,33.3,4,10,6,4,13,18,34,1
539,Alex Roldan,sv SLV,"MF,DF",Seattle Sounders,,28.76986301,1996,6.1,13,13,5,5,3,5,10,50,5,11,2,9,11,24,20,2
540,Cristian Roldan,us USA,"MF,FW",Seattle Sounders,,29.92054795,1995,10.1,24,11,8,12,4,15,26,57.7,11,12,1,11,11,35,14,0
541,Nicolás Romero,ar ARG,DF,Minnesota Utd,,21.43287671,2003,6.8,6,2,6,0,0,4,7,57.1,3,9,5,4,10,16,45,1
542,David Romney,us USA,DF,SJ Earthquakes,,31.89589041,1993,11,7,2,3,4,0,5,7,71.4,2,18,10,8,8,15,70,1
543,Connor Ronan,ie IRL,"MF,FW",Colorado Rapids,,27.16438356,1998,1.2,3,1,2,1,0,2,4,50,2,3,3,0,1,4,3,0
544,Anderson Rosa,br BRA,DF,Colorado Rapids,,23.4739726,2001,0.3,1,0,0,1,0,0,0,,0,0,0,0,0,1,0,0
545,Joseph Rosales,hn HON,DF,Minnesota Utd,,24.49315068,2000,5.9,22,12,14,6,2,11,19,57.9,8,6,0,6,7,29,14,0
546,Keegan Rosenberry,us USA,DF,Colorado Rapids,,31.39726027,1993,7.4,5,3,4,1,0,4,9,44.4,5,18,10,8,14,19,32,0
547,Daniel Rosero,co COL,DF,Sporting KC,,31.57808219,1993,1.8,5,2,4,1,0,3,4,75,1,1,1,0,6,11,8,0
548,Diego Rossi,uy URU,"FW,MF",Columbus Crew,,27.16712329,1998,10.8,3,1,0,1,2,2,6,33.3,4,10,0,10,3,6,4,0
549,Sigurd Rosted,no NOR,DF,Toronto FC,,30.78630137,1994,8,12,6,7,4,1,7,10,70,3,11,9,2,14,26,46,0
550,Paul Rothrock,us USA,"MF,FW",Seattle Sounders,,26.31780822,1999,9.2,8,5,2,4,2,4,14,28.6,10,9,0,9,6,14,8,0
551,Kye Rowles,au AUS,DF,D.C. United,,26.8630137,1998,9,11,8,5,4,2,8,13,61.5,5,6,4,2,16,27,60,0
552,Diego Rubio,cl CHI,"FW,MF",Austin,,31.97260274,1993,1.6,4,2,4,0,0,0,4,0,4,1,0,1,1,5,2,0
553,Pablo Ruíz,ar ARG,MF,Real Salt Lake,,26.37260274,1998,2.1,3,2,1,2,0,0,5,0,5,3,0,3,2,5,0,0
554,David Ruíz-Ochoa,hn HON,"MF,FW",Inter Miami,,21.23561644,2004,0.8,3,1,2,1,0,2,3,66.7,1,0,0,0,1,4,0,0
555,Albert Rusnák,sk SVK,"FW,MF",Seattle Sounders,,30.82739726,1994,7.8,3,1,0,1,2,2,2,100,0,1,0,1,0,3,2,0
556,Jacen Russell-Rowe,ca CAN,FW,Columbus Crew,,22.64109589,2002,9.5,6,1,1,4,1,3,5,60,2,4,1,3,0,6,5,0
557,Cesar Ruvalcaba,us USA,DF,Columbus Crew,,23.8109589,2001,1.6,3,2,3,0,0,1,2,50,1,6,1,5,1,4,4,0
558,Emmanuel Sabbi,us USA,FW,Vancouver W'caps,,27.36164384,1997,4,10,8,2,6,2,3,7,42.9,4,2,0,2,2,12,7,0
559,Besard Sabovic,se SWE,MF,Austin,,27.32876712,1998,7.3,16,8,7,8,1,10,13,76.9,3,9,0,9,7,23,14,0
560,Anisse Saidi,tn TUN,MF,San Diego FC,,16.8739726,2008,0.1,0,0,0,0,0,0,0,,0,0,0,0,0,0,0,0
561,Adam Saldaña,us USA,MF,LAFC,,23.23835616,2002,2,5,4,3,2,0,4,5,80,1,4,1,3,1,6,3,1
562,Nathan-Dylan Saliba,ca CAN,MF,CF Montréal,,20.68219178,2004,9.3,25,16,4,17,4,12,20,60,8,9,1,8,7,32,10,1
563,Dániel Sallói,hu HUN,"FW,MF",Sporting KC,,28.79452055,1996,7.6,7,4,5,0,2,2,6,33.3,4,6,0,6,5,12,5,0
564,Lucas Sanabria,uy URU,"MF,FW",LA Galaxy,,21.35616438,2003,2.5,6,4,3,1,2,5,7,71.4,2,3,0,3,4,10,4,0
565,Ilie Sánchez,es ESP,MF,Austin,,34.45205479,1990,6.5,13,8,6,5,2,4,10,40,6,6,2,4,8,21,9,0
566,William Sands,us USA,DF,NE Revolution,,24.83013699,2000,3.2,6,4,2,4,0,3,4,75,1,3,3,0,5,11,16,0
567,Edvard Sandvik Tagseth,no NOR,MF,Nashville SC,,24.27945205,2001,10.1,27,16,10,16,1,12,24,50,12,14,0,14,12,39,18,0
568,Jeong Sangbin,kr KOR,"FW,MF",Minnesota Utd,,23.09315068,2002,2,2,1,0,1,1,1,4,25,3,1,0,1,0,2,2,0
569,Sergio Santos Gomes,br BRA,"FW,MF",FC Cincinnati,,30.66575342,1994,3.8,12,7,1,9,2,5,10,50,5,3,1,2,0,12,3,0
570,Rafael Santos,br BRA,DF,Orlando City,,27.24383562,1998,5.4,15,8,11,1,3,7,10,70,3,4,1,3,6,21,17,0
571,Nick Scardina,us USA,DF,Charlotte,,23.86849315,2001,2.3,4,3,3,1,0,3,7,42.9,4,0,0,0,1,5,6,0
572,Rodrigo Schlegel,ar ARG,DF,Orlando City,,28.08767123,1997,9.5,10,5,7,3,0,4,11,36.4,7,11,5,6,6,16,72,1
573,David Schnegg,at AUT,"DF,MF",D.C. United,,26.59726027,1998,10.8,33,25,12,9,12,23,35,65.7,12,18,3,15,14,47,41,0
574,Patrick Schulte,us USA,GK,Columbus Crew,,24.14520548,2001,10,0,0,0,0,0,0,1,0,1,0,0,0,0,0,6,3
575,Tarik Scott,us USA,"DF,FW",FC Dallas,,20.03287671,2005,0.2,1,1,1,0,0,0,1,0,1,0,0,0,1,2,0,0
576,Dante Sealy,us USA,"FW,DF",CF Montréal,,22.04931507,2003,7.8,13,10,5,6,2,6,11,54.5,5,8,0,8,4,17,7,0
577,Gabe Segal,us USA,"FW,MF",Houston Dynamo,,23.96712329,2001,0.3,0,0,0,0,0,0,0,,0,0,0,0,0,0,0,0
578,Telasco Segovia,ve VEN,"MF,FW",Inter Miami,,22.09041096,2003,5.2,10,6,3,5,2,5,11,45.5,6,4,1,3,2,12,0,1
579,Eddie Segura,co COL,DF,LAFC,,28.25205479,1997,6.4,6,2,3,3,0,4,7,57.1,3,14,6,8,9,15,23,0
580,Amar Sejdic,us USA,"MF,FW",Columbus Crew,,28.43013699,1996,0.1,0,0,0,0,0,0,0,,0,0,0,0,0,0,1,0
581,Brandon Servania,us USA,MF,D.C. United,,26.14794521,1999,5.9,17,10,6,8,3,6,10,60,4,6,1,5,4,21,4,1
582,Jacob Shaffelburg,ca CAN,"FW,MF",Nashville SC,,25.43835616,1999,2.9,7,4,1,3,3,1,5,20,4,8,1,7,1,8,3,0
583,Charles Sharp,us USA,FW,Toronto FC,,23.86575342,2001,1.1,0,0,0,0,0,0,0,,0,0,0,0,1,1,1,0
584,Samuel Shashoua,eng ENG,"MF,FW",Minnesota Utd,,25.97808219,1999,1.2,2,1,1,1,0,1,3,33.3,2,2,0,2,2,4,0,0
585,Khiry Shelton,us USA,DF,Sporting KC,,31.85753425,1993,4.4,3,1,2,1,0,1,5,20,4,3,0,3,11,14,7,0
586,Jonathan Shore,us USA,MF,NYCFC,,18.06027397,2007,7.7,31,16,11,16,4,16,29,55.2,13,6,2,4,7,38,10,1
587,Show,ao ANG,MF,FC Dallas,,26.16438356,1999,2.2,2,2,0,1,1,1,1,100,0,2,0,2,1,3,0,0
588,Xande Silva,pt POR,FW,Atlanta Utd,,28.1369863,1997,2.5,5,2,4,1,0,2,4,50,2,1,0,1,2,7,3,1
589,Xande Silva,pt POR,DF,St. Louis,,28.1369863,1997,0.2,2,1,0,2,0,2,2,100,0,0,0,0,0,2,0,0
590,Jonathan Sirois,ca CAN,GK,CF Montréal,,23.85479452,2001,10,0,0,0,0,0,0,0,,0,0,0,0,0,0,5,4
591,Jack Skahan,us USA,MF,SJ Earthquakes,,27.23835616,1998,0.1,0,0,0,0,0,0,0,,0,0,0,0,0,0,0,0
592,Bartosz Slisz,pl POL,MF,Atlanta Utd,,26.10136986,1999,8.2,20,11,10,8,2,7,8,87.5,1,13,3,10,13,33,21,1
593,Tyger Smalls,,"FW,MF",Charlotte,,0,,0.6,1,1,0,0,1,0,1,0,1,1,0,1,0,1,3,0
594,Alec Smir,us USA,GK,Minnesota Utd,,26.06027397,1999,1,0,0,0,0,0,0,0,,0,0,0,0,0,0,1,0
595,Brad Smith,au AUS,"DF,MF",FC Cincinnati,,31.07123288,1994,1.4,0,0,0,0,0,0,0,,0,0,0,0,0,0,1,0
596,Ian Smith,us USA,DF,Portland Timbers,,22.80273973,2002,3.3,6,3,4,1,1,2,4,50,2,6,2,4,3,9,12,0
597,Kyle Smith,us USA,"DF,MF",Orlando City,,33.31780822,1992,4.5,10,8,8,2,0,6,10,60,4,7,0,7,2,12,14,0
598,Artem Smoliakov,ua UKR,"DF,MF",LAFC,,21.93424658,2003,2.9,0,0,0,0,0,0,0,,0,5,2,3,2,2,11,0
599,Mohammed Sofo,gh GHA,FW,NY Red Bulls,,20.50958904,2004,2.6,9,6,4,2,3,2,4,50,2,5,0,5,1,10,0,0
600,Tyrese Spicer,tt TRI,"FW,MF",Toronto FC,,24.41643836,2000,3.5,6,2,1,3,2,2,4,50,2,4,0,4,3,9,4,0
601,Dayne St. Clair,ca CAN,GK,Minnesota Utd,,27.9890411,1997,10,0,0,0,0,0,0,0,,0,0,0,0,0,0,0,0
602,Lazar Stefanovic,ca CAN,"DF,MF",Toronto FC,,18.73424658,2006,1.2,5,2,2,3,0,3,3,100,0,0,0,0,2,7,5,0
603,Zack Steffen,us USA,GK,Colorado Rapids,,30.09041096,1995,9,0,0,0,0,0,0,0,,0,0,0,0,0,0,4,0
604,Daniel Steres,us USA,DF,Houston Dynamo,,34.47945205,1990,3.4,5,1,3,2,0,3,6,50,3,4,2,2,4,9,17,2
605,Kimani Stewart-Baynes,ca CAN,"MF,FW",Colorado Rapids,,20.29589041,2005,0.2,0,0,0,0,0,0,0,,0,0,0,0,0,0,0,0
606,Jared Stroud,us USA,"FW,MF",D.C. United,,28.81917808,1996,7.2,12,9,10,2,0,3,11,27.3,8,8,1,7,1,13,3,0
607,Peter Stroud,us USA,MF,NY Red Bulls,,23.03287671,2002,7.9,25,19,6,16,3,11,25,44,14,9,1,8,14,39,13,0
608,Brad Stuver,us USA,GK,Austin,,34.05205479,1991,11,0,0,0,0,0,0,0,,0,0,0,0,0,0,4,3
609,Luis Suárez,uy URU,FW,Inter Miami,,38.27671233,1987,7.3,10,7,5,4,1,5,5,100,0,3,0,3,0,10,4,0
610,Magomed-Shapi Suleymanov,ru RUS,"FW,MF",Sporting KC,,25.38356164,1999,8.4,13,5,6,4,3,6,8,75,2,3,0,3,5,18,6,0
611,Cavan Sullivan,us USA,"MF,FW",Philadelphia Union,,15.6,2009,0.5,2,0,0,2,0,1,5,20,4,2,0,2,0,2,0,0
612,Quinn Sullivan,us USA,MF,Philadelphia Union,,21.10684932,2004,10.3,21,16,5,13,3,9,17,52.9,8,15,0,15,1,22,10,0
613,Finn Surman,nz NZL,DF,Portland Timbers,,21.61369863,2003,10.7,8,6,6,1,1,5,8,62.5,3,15,9,6,6,14,90,1
614,Sam Surridge,eng ENG,FW,Nashville SC,,26.76986301,1998,10.7,11,5,3,5,3,5,7,71.4,2,10,0,10,4,15,8,0
615,Oleksandr Svatok,ua UKR,DF,Austin,,30.60273973,1994,7.7,12,3,9,2,1,2,3,66.7,1,5,3,2,9,21,52,0
616,Erik Sviatchenko,dk DEN,DF,Houston Dynamo,,33.58356164,1991,5.5,10,3,9,1,0,5,6,83.3,1,6,5,1,7,17,30,1
617,Hennadii Synchuk,ua UKR,FW,CF Montréal,,18.81917808,2006,1.3,5,2,2,1,2,2,4,50,2,2,0,2,0,5,0,0
618,Nkosi Tafari,us USA,DF,LAFC,,28.11780822,1997,4.9,12,5,9,2,1,6,9,66.7,3,7,7,0,5,17,29,0
619,Zakaria Taifi,us USA,DF,Orlando City,,19.59178082,2005,0.1,0,0,0,0,0,0,0,,0,1,0,1,0,0,1,0
620,Yohei Takaoka,jp JPN,GK,Vancouver W'caps,,29.1369863,1996,11,0,0,0,0,0,0,0,,0,0,0,0,0,0,8,0
621,Strahinja Tanasijević,rs SRB,DF,NYCFC,,27.89589041,1997,2.2,1,0,1,0,0,1,1,100,0,1,0,1,2,3,14,0
622,Andrew Tarbell,us USA,GK,Houston Dynamo,,31.57534247,1993,3.4,0,0,0,0,0,0,1,0,1,0,0,0,0,0,1,0
623,Iuri Tavares,cv CPV,"FW,MF",Charlotte,,24.15890411,2001,0.3,1,0,0,0,1,0,0,,0,2,0,2,1,2,0,0
624,D.J. Taylor,us USA,DF,Minnesota Utd,,27.69041096,1997,0.7,1,1,1,0,0,1,2,50,1,1,0,1,1,2,3,0
625,Robert Taylor,fi FIN,FW,Austin,,30.5369863,1994,0.3,1,1,0,1,0,0,1,0,1,0,0,0,0,1,0,0
626,Robert Taylor,fi FIN,"MF,FW",Inter Miami,,30.5369863,1994,2.2,5,2,3,2,0,3,4,75,1,1,0,1,1,6,0,0
627,Carlos Terán,co COL,DF,Chicago Fire,,24.6109589,2000,3.3,6,3,4,2,0,2,7,28.6,5,2,1,1,8,14,15,1
628,Cedric Teuchert,de GER,"FW,MF",St. Louis,,28.30410959,1997,5.9,2,2,0,1,1,1,3,33.3,2,5,0,5,0,2,4,0
629,Odin Thiago Holm,no NOR,"MF,FW",LAFC,,22.29315068,2003,1.1,6,4,3,1,2,3,3,100,0,3,1,2,2,8,2,0
630,Jamal Thiaré,sn SEN,"FW,DF",Atlanta Utd,,32.09589041,1993,1.6,0,0,0,0,0,0,0,,0,0,0,0,0,0,0,0
631,Andrew Thomas,ru RUS,GK,Seattle Sounders,,26.6739726,1998,1,0,0,0,0,0,0,0,,0,0,0,0,0,0,0,1
632,Erik Thommy,de GER,"FW,MF",Sporting KC,,30.70684932,1994,5.6,10,6,1,5,4,2,8,25,6,11,1,10,2,12,5,0
633,Kosi Thompson,ca CAN,DF,Toronto FC,,22.26849315,2003,7.8,24,9,14,8,2,14,24,58.3,10,11,4,7,6,30,25,1
634,Timmy Tillman,de GER,MF,LAFC,,26.33150685,1999,8.3,14,12,5,5,4,8,14,57.1,6,16,1,15,8,22,8,1
635,Cayman Togashi,jp JPN,"MF,FW",Atlanta Utd,,31.73424658,1993,0.7,1,0,1,0,0,0,0,,0,0,0,0,0,1,0,0
636,Nouhou Tolo,cm CMR,DF,Seattle Sounders,,27.86575342,1997,8.7,11,8,7,3,1,7,11,63.6,4,8,8,0,5,16,28,1
637,Tomas Totland,no NOR,DF,St. Louis,,26.6,1998,3.7,3,3,1,2,0,1,3,33.3,2,9,1,8,5,8,7,0
638,Mason Toye,us USA,FW,Sporting KC,,26.55068493,1998,0.2,0,0,0,0,0,0,1,0,1,0,0,0,1,1,0,0
639,Wil Trapp,us USA,MF,Minnesota Utd,,32.30136986,1993,9.7,22,14,14,5,3,11,25,44,14,6,2,4,20,42,22,1
640,Jackson Travis,us USA,DF,Colorado Rapids,,21.19452055,2004,1.5,4,3,3,1,0,1,4,25,3,2,0,2,2,6,3,0
641,Niko Tsakiris,us USA,MF,SJ Earthquakes,,19.87671233,2005,2.7,4,3,1,3,0,0,1,0,1,2,0,2,0,4,1,0
642,Garrison Tubbs,us USA,DF,D.C. United,,23.2109589,2002,0.5,1,0,1,0,0,0,0,,0,1,1,0,2,3,3,0
643,Jeppe Tverskov,dk DEN,MF,San Diego FC,,32.14794521,1993,10.8,27,19,12,12,3,13,23,56.5,10,11,3,8,27,54,20,2
644,Mikael Uhre,dk DEN,FW,Philadelphia Union,,30.59452055,1994,6.8,8,7,3,1,4,2,6,33.3,4,4,0,4,0,8,3,0
645,Cengiz Ünder,tr TUR,FW,LAFC,,27.80821918,1997,3.4,0,0,0,0,0,0,0,,0,0,0,0,3,3,1,0
646,Osaze Urhoghide,nl NED,DF,FC Dallas,,24.83561644,2000,11,19,15,14,4,1,7,14,50,7,14,9,5,10,29,71,0
647,Maximiliano Urruti,ar ARG,FW,NE Revolution,,34.19726027,1991,4,5,4,1,2,2,1,8,12.5,7,1,0,1,3,8,2,0
648,Júnior Urso,br BRA,MF,Houston Dynamo,,36.15342466,1989,2.2,6,4,3,2,1,3,4,75,1,3,1,2,2,8,4,0
649,Óscar Ustari,ar ARG,GK,Inter Miami,,38.83835616,1986,6.4,0,0,0,0,0,0,0,,0,0,0,0,0,0,4,0
650,Myrto Uzuni,al ALB,FW,Austin,,29.92876712,1995,7.8,6,2,4,1,1,4,9,44.4,5,4,1,3,4,10,7,0
651,Onni Valakari,fi FIN,"FW,MF",San Diego FC,,25.71232877,1999,7.3,10,3,3,4,3,3,10,30,7,7,2,5,2,12,6,0
652,Omar Valencia,pa PAN,DF,NY Red Bulls,,20.90684932,2004,7.1,16,11,8,6,2,6,11,54.5,5,12,1,11,10,26,13,0
653,Gerardo Valenzuela,us USA,MF,FC Cincinnati,,20.6,2004,1.5,1,1,1,0,0,0,0,,0,3,0,3,0,1,1,1
654,Kerwin Vargas,co COL,"FW,MF",Charlotte,,23.3369863,2002,4.5,5,3,2,1,2,3,9,33.3,6,10,2,8,2,7,6,0
655,Obed Vargas,mx MEX,MF,Seattle Sounders,,19.74794521,2005,8.8,22,15,7,9,6,11,17,64.7,6,7,0,7,16,38,9,2
656,Indiana Vassilev,us USA,MF,Philadelphia Union,,24.21369863,2001,6.1,6,4,3,3,0,4,7,57.1,3,4,0,4,4,10,3,0
657,Brandon Vazquez,us USA,FW,Austin,,26.55616438,1998,9.7,8,4,3,2,3,4,12,33.3,8,12,3,9,9,17,17,0
658,Brayan Vera,co COL,DF,Real Salt Lake,,26.30136986,1999,6.7,10,9,5,5,0,4,6,66.7,2,9,5,4,9,19,28,1
659,Oscar Verhoeven,us USA,DF,San Diego FC,,18.92876712,2006,0.3,0,0,0,0,0,0,0,,0,0,0,0,0,0,0,0
660,Oscar Verhoeven,us USA,MF,SJ Earthquakes,,18.92876712,2006,0.1,0,0,0,0,0,0,0,,0,0,0,0,0,0,0,0
661,Ranko Veselinović,rs SRB,DF,Vancouver W'caps,,26.11506849,1999,10,9,4,5,3,1,2,3,66.7,1,4,4,0,8,17,47,0
662,Jules-Anthony Vilsaint,ca CAN,"FW,MF",CF Montréal,,22.3260274,2003,1.3,1,0,0,0,1,0,0,,0,0,0,0,0,1,0,0
663,Sam Vines,us USA,DF,Colorado Rapids,,25.92876712,1999,2.4,1,0,1,0,0,1,3,33.3,2,4,2,2,4,5,3,0
664,Pedro Vite,ec ECU,"MF,FW",Vancouver W'caps,,23.15616438,2002,8.1,10,6,3,4,3,7,12,58.3,5,8,1,7,5,15,3,0
665,Robert Voloder,ba BIH,DF,Sporting KC,,23.9890411,2001,6.5,6,5,5,1,0,1,5,20,4,4,2,2,12,18,35,0
666,Giacomo Vrioni,al ALB,"FW,MF",CF Montréal,,26.55342466,1998,0.9,0,0,0,0,0,0,0,,0,0,0,0,0,0,0,0
667,Kai Wagner,de GER,DF,Philadelphia Union,,28.21643836,1997,8.9,28,23,12,11,5,12,28,42.9,16,18,1,17,12,40,37,2
668,Conrad Wallem,no NOR,"DF,MF",St. Louis,,24.90410959,2000,9.2,11,6,6,3,2,4,11,36.4,7,13,5,8,8,19,22,0
669,Joel Waterman,ca CAN,DF,CF Montréal,,29.27671233,1996,8.4,6,4,4,1,1,2,8,25,6,11,5,6,12,18,39,0
670,Akil Watts,us USA,"MF,DF",St. Louis,,25.24657534,2000,8.8,13,8,8,3,2,6,14,42.9,8,13,3,10,11,24,16,0
671,Marcelo Weigandt,ar ARG,DF,Inter Miami,,25.31232877,2000,2.5,6,1,2,3,1,2,4,50,2,2,0,2,1,7,5,0
672,Francis Westfield,us USA,DF,Philadelphia Union,,19.40273973,2005,8.7,15,10,5,7,3,9,13,69.2,4,12,6,6,2,17,37,0
673,Ashley Westwood,eng ENG,MF,Charlotte,,35.09315068,1990,11,12,7,6,5,1,9,13,69.2,4,10,6,4,11,23,13,0
674,Brian White,us USA,FW,Vancouver W'caps,,29.24931507,1996,7.9,2,1,0,1,1,1,3,33.3,2,8,1,7,2,4,14,0
675,Adrian Wibowo,us USA,FW,LAFC,,19.29589041,2006,0.2,0,0,0,0,0,0,0,,0,0,0,0,0,0,0,0
676,Derrick Williams,ie IRL,DF,Atlanta Utd,,32.29589041,1993,6.1,7,4,6,1,0,2,4,50,2,6,1,5,4,11,29,1
677,Samuel Williams,us USA,MF,Chicago Fire,,20.13150685,2005,2.6,3,1,1,2,0,2,3,66.7,1,4,0,4,2,5,2,0
678,Thomas Williams,us USA,DF,Orlando City,,20.72054795,2004,0.1,1,0,1,0,0,0,0,,0,0,0,0,1,2,3,0
679,Eryk Williamson,us USA,"MF,FW",Charlotte,,27.89863014,1997,2.1,2,2,0,1,1,0,1,0,1,1,0,1,2,4,2,0
680,Joe Willis,us USA,GK,Nashville SC,,36.73424658,1988,11,1,1,1,0,0,0,1,0,1,0,0,0,0,1,4,0
681,Bruno Wilson,pt POR,DF,SJ Earthquakes,,28.35342466,1996,8,9,4,7,1,1,4,5,80,1,9,4,5,18,27,56,1
682,Henry Wingo,us USA,DF,Toronto FC,,29.58356164,1995,2.5,3,3,0,3,0,2,3,66.7,1,1,0,1,2,5,10,1
683,Hannes Wolf,at AUT,FW,NYCFC,,26.05205479,1999,10.4,20,14,4,12,4,10,25,40,15,13,1,12,9,29,10,0
684,Owen Wolff,us USA,"MF,FW",Austin,,20.34520548,2004,10,15,9,6,7,2,6,15,40,9,17,0,17,7,22,10,1
685,Tyler Wolff,us USA,"FW,MF",Real Salt Lake,,22.22191781,2003,2.3,6,2,3,1,2,3,3,100,0,4,1,3,3,9,4,0
686,Elijah Wynder,us USA,MF,LA Galaxy,,22.15342466,2003,2.5,4,3,3,0,1,3,5,60,2,5,1,4,1,5,4,0
687,Miki Yamane,jp JPN,DF,LA Galaxy,,31.36712329,1993,7.3,19,13,7,9,3,8,17,47.1,9,9,0,9,10,29,27,1
688,Dominik Yankov,bg BUL,MF,CF Montréal,,24.76986301,2000,0.3,0,0,0,0,0,0,0,,0,0,0,0,0,0,0,0
689,Darren Yapi,us USA,FW,Colorado Rapids,,20.45753425,2004,3.6,5,4,0,3,2,0,1,0,1,4,1,3,2,7,2,0
690,Joshua Yaro,gh GHA,DF,St. Louis,,30.46027397,1994,7.1,8,4,5,3,0,6,7,85.7,1,12,6,6,9,17,37,1
691,Patrick Yazbek,au AUS,MF,Nashville SC,,23.08219178,2002,6.3,6,3,1,3,2,4,13,30.8,9,9,5,4,8,14,7,0
692,Kelvin Yeboah,it ITA,FW,Minnesota Utd,,24.99726027,2000,8.6,8,8,1,2,5,2,4,50,2,9,0,9,2,10,3,0
693,Yaw Yeboah,gh GHA,"MF,FW",LAFC,,28.10410959,1997,3.2,4,2,3,1,0,2,5,40,3,4,0,4,2,6,2,0
694,DeAndre Yedlin,us USA,DF,FC Cincinnati,,31.82191781,1993,9.8,14,7,6,5,3,6,14,42.9,8,10,1,9,3,17,24,1
695,Maya Yoshida,jp JPN,DF,LA Galaxy,,36.69589041,1988,7,2,2,0,2,0,0,3,0,3,7,5,2,6,8,36,0
696,Jackson Yueill,us USA,MF,NE Revolution,,28.12876712,1997,4.2,2,0,0,2,0,1,3,33.3,2,4,0,4,4,6,6,0
697,Alhassan Yusuf,ng NGA,MF,NE Revolution,,24.79726027,2000,9.9,20,13,7,11,2,7,19,36.8,12,15,0,15,12,32,22,0
698,Wilfried Zaha,ci CIV,"FW,MF",Charlotte,,32.48219178,1992,9,11,8,2,6,3,4,14,28.6,10,9,0,9,3,14,4,1
699,Eriq Zavaleta,sv SLV,DF,LA Galaxy,,32.75616438,1992,1.4,1,1,1,0,0,1,2,50,1,2,2,0,2,3,3,0
700,Sean Zawadzki,us USA,"DF,MF",Columbus Crew,,25.03835616,2000,11,26,13,14,9,3,8,12,66.7,4,9,1,8,11,37,39,1
701,Walker Zimmerman,us USA,DF,Nashville SC,,31.96164384,1993,6.9,9,7,8,1,0,5,8,62.5,3,5,4,1,9,18,56,0
702,Philip Zinckernagel,dk DEN,FW,Chicago Fire,,30.38356164,1994,8.5,14,6,5,5,4,5,18,27.8,13,8,1,7,2,16,4,2
703,Rida Zouhir,ca CAN,"MF,FW",D.C. United,,21.44657534,2003,1,1,0,0,1,0,1,3,33.3,2,2,1,1,2,3,2,0
1,Brenden Aaronson,us USA,MF,Leeds United,,24.53150685,2000,39.5,57,33,18,24,15,17,50,34,33,40,1,39,8,65,8,1
2,Thelo Aasgaard,no NOR,"MF,FW",Luton Town,,23.00547945,2002,16.8,20,10,4,10,6,10,20,50,10,26,6,20,9,29,30,0
3,James Abankwah,ie IRL,DF,Watford,,21.29589041,2004,15.4,25,22,19,5,1,11,13,84.6,2,30,13,17,9,34,88,5
4,Salis Abdul Samed,gh GHA,MF,Sunderland,,25.10684932,2000,3.1,2,0,1,1,0,1,1,100,0,1,0,1,2,4,6,0
5,Azeem Abdulai,sct SCO,"FW,MF",Swansea City,,22.4,2002,3.9,9,5,3,3,3,4,8,50,4,4,0,4,2,11,3,0
6,Ebou Adams,gm GAM,MF,Derby County,,29.29863014,1996,42.1,151,99,53,77,21,54,93,58.1,39,76,17,59,56,207,74,1
7,Elijah Adebayo,eng ENG,FW,Luton Town,,27.32054795,1998,26.9,14,11,8,2,4,6,22,27.3,16,34,9,25,7,21,44,0
8,Michael Adu-Poku,eng ENG,FW,Watford,,19.61369863,2005,0,0,0,0,0,0,0,0,,0,0,0,0,0,0,0,0
9,Enock Agyei,be BEL,"FW,MF",Burnley,,20.30410959,2005,0.6,4,0,3,1,0,1,2,50,1,1,0,1,0,4,0,0
10,Anel Ahmedhodžić,ba BIH,DF,Sheffield Utd,,26.10684932,1999,34.8,53,43,36,16,1,27,41,65.9,14,25,14,11,40,93,175,1
11,Semi Ajayi,ng NGA,DF,West Brom,,31.48219178,1993,13.6,12,6,9,3,0,5,8,62.5,3,5,3,2,11,23,54,0
12,Milan Aleksić,rs SRB,"MF,FW",Sunderland,,19.67671233,2005,3.2,6,4,3,2,1,2,4,50,2,2,0,2,4,10,6,0
13,Ajibola Alese,eng ENG,DF,Sunderland,,24.29315068,2001,7.8,10,4,5,2,3,6,8,75,2,11,4,7,6,16,41,0
14,Jamie Allen,eng ENG,MF,Coventry City,,30.26027397,1995,11.2,30,16,15,10,5,19,37,51.4,18,17,3,14,9,39,11,1
15,Joe Allen,wls WAL,MF,Swansea City,,35.13972603,1990,7.9,15,8,6,4,5,6,13,46.2,7,4,1,3,7,22,8,0
16,Millenic Alli,ie IRL,"FW,DF",Luton Town,,25.23835616,2000,8.5,10,5,5,2,3,4,8,50,4,8,1,7,1,11,13,1
17,Jak Alnwick,eng ENG,GK,Cardiff City,,31.87945205,1993,29,1,1,1,0,0,1,3,33.3,2,0,0,0,0,1,19,2
18,Will Alves,eng ENG,"FW,MF",Cardiff City,,20.24657534,2005,7.4,16,11,9,5,2,6,10,60,4,4,0,4,3,19,3,0
19,Steven Alzate,co COL,MF,Hull City,,26.65205479,1998,21.6,74,50,34,37,3,25,38,65.8,13,31,18,13,27,101,58,1
20,Zeki Amdouni,ch SUI,MF,Burnley,,24.41369863,2000,0.4,1,1,0,0,1,0,0,,0,3,0,3,0,1,1,0
21,Ethan Ampadu,wls WAL,"DF,MF",Leeds United,,24.63561644,2000,25.4,47,27,18,24,5,26,39,66.7,13,26,15,11,25,72,88,0
22,Nordin Amrabat,ma MAR,"FW,MF",Hull City,,38.09315068,1987,3.2,6,5,2,2,2,4,6,66.7,2,2,0,2,0,6,3,1
23,Lucas Andersen,dk DEN,"MF,FW",QPR,,30.63835616,1994,12.9,26,14,7,15,4,8,28,28.6,20,12,2,10,9,35,12,0
24,Joe Anderson,eng ENG,DF,Sunderland,,24.23835616,2001,1.1,2,2,2,0,0,2,3,66.7,1,0,0,0,0,2,2,0
25,Ryan Andrews,eng ENG,"DF,MF",Watford,,20.68767123,2004,23.2,37,26,19,13,5,17,33,51.5,16,21,4,17,23,60,76,1
26,Jaidon Anthony,eng ENG,"FW,MF",Burnley,,25.42191781,1999,40.7,56,33,13,34,9,21,52,40.4,31,57,5,52,31,87,51,0
27,Adil Aouchiche,fr FRA,"MF,FW",Portsmouth,,22.80273973,2002,7.6,14,7,1,7,6,4,19,21.1,15,13,1,12,10,24,6,0
28,Adil Aouchiche,fr FRA,"FW,MF",Sunderland,,22.80273973,2002,3.3,4,2,2,0,2,2,8,25,6,4,1,3,0,4,3,1
29,Oliver Arblaster,eng ENG,MF,Sheffield Utd,,20.99726027,2004,10.9,12,7,4,6,2,6,11,54.5,5,7,4,3,9,21,25,0
30,Jordan Archer,sct SCO,GK,Portsmouth,,32.06027397,1993,1.7,0,0,0,0,0,0,0,,0,0,0,0,0,0,0,0
31,Adam Armstrong,eng ENG,FW,West Brom,,28.22739726,1997,11.2,9,7,1,4,4,3,5,60,2,4,1,3,0,9,2,0
32,Harrison Armstrong,eng ENG,MF,Derby County,,18.28767123,2007,12.3,25,18,10,13,2,11,21,52.4,10,10,1,9,23,48,33,0
33,Sinclair Armstrong,ie IRL,FW,Bristol City,,21.86575342,2003,17.3,3,1,0,2,1,0,3,0,3,4,0,4,3,6,0,0
34,Stuart Armstrong,sct SCO,"MF,FW",Sheffield Weds,,33.09589041,1992,6,10,6,4,4,2,2,5,40,3,4,2,2,2,12,8,0
35,Harrison Ashby,sct SCO,"DF,FW",QPR,,23.46849315,2001,17.6,56,35,34,18,4,31,46,67.4,15,23,5,18,11,67,67,2
36,Cian Ashford,wls WAL,"FW,MF",Cardiff City,,20.60821918,2004,16.9,21,12,13,3,5,12,23,52.2,11,13,0,13,8,29,7,0
37,Robert Atkinson,eng ENG,DF,Portsmouth,,26.80821918,1998,12.2,7,3,5,1,1,4,5,80,1,17,12,5,9,16,102,0
38,Luke Ayling,eng ENG,DF,Middlesbrough,,33.69041096,1991,21.7,60,42,34,22,4,40,57,70.2,17,36,12,24,23,83,38,1
39,Finn Azaz,ie IRL,"MF,FW",Middlesbrough,,24.65479452,2000,39.4,39,28,10,21,8,19,36,52.8,17,30,5,25,14,53,23,0
40,Femi Azeez,eng ENG,FW,Millwall,,23.91232877,2001,21.2,47,30,19,16,12,21,38,55.3,17,28,3,25,18,65,42,0
41,Kwadwo Baah,eng ENG,"MF,FW",Watford,,22.26575342,2003,16.2,16,12,8,5,3,2,7,28.6,5,10,1,9,4,20,15,0
42,Daniel Bachmann,at AUT,GK,Watford,,30.81917808,1994,21.1,0,0,0,0,0,0,0,,0,0,0,0,0,0,12,5
43,Joel Bagan,ie IRL,DF,Cardiff City,,24.99178082,2000,17.9,32,20,22,10,0,14,24,58.3,10,21,12,9,14,46,89,1
44,Michael Baidoo,gh GHA,"MF,FW",Plymouth Argyle,,25.97260274,1999,5,6,3,2,4,0,3,12,25,9,3,0,3,2,8,5,0
45,Lewis Baker,eng ENG,MF,Stoke City,,30.02465753,1995,16.4,9,4,4,5,0,5,16,31.3,11,9,4,5,12,21,17,1
46,Lewis Baker,eng ENG,"MF,FW",Blackburn,,30.02465753,1995,6.6,12,3,7,5,0,4,7,57.1,3,9,3,6,5,17,13,0
47,Daniel Ballard,nir NIR,DF,Sunderland,,25.61369863,1999,12.5,11,7,9,2,0,7,10,70,3,9,6,3,9,20,80,2
48,Patrick Bamford,eng ENG,FW,Leeds United,,31.66027397,1993,2.8,3,2,1,1,1,1,2,50,1,1,0,1,2,5,2,0
49,Raees Bangura-Williams,,"FW,MF",Millwall,,0,,6.8,23,15,10,10,3,8,11,72.7,3,10,0,10,3,26,10,0
50,Barry Bannan,sct SCO,MF,Sheffield Weds,,35.42191781,1989,38.5,66,36,31,24,11,29,62,46.8,33,42,23,19,22,88,55,2
51,Tammer Bany,dk DEN,"MF,FW",West Brom,,21.53972603,2003,0.6,4,4,0,3,1,2,2,100,0,2,0,2,2,6,1,0
52,Jamal Baptiste,eng ENG,DF,Sheffield Utd,,21.47671233,2003,0.1,0,0,0,0,0,0,1,0,1,1,1,0,0,0,0,0
53,Shandon Baptiste,gd GRN,MF,Luton Town,,27.07123288,1998,8,14,8,8,5,1,8,15,53.3,7,14,5,9,12,26,15,0
54,Tom Barkhuizen,eng ENG,"FW,MF",Derby County,,31.83287671,1993,4.5,7,4,5,1,1,3,6,50,3,3,1,2,5,12,6,0
55,Daniel Barlaser,tr TUR,MF,Middlesbrough,,28.29041096,1997,12.8,16,11,4,8,4,6,16,37.5,10,9,3,6,10,26,13,3
56,Ashley Barnes,eng ENG,"FW,MF",Norwich City,,35.50958904,1989,1.9,1,0,0,1,0,0,0,,0,1,0,1,1,2,2,0
57,Ashley Barnes,eng ENG,"FW,MF",Burnley,,35.50958904,1989,1.5,0,0,0,0,0,0,0,,0,3,1,2,2,2,2,0
58,Louie Barry,eng ENG,"FW,MF",Hull City,,21.86849315,2003,1.8,1,1,0,1,0,0,1,0,1,2,0,2,1,2,1,0
59,Kyle Bartley,eng ENG,DF,West Brom,,33.95068493,1991,29,25,14,21,4,0,11,14,78.6,3,30,27,3,23,48,182,1
60,Norman Bassette,be BEL,FW,Coventry City,,20.48219178,2004,10.1,4,4,1,1,2,1,4,25,3,10,0,10,0,4,9,0
61,Danny Batth,eng ENG,DF,Blackburn,,34.61643836,1990,33.4,31,23,24,6,1,15,24,62.5,9,36,29,7,37,68,244,2
62,Patrick Bauer,de GER,DF,Preston,,32.51506849,1992,0.1,1,0,1,0,0,1,1,100,0,2,2,0,0,1,0,0
63,James Beadle,eng ENG,GK,Sheffield Weds,,20.8,2004,38,1,1,1,0,0,1,2,50,1,0,0,0,0,1,24,5
64,Owen Beck,wls WAL,"DF,FW",Blackburn,,22.73424658,2002,20.8,63,38,40,19,4,33,46,71.7,13,34,12,22,19,82,74,0
65,Chris Bedia,ci CIV,FW,Hull City,,29.16438356,1996,10.2,10,6,2,6,2,1,4,25,3,6,1,5,0,10,10,0
66,Amari'i Bell,jm JAM,DF,Luton Town,,30.99726027,1994,30.1,47,25,23,19,5,31,54,57.4,23,25,10,15,26,73,103,0
67,Sam Bell,eng ENG,"FW,DF",Bristol City,,22.94794521,2002,4.9,9,7,2,6,1,3,11,27.3,8,4,0,4,2,11,5,0
68,Jobe Bellingham,eng ENG,MF,Sunderland,,19.6109589,2005,39,72,41,36,23,13,27,44,61.4,17,56,15,41,30,102,92,0
69,Bachir Belloumi,dz ALG,"FW,MF",Hull City,,22.92328767,2002,9.1,13,7,4,7,2,4,11,36.4,7,9,0,9,9,22,11,1
70,Anis Ben Slimane,tn TUN,MF,Norwich City,,24.13424658,2001,23.2,37,27,12,18,7,19,32,59.4,13,22,5,17,15,52,30,1
71,Anis Ben Slimane,tn TUN,MF,Sheffield Utd,,24.13424658,2001,0.5,2,0,1,1,0,0,0,,0,0,0,0,0,2,0,0
72,Joe Bennett,eng ENG,DF,Oxford United,,35.10136986,1990,8.3,15,7,8,6,1,8,9,88.9,1,9,5,4,9,24,30,1
73,Daniel Bennie,au AUS,"FW,MF",QPR,,19.05753425,2006,2.4,0,0,0,0,0,0,0,,0,3,0,3,1,1,7,0
74,Jóhann Berg Guðmundsson,is ISL,MF,Burnley,,34.51780822,1990,0.2,0,0,0,0,0,0,0,,0,0,0,0,0,0,0,0
75,Di'Shon Bernard,jm JAM,DF,Sheffield Weds,,24.55342466,2000,24.8,29,20,22,7,0,17,25,68,8,34,22,12,27,56,117,0
76,Kian Best,eng ENG,DF,Preston,,19.68493151,2005,0,1,1,0,1,0,1,1,100,0,0,0,0,0,1,0,0
77,Florian Bianchini,fr FRA,FW,Swansea City,,23.85753425,2001,12.3,17,12,8,8,1,5,17,29.4,12,16,1,15,2,19,9,0
78,Jake Bidwell,eng ENG,DF,Coventry City,,32.12054795,1993,22.9,20,13,8,9,3,10,18,55.6,8,22,18,4,18,38,63,1
79,Luis Binks,eng ENG,DF,Coventry City,,23.66849315,2001,20.6,22,10,13,7,2,9,14,64.3,5,21,14,7,20,42,137,0
80,Max Bird,eng ENG,MF,Bristol City,,24.62465753,2000,38.7,86,58,19,55,12,40,66,60.6,26,47,14,33,32,118,22,0
81,Colby Bishop,eng ENG,FW,Portsmouth,,28.49589041,1996,29.2,26,15,3,16,7,8,19,42.1,11,22,5,17,4,30,39,1
82,Billy Blacker,eng ENG,MF,Sheffield Utd,,18.94246575,2006,0,0,0,0,0,0,0,0,,0,0,0,0,0,0,0,0
83,Corey Blackett-Taylor,eng ENG,"FW,MF",Derby County,,27.6109589,1997,4.5,1,1,0,0,1,1,5,20,4,3,1,2,4,5,1,0
84,Harvey Blair,eng ENG,FW,Portsmouth,,21.63561644,2003,3.3,4,1,2,0,2,0,5,0,5,6,0,6,4,8,2,0
85,Malachi Boateng,eng ENG,MF,Plymouth Argyle,,22.83013699,2002,2.2,6,2,2,3,1,1,3,33.3,2,4,0,4,4,10,7,0
86,Eric Bocat,fr FRA,DF,Stoke City,,25.8,1999,22.7,42,25,25,12,5,23,33,69.7,10,33,7,26,31,73,103,1
87,Jayden Bogle,eng ENG,DF,Leeds United,,24.76986301,2000,42.5,98,62,49,34,15,48,84,57.1,36,36,2,34,37,135,91,1
88,Jonathan Bond,eng ENG,GK,Watford,,31.95890411,1993,8.9,0,0,0,0,0,0,0,,0,0,0,0,0,0,5,0
89,Neto Borges,br BRA,DF,Middlesbrough,,28.63835616,1996,32.1,65,39,44,14,7,34,56,60.7,22,24,6,18,40,105,131,0
90,Raphael Borges Rodrigues,au AUS,"MF,FW",Coventry City,,21.64383562,2003,0.1,0,0,0,0,0,0,0,,0,0,0,0,0,0,2,0
91,Josh Bowler,eng ENG,"FW,DF",Preston,,26.16438356,1999,5.1,13,6,3,6,4,6,9,66.7,3,5,1,4,3,16,3,0
92,Josh Bowler,eng ENG,"MF,FW",Luton Town,,26.16438356,1999,1.7,2,2,1,1,0,0,3,0,3,1,1,0,2,4,4,0
93,Sonny Bradley,eng ENG,DF,Derby County,,33.63835616,1991,3.4,2,2,2,0,0,1,1,100,0,6,6,0,5,7,28,0
94,Tom Bradshaw,wls WAL,FW,Oxford United,,32.76986301,1992,4,0,0,0,0,0,0,0,,0,1,0,1,1,1,4,0
95,Tom Bradshaw,wls WAL,FW,Millwall,,32.76986301,1992,5,4,2,0,2,2,2,3,66.7,1,1,0,1,0,4,5,0
96,Robbie Brady,ie IRL,"DF,FW",Preston,,33.30136986,1992,18.2,39,28,13,18,8,19,34,55.9,15,26,3,23,22,61,39,0
97,Cohen Bramall,eng ENG,"DF,FW",Portsmouth,,29.08767123,1996,5.1,6,6,3,2,1,4,8,50,4,2,0,2,3,9,14,0
98,Cameron Brannagan,eng ENG,MF,Oxford United,,28.98630137,1996,32.2,58,35,36,22,0,38,65,58.5,27,38,14,24,31,89,44,0
99,Ben Brereton,cl CHI,"FW,MF",Sheffield Utd,,26.04383562,1999,10.9,2,1,0,0,2,1,8,12.5,7,10,2,8,8,10,23,0
100,Rhian Brewster,eng ENG,"MF,FW",Sheffield Utd,,25.09041096,2000,17.3,16,8,4,4,8,5,15,33.3,10,20,3,17,5,21,35,0
101,Callum Brittain,eng ENG,DF,Blackburn,,27.14520548,1998,29.5,56,34,34,17,5,38,47,80.9,9,36,15,21,21,77,129,1
102,Andre Brooks,eng ENG,"FW,MF",Sheffield Utd,,21.70410959,2003,10.6,34,16,14,12,8,15,27,55.6,12,19,1,18,6,40,13,0
103,Ciaron Brown,nir NIR,DF,Oxford United,,27.30136986,1998,40.1,28,20,23,5,0,17,24,70.8,7,49,35,14,49,77,267,0
104,Dejaune Brown,,FW,Derby County,,0,,4.3,5,4,0,3,2,3,5,60,2,7,1,6,2,7,6,0
105,Jacob Brown,sct SCO,"FW,MF",Luton Town,,27.06575342,1998,13.5,10,6,3,5,2,6,13,46.2,7,10,4,6,5,15,24,0
106,Alan Browne,ie IRL,"MF,DF",Sunderland,,30.05205479,1995,13.5,20,12,17,3,0,7,18,38.9,11,15,3,12,11,31,28,1
107,Josh Brownhill,eng ENG,"MF,FW",Burnley,,29.37260274,1995,38.6,64,35,25,25,14,23,53,43.4,30,26,5,21,32,96,60,1
108,Joe Bryan,eng ENG,DF,Millwall,,31.62739726,1993,36.4,90,61,51,33,6,51,89,57.3,38,60,19,41,69,159,132,2
109,Solomon Brynn,eng ENG,GK,Middlesbrough,,24.50958904,2000,5.7,2,2,2,0,0,2,2,100,0,0,0,0,0,2,2,0
110,John Buckley,eng ENG,MF,Blackburn,,25.55616438,1999,9.5,31,15,10,20,1,14,23,60.9,9,17,6,11,14,45,23,0
111,Mustapha Bundu,sl SLE,"FW,MF",Plymouth Argyle,,28.18082192,1997,25.6,30,17,8,14,8,13,26,50,13,16,4,12,12,42,33,0
112,Wouter Burger,nl NED,MF,Stoke City,,24.2109589,2001,33.4,82,55,35,41,6,36,66,54.5,30,46,14,32,51,133,89,0
113,Delano Burgzorg,sr SUR,"FW,MF",Middlesbrough,,26.48767123,1998,24.3,39,20,12,16,11,14,25,56,11,18,1,17,3,42,12,1
114,Reece Burke,eng ENG,DF,Luton Town,,28.66849315,1996,9.5,19,11,8,8,3,4,11,36.4,7,10,5,5,13,32,49,0
115,Finley Burns,eng ENG,"DF,MF",Hull City,,21.87945205,2003,3.5,5,4,2,3,0,2,4,50,2,4,4,0,9,14,16,0
116,Harrison Burrows,eng ENG,DF,Sheffield Utd,,23.30684932,2002,38.4,78,54,49,25,4,44,73,60.3,29,29,7,22,30,108,98,1
117,Mason Burstow,eng ENG,"FW,MF",Hull City,,21.74794521,2003,10.6,20,8,13,7,0,7,21,33.3,14,17,3,14,3,23,21,0
118,Sam Byram,eng ENG,DF,Leeds United,,31.63013699,1993,15.7,31,19,18,10,3,18,23,78.3,5,17,5,12,22,53,46,0
119,Ben Cabango,wls WAL,DF,Swansea City,,24.92876712,2000,44.8,84,57,58,23,3,33,51,64.7,18,51,33,18,41,125,275,3
120,Tyrese Campbell,eng ENG,FW,Sheffield Utd,,25.34794521,1999,17.6,5,2,1,2,2,0,2,0,2,13,3,10,0,5,11,0
121,Thomas Cannon,ie IRL,FW,Stoke City,,22.34794521,2002,20.6,13,8,1,3,9,3,10,30,7,12,5,7,2,15,23,0
122,Thomas Cannon,ie IRL,FW,Sheffield Utd,,22.34794521,2002,7.6,1,0,0,0,1,1,3,33.3,2,6,2,4,0,1,5,0
123,Todd Cantwell,eng ENG,"MF,FW",Blackburn,,27.18082192,1998,27.5,59,41,25,23,11,23,46,50,23,25,3,22,20,79,22,0
124,Theo Carroll,eng ENG,MF,Preston,,17.86849315,2007,0,1,1,1,0,0,0,0,,0,0,0,0,0,1,1,0
125,Hayden Carter,eng ENG,DF,Blackburn,,25.37808219,1999,15.1,24,13,17,6,1,17,32,53.1,15,20,12,8,19,43,65,0
126,Eiran Cashin,ie IRL,DF,Derby County,,23.48219178,2001,19.8,51,33,26,22,3,30,46,65.2,16,30,14,16,43,94,97,0
127,Žan Celar,si SVN,FW,QPR,,26.13972603,1999,10.5,4,2,1,2,1,1,4,25,3,2,1,1,0,4,10,0
128,Ilias Chair,ma MAR,"MF,FW",QPR,,27.50958904,1997,18.9,13,9,8,1,4,6,23,26.1,17,20,1,19,5,18,5,0
129,Giorgi Chakvetadze,ge GEO,"MF,FW",Watford,,25.67945205,1999,36.5,39,32,8,23,8,18,39,46.2,21,17,2,15,10,49,10,1
130,Nathaniel Chalobah,eng ENG,MF,Sheffield Weds,,30.39178082,1994,4.9,9,4,6,2,1,7,10,70,3,4,2,2,12,21,19,0
131,Calum Chambers,eng ENG,"DF,MF",Cardiff City,,30.28493151,1995,39,74,48,34,34,6,32,49,65.3,17,48,26,22,52,126,148,4
132,Samuel Chambers,eng ENG,FW,Leeds United,,17.70958904,2007,0.2,0,0,0,0,0,0,0,,0,0,0,0,0,0,0,0
133,Pierce Charles,nir NIR,GK,Sheffield Weds,,19.78630137,2005,8,0,0,0,0,0,0,0,,0,1,0,1,0,0,1,2
134,Shea Charles,nir NIR,"MF,DF",Sheffield Weds,,21.49315068,2003,40.3,108,57,48,47,13,53,83,63.9,30,55,18,37,59,167,75,0
135,Tawanda Chirewa,zw ZIM,MF,Derby County,,21.56164384,2003,1.7,7,5,2,4,1,2,5,40,3,1,0,1,1,8,0,0
136,Tahith Chong,nl NED,"MF,DF",Luton Town,,25.41369863,1999,22.5,23,13,9,8,6,11,25,44,14,23,3,20,8,31,20,1
137,Hamza Choudhury,bd BAN,"MF,DF",Sheffield Utd,,27.5890411,1997,12.3,34,23,19,12,3,15,24,62.5,9,15,6,9,28,62,35,1
138,Benjamin Chrisene,eng ENG,DF,Norwich City,,21.30684932,2004,12.8,33,23,22,11,0,14,23,60.9,9,14,5,9,10,43,22,0
139,Cyrus Christie,ie IRL,DF,Swansea City,,32.59178082,1992,3.1,2,1,2,0,0,1,1,100,0,4,1,3,3,5,21,1
140,Dennis Cirkin,eng ENG,DF,Sunderland,,23.07671233,2002,30.4,91,50,50,33,8,45,74,60.8,29,41,14,27,43,134,104,0
141,Ibrahim Cissoko,nl NED,"FW,MF",Plymouth Argyle,,22.10684932,2003,7.3,15,5,12,2,1,6,11,54.5,5,7,0,7,4,19,4,0
142,Ibrahim Cissoko,nl NED,"FW,MF",Sheffield Weds,,22.10684932,2003,0.6,0,0,0,0,0,0,1,0,1,4,0,4,1,1,0,0
143,Jordan Clark,eng ENG,MF,Luton Town,,31.61369863,1993,35.9,56,37,24,24,8,26,66,39.4,40,39,15,24,30,86,51,1
144,Harry Clarke,eng ENG,DF,Sheffield Utd,,24.17260274,2001,5.2,10,6,6,2,2,4,7,57.1,3,8,5,3,4,14,23,0
145,Jack Clarke,eng ENG,FW,Sunderland,,24.44383562,2000,2,2,1,2,0,0,1,5,20,4,2,0,2,0,2,2,0
146,Matthew Clarke,eng ENG,DF,Derby County,,28.61369863,1996,15.2,29,16,20,8,1,11,19,57.9,8,20,8,12,19,48,112,0
147,Matthew Clarke,eng ENG,DF,Middlesbrough,,28.61369863,1996,12.4,25,18,13,12,0,12,15,80,3,17,9,8,17,42,64,1
148,Jake Clarke-Salter,eng ENG,DF,QPR,,27.61369863,1997,8.4,14,7,8,6,0,5,8,62.5,3,10,6,4,4,18,40,0
149,Josh Coburn,eng ENG,MF,Middlesbrough,,22.40821918,2002,0.1,0,0,0,0,0,0,0,,0,0,0,0,0,0,2,0
150,Josh Coburn,eng ENG,FW,Millwall,,22.40821918,2002,13.5,10,8,2,5,3,2,3,66.7,1,9,2,7,2,12,16,0
151,Jack Colback,eng ENG,MF,QPR,,35.5260274,1989,16.1,25,13,12,11,2,12,18,66.7,6,17,3,14,11,36,18,0
152,Devante Cole,eng ENG,"FW,MF",West Brom,,29.98356164,1995,1.8,2,1,1,1,0,1,3,33.3,2,5,1,4,1,3,3,0
153,Bradley Collins,eng ENG,GK,Coventry City,,28.20547945,1997,14.6,1,1,1,0,0,1,1,100,0,0,0,0,0,1,10,3
154,James Collins,ie IRL,"FW,MF",Derby County,,34.42191781,1990,2.5,1,1,0,0,1,0,4,0,4,5,1,4,2,3,6,0
155,Jamilu Collins,ng NGA,DF,Cardiff City,,30.74520548,1994,1.8,5,3,3,1,1,4,5,80,1,1,0,1,2,7,13,0
156,Rubin Colwill,wls WAL,"MF,FW",Cardiff City,,23.01917808,2002,28,56,33,20,25,11,23,40,57.5,17,39,5,34,11,67,22,0
157,Aaron Connolly,ie IRL,"FW,MF",Sunderland,,25.2630137,2000,2.7,2,1,0,1,1,2,4,50,2,0,0,0,0,2,2,0
158,Aaron Connolly,ie IRL,"FW,MF",Millwall,,25.2630137,2000,7.3,7,4,1,5,1,3,4,75,1,5,0,5,1,8,10,0
159,Tommy Conway,sct SCO,"FW,MF",Middlesbrough,,22.74246575,2002,26.2,15,10,6,5,4,4,13,30.8,9,12,0,12,3,18,10,0
160,Steve Cook,eng ENG,DF,QPR,,34.04109589,1991,29.1,19,14,16,1,2,11,16,68.8,5,33,27,6,24,43,174,0
161,Jake Cooper,eng ENG,DF,Millwall,,30.24657534,1995,35.5,33,24,23,7,3,17,31,54.8,14,34,24,10,21,54,238,3
162,Michael Cooper,eng ENG,GK,Sheffield Utd,,25.56986301,1999,43,1,0,1,0,0,1,1,100,0,0,0,0,0,1,26,1
163,Oliver Cooper,wls WAL,"MF,FW",Swansea City,,25.38630137,1999,11.6,23,12,4,15,4,12,23,52.2,11,19,2,17,6,29,7,0
164,José Cordoba,pa PAN,DF,Norwich City,,24.16164384,2001,23.4,27,12,21,5,1,16,24,66.7,8,20,11,9,21,48,106,0
165,David Cornell,wls WAL,GK,Preston,,34.10136986,1991,9,0,0,0,0,0,0,0,,0,0,0,0,0,0,2,1
166,Harry Cornick,eng ENG,"FW,MF",Bristol City,,30.06849315,1995,0.4,0,0,0,0,0,0,2,0,2,0,0,0,0,0,0,0
167,Lewie Coyle,eng ENG,DF,Hull City,,29.55068493,1995,41.3,98,64,69,23,6,58,92,63,34,35,20,15,26,124,163,3
168,Tristan Crama,fr FRA,DF,Millwall,,23.48493151,2001,18.2,35,23,22,10,3,18,33,54.5,15,21,9,12,30,65,123,0
169,Charlie Crew,wls WAL,MF,Leeds United,,18.88493151,2006,0.1,0,0,0,0,0,0,0,,0,0,0,0,0,0,0,0
170,Ante Crnac,hr CRO,FW,Norwich City,,21.37808219,2003,27.7,47,31,19,18,10,21,46,45.7,25,34,4,30,6,53,25,1
171,Matt Crooks,eng ENG,"MF,FW",Hull City,,31.28493151,1994,8.8,19,10,9,8,2,7,12,58.3,5,10,2,8,5,24,21,0
172,Josh Cullen,ie IRL,MF,Burnley,,29.0739726,1996,42.2,65,34,17,44,4,31,55,56.4,24,34,12,22,34,99,72,1
173,Liam Cullen,wls WAL,"MF,FW",Swansea City,,26.03013699,1999,33.3,37,19,7,18,12,9,34,26.5,25,27,10,17,8,45,41,0
174,Jamie Cumming,eng ENG,GK,Oxford United,,25.6630137,1999,45,0,0,0,0,0,0,2,0,2,0,0,0,0,0,35,3
175,Luke Cundle,eng ENG,"MF,FW",Millwall,,23.02191781,2002,10.9,15,8,4,9,2,1,8,12.5,7,12,3,9,8,23,6,0
176,Jesper Daland,no NOR,DF,Cardiff City,,25.32328767,2000,15.9,12,7,9,3,0,7,14,50,7,18,6,12,9,21,81,1
177,Owen Dale,eng ENG,"MF,FW",Oxford United,,26.50410959,1998,3.9,5,5,3,2,0,1,3,33.3,2,3,0,3,4,9,7,0
178,Harry Darling,eng ENG,DF,Swansea City,,25.7369863,1999,37.1,31,14,18,10,3,13,23,56.5,10,46,37,9,25,56,204,4
179,Karl Darlow,wls WAL,GK,Leeds United,,34.56986301,1990,7,0,0,0,0,0,0,0,,0,0,0,0,0,0,2,0
180,Jay Dasilva,wls WAL,DF,Coventry City,,27.03287671,1998,20.1,57,36,33,16,8,34,54,63,20,28,4,24,23,80,49,0
181,Adam Davies,wls WAL,GK,Sheffield Utd,,32.79726027,1992,3,0,0,0,0,0,0,0,,0,0,0,0,0,0,1,0
182,Isaak Davies,wls WAL,"FW,MF",Cardiff City,,23.60547945,2001,3.2,10,6,3,5,2,3,6,50,3,6,0,6,1,11,2,0
183,Tom Davies,eng ENG,MF,Sheffield Utd,,26.84383562,1998,7.5,20,15,6,12,2,7,16,43.8,9,8,0,8,8,28,9,0
184,James Debayo,eng ENG,DF,Leeds United,,19.81369863,2005,0,0,0,0,0,0,0,0,,0,0,0,0,0,0,0,0
185,Hannes Delcroix,be BEL,DF,Swansea City,,26.17808219,1999,9.9,24,20,13,10,1,7,10,70,3,12,4,8,14,38,72,1
186,Tom Dele-Bashiru,ng NGA,MF,Watford,,25.62739726,1999,22.9,22,17,16,5,1,10,17,58.8,7,21,9,12,19,41,28,4
187,Karamoko Dembélé,eng ENG,"FW,MF",QPR,,22.19452055,2003,13.2,15,9,5,7,3,3,12,25,9,5,1,4,6,21,9,0
188,Siriki Dembélé,ci CIV,"FW,MF",Oxford United,,28.65479452,1996,15.2,29,17,9,13,7,9,18,50,9,19,0,19,9,38,7,0
189,Rav van den Berg,nl NED,DF,Middlesbrough,,20.82465753,2004,23.6,26,14,17,6,3,19,28,67.9,9,27,20,7,26,52,133,1
190,Emmanuel Dennis,ng NGA,"FW,MF",Blackburn,,27.46575342,1997,1.8,1,1,0,1,0,1,2,50,1,2,0,2,1,2,2,0
191,Terry Devlin,nir NIR,"DF,MF",Portsmouth,,21.49041096,2003,17.4,30,23,19,9,2,17,39,43.6,22,28,11,17,38,68,79,1
192,Ousmane Diakité,ml MLI,"MF,DF",West Brom,,24.77534247,2000,9.6,30,14,10,19,1,12,20,60,8,26,8,18,16,46,49,0
193,Grady Diangana,cd COD,"FW,MF",West Brom,,27.04109589,1998,16.6,41,24,19,18,4,19,38,50,19,17,1,16,9,50,9,0
194,Robert Dickie,eng ENG,DF,Bristol City,,29.16986301,1996,34.7,36,25,19,17,0,13,29,44.8,16,37,32,5,34,70,235,2
195,Seny Dieng,sn SEN,GK,Middlesbrough,,30.44383562,1994,17,0,0,0,0,0,0,2,0,2,0,0,0,0,0,11,1
196,Anfernee Dijksteel,sr SUR,DF,Middlesbrough,,28.51780822,1996,28.1,68,41,30,31,7,28,45,62.2,17,47,15,32,27,95,89,0
197,Daryl Dike,us USA,"FW,MF",West Brom,,24.91780822,2000,2.5,2,1,1,1,0,1,1,100,0,1,0,1,0,2,7,0
198,Jaden Dixon,eng ENG,"FW,DF",Stoke City,,18.23561644,2007,0.1,0,0,0,0,0,0,1,0,1,1,0,1,0,0,0,0
199,Elijah Dixon-Bonner,eng ENG,"MF,FW",QPR,,24.3369863,2001,0.1,0,0,0,0,0,0,0,,0,0,0,0,0,0,0,0
200,Ben Doak,sct SCO,FW,Middlesbrough,,19.47671233,2005,19.8,26,16,9,13,4,13,31,41.9,18,17,2,15,5,31,14,0
201,Lewis Dobbin,eng ENG,FW,Norwich City,,22.33150685,2003,7.1,5,4,1,4,0,2,5,40,3,8,1,7,0,5,3,0
202,Lewis Dobbin,eng ENG,"FW,MF",West Brom,,22.33150685,2003,3.8,6,3,4,2,0,2,7,28.6,5,3,0,3,2,8,3,0
203,Tyrhys Dolan,eng ENG,"FW,MF",Blackburn,,23.34794521,2001,35.3,58,40,24,24,10,24,51,47.1,27,32,0,32,28,86,35,2
204,Alfie Doughty,eng ENG,"DF,MF",Luton Town,,25.36712329,1999,22.6,61,38,30,23,8,32,56,57.1,24,40,3,37,29,90,48,1
205,Mamadou Doumbia,ml MLI,FW,Watford,,19.20547945,2006,10.8,12,7,1,6,5,6,8,75,2,10,0,10,3,15,5,1
206,Oliver Dovin,se SWE,GK,Coventry City,,22.81369863,2002,27.4,0,0,0,0,0,0,1,0,1,0,0,0,0,0,18,2
207,Callum Doyle,eng ENG,DF,Norwich City,,21.58356164,2003,38.2,54,33,34,18,2,33,52,63.5,19,51,27,24,56,110,164,4
208,Andre Dozzell,eng ENG,MF,Portsmouth,,26.00547945,1999,31.3,49,32,14,29,6,15,34,44.1,19,35,13,22,25,74,55,1
209,Cody Drameh,eng ENG,DF,Hull City,,23.40273973,2001,18.3,74,49,47,18,9,45,76,59.2,31,24,7,17,19,93,81,0
210,Amario Duberry,eng ENG,"FW,MF",Blackburn,,19.93150685,2005,8,12,8,5,3,4,8,16,50,8,6,0,6,1,13,15,1
211,Shane Duffy,ie IRL,DF,Norwich City,,33.3369863,1992,44.9,37,21,27,9,1,19,34,55.9,15,56,45,11,32,69,238,3
212,Jimmy Dunne,ie IRL,DF,QPR,,27.53972603,1997,45,113,70,70,32,11,62,82,75.6,20,64,24,40,46,159,260,0
213,Leonard Duru,eng ENG,DF,Blackburn,,20.30684932,2005,0,0,0,0,0,0,0,0,,0,0,0,0,0,0,0,0
214,Pierre Dwomoh,be BEL,MF,Watford,,20.86849315,2004,5.9,13,4,7,4,2,7,11,63.6,4,8,0,8,16,29,5,1
215,Lyndon Dykes,sct SCO,FW,QPR,,29.57260274,1995,0.1,0,0,0,0,0,0,0,,0,0,0,0,0,0,1,0
216,George Earthy,eng ENG,"MF,FW",Bristol City,,20.66027397,2004,16.2,22,10,9,9,4,14,27,51.9,13,15,4,11,13,35,14,1
217,Malcolm Ebiowei,eng ENG,MF,Oxford United,,21.6630137,2003,0.8,3,2,2,1,0,1,1,100,0,1,0,1,1,4,0,0
218,Festy Ebosele,ie IRL,"DF,MF",Watford,,22.75342466,2002,8.4,29,19,11,13,5,16,28,57.1,12,8,2,6,2,31,21,0
219,Josh Eccles,eng ENG,MF,Coventry City,,25.07671233,2000,26,40,29,18,17,5,18,43,41.9,25,41,18,23,23,63,38,1
220,George Edmundson,eng ENG,DF,Middlesbrough,,27.6739726,1997,23.2,23,18,10,10,3,14,19,73.7,5,17,10,7,22,45,121,3
221,Joe Edwards,eng ENG,DF,Plymouth Argyle,,34.50684932,1990,12.6,38,26,20,13,5,16,23,69.6,7,28,9,19,17,55,49,0
222,Kyle Edwards,eng ENG,"MF,FW",Oxford United,,27.20821918,1998,2.2,2,1,0,0,2,2,3,66.7,1,3,3,0,2,4,3,0
223,Marcus Edwards,eng ENG,"FW,MF",Burnley,,26.41643836,1998,10.4,13,5,7,4,2,9,24,37.5,15,9,0,9,5,18,8,2
224,Ronnie Edwards,eng ENG,"DF,MF",QPR,,22.10136986,2003,20.2,26,18,15,10,1,13,22,59.1,9,28,17,11,26,52,125,1
225,John Egan,ie IRL,DF,Burnley,,32.5369863,1992,1.8,1,1,1,0,0,1,1,100,0,1,0,1,0,1,9,0
226,John Egan,ie IRL,DF,Hull City,,32.5369863,1992,8.1,1,0,0,1,0,1,3,33.3,2,5,3,2,3,4,61,1
227,CJ Egan-Riley,eng ENG,DF,Burnley,,22.33424658,2003,40,60,41,39,17,4,34,37,91.9,3,39,29,10,36,96,199,2
228,Callum Elder,au AUS,DF,Derby County,,30.26575342,1995,23.9,42,28,18,17,7,25,36,69.4,11,39,12,27,27,69,72,0
229,Aidomo Emakhu,ie IRL,"FW,MF",Millwall,,21.52054795,2003,7.7,20,12,8,5,7,6,15,40,9,18,2,16,5,25,9,0
230,Lukas Engel,dk DEN,DF,Middlesbrough,,26.38630137,1998,4.1,8,5,5,3,0,7,14,50,7,9,2,7,6,14,4,0
231,Niall Ennis,eng ENG,FW,Stoke City,,25.95616438,1999,2.2,1,0,1,0,0,1,2,50,1,0,0,0,0,1,3,0
232,Romain Esse,eng ENG,"FW,MF",Millwall,,19.97534247,2005,22.4,66,43,24,25,17,28,40,70,12,27,1,26,9,75,21,0
233,Maxime Estève,fr FRA,DF,Burnley,,22.93972603,2002,45.1,48,29,34,12,2,24,36,66.7,12,58,41,17,37,85,234,2
234,Oscar Estupiñan,co COL,FW,Hull City,,28.34520548,1996,1.6,0,0,0,0,0,0,0,,0,2,0,2,0,0,4,0
235,Ched Evans,wls WAL,"FW,MF",Preston,,36.34794521,1988,1.1,1,1,1,0,0,0,2,0,2,0,0,0,0,1,3,0
236,George Evans,eng ENG,GK,Millwall,,19.96712329,2005,4,1,1,1,0,0,1,1,100,0,0,0,0,0,1,5,0
237,Milan van Ewijk,nl NED,DF,Coventry City,,24.65205479,2000,44.6,92,66,53,31,8,32,63,50.8,31,37,9,28,54,146,127,1
238,Malachi Fagan-Walcott,eng ENG,DF,Cardiff City,,23.14794521,2002,0.3,1,1,0,1,0,1,2,50,1,0,0,0,0,1,1,0
239,Akin Famewo,eng ENG,DF,Sheffield Weds,,26.48219178,1998,10.4,17,13,12,5,0,8,14,57.1,6,11,7,4,24,41,43,0
240,Lamine Fanne,es ESP,"MF,FW",Luton Town,,21.25753425,2004,6.5,6,3,2,4,0,1,8,12.5,7,8,0,8,6,12,13,1
241,Jacob Farrell,au AUS,DF,Portsmouth,,22.45479452,2002,1,1,1,1,0,0,1,2,50,1,0,0,0,4,5,5,0
242,Christian Fassnacht,ch SUI,"FW,DF",Norwich City,,31.47671233,1993,0.9,2,1,1,0,1,1,3,33.3,2,1,0,1,0,2,1,0
243,Tom Fellows,eng ENG,"FW,MF",West Brom,,21.77534247,2003,31.9,38,20,17,17,4,20,37,54.1,17,20,3,17,9,47,28,0
244,Marselino Ferdinan,id IDN,MF,Oxford United,,20.64931507,2004,0.2,1,1,0,1,0,0,0,,0,0,0,0,0,1,0,0
245,Sam Field,eng ENG,MF,QPR,,26.9890411,1998,32.3,61,35,19,32,10,22,35,62.9,13,49,20,29,31,92,103,1
246,Tegan Finn,,MF,Plymouth Argyle,,0,,1.6,3,1,2,0,1,1,3,33.3,2,3,0,3,3,6,2,0
247,Junior Firpo,do DOM,DF,Leeds United,,28.69863014,1996,29.1,66,34,26,30,10,34,59,57.6,25,25,7,18,37,103,102,0
248,Will Fish,eng ENG,DF,Cardiff City,,22.20821918,2003,15.3,12,9,7,5,0,3,8,37.5,5,18,17,1,17,29,114,0
249,Kellen Fisher,eng ENG,"DF,MF",Norwich City,,20.99726027,2004,29.9,60,44,32,19,9,29,47,61.7,18,25,8,17,36,96,84,1
250,Zian Flemming,nl NED,FW,Burnley,,26.75616438,1998,26.9,18,15,2,12,4,6,21,28.6,15,13,1,12,5,23,28,0
251,Tyrese Fornah,sl SLE,MF,Derby County,,25.64383562,1999,0.1,0,0,0,0,0,0,0,,0,0,0,0,0,0,0,0
252,Adam Forshaw,eng ENG,MF,Plymouth Argyle,,33.56986301,1991,7.6,21,14,9,9,3,11,14,78.6,3,5,1,4,6,27,8,0
253,Adam Forshaw,eng ENG,MF,Blackburn,,33.56986301,1991,6.3,18,10,11,5,2,7,17,41.2,10,4,1,3,6,24,12,0
254,Amankwah Forson,gh GHA,"MF,FW",Norwich City,,22.33972603,2002,8.1,16,9,9,4,3,5,14,35.7,9,16,5,11,2,18,6,1
255,Marcus Forss,fi FIN,FW,Middlesbrough,,25.87671233,1999,7.4,15,8,6,7,2,6,8,75,2,4,1,3,4,19,7,0
256,Craig Forsyth,sct SCO,DF,Derby County,,36.1890411,1989,28.4,36,24,19,14,3,18,28,64.3,10,38,16,22,30,66,146,1
257,Gabriel Forsyth,sct SCO,"MF,FW",Norwich City,,18.74794521,2006,1.8,1,1,0,1,0,1,2,50,1,3,1,2,2,3,0,0
258,Lyle Foster,za RSA,FW,Burnley,,24.66575342,2000,17.7,20,13,6,11,3,10,18,55.6,8,8,0,8,3,23,14,0
259,Morgan Fox,wls WAL,DF,QPR,,31.61643836,1993,14.9,20,13,13,6,1,12,17,70.6,5,19,14,5,6,26,86,0
260,Gianluca Frabotta,it ITA,DF,West Brom,,25.86027397,1999,0.7,4,4,2,1,1,2,2,100,0,1,0,1,1,5,3,0
261,Gonçalo Franco,pt POR,MF,Swansea City,,24.46027397,2000,34.9,130,74,39,72,19,51,101,50.5,50,62,8,54,41,171,29,3
262,Michael Frey,ch SUI,FW,QPR,,30.79178082,1994,19.8,22,16,2,12,8,6,12,50,6,13,2,11,4,26,23,1
263,Dael Fry,eng ENG,DF,Middlesbrough,,27.67671233,1997,15.7,8,3,6,2,0,4,9,44.4,5,17,15,2,21,29,140,1
264,Mads Frøkjær-Jensen,dk DEN,"FW,MF",Preston,,25.76438356,1999,26.2,44,15,20,19,5,13,41,31.7,28,37,3,34,12,56,15,1
265,Leo Fuhr Hjelde,no NOR,DF,Sunderland,,21.68767123,2003,4.6,11,6,4,4,3,5,6,83.3,1,6,3,3,4,15,31,0
266,Jay Fulton,sct SCO,MF,Swansea City,,31.09041096,1994,14.3,21,16,9,10,2,6,11,54.5,5,9,4,5,14,35,26,2
267,Darnell Furlong,eng ENG,DF,West Brom,,29.50684932,1995,41.2,43,22,25,12,6,23,39,59,16,38,16,22,30,73,163,2
268,Sam Gallagher,eng ENG,"FW,MF",Stoke City,,29.63287671,1995,11.4,16,10,3,10,3,6,14,42.9,8,13,4,9,3,19,28,1
269,Brendan Galloway,zw ZIM,DF,Plymouth Argyle,,29.13150685,1996,10.9,32,21,20,10,2,15,19,78.9,4,27,15,12,20,52,58,1
270,Djeidi Gassama,fr FRA,"MF,FW",Sheffield Weds,,21.64657534,2003,33.1,51,32,18,27,6,25,56,44.6,31,24,1,23,12,63,15,0
271,Joe Gelhardt,eng ENG,"FW,MF",Leeds United,,23,2002,0.1,0,0,0,0,0,0,1,0,1,0,0,0,0,0,0,0
272,Joe Gelhardt,eng ENG,"FW,MF",Hull City,,23,2002,17.7,21,15,5,12,4,10,31,32.3,21,21,2,19,3,24,29,1
273,Anwar El Ghazi,nl NED,FW,Cardiff City,,30.00273973,1995,13.1,8,6,2,4,2,3,7,42.9,4,5,3,2,2,10,9,0
274,Liam Gibbs,eng ENG,"MF,FW",Norwich City,,22.38082192,2002,2.4,4,1,1,3,0,2,3,66.7,1,0,0,0,0,4,3,0
275,Ben Gibson,eng ENG,DF,Stoke City,,32.29863014,1993,21.6,14,5,8,6,0,6,11,54.5,5,31,27,4,17,31,112,1
276,Lewis Gibson,eng ENG,DF,Preston,,24.79178082,2000,18.2,27,19,14,10,3,16,22,72.7,6,22,13,9,19,46,111,0
277,Lewis Gibson,eng ENG,DF,Plymouth Argyle,,24.79178082,2000,18,26,18,21,4,1,15,20,75,5,34,25,9,17,43,98,0
278,Alexander Gilbert,ie IRL,MF,Middlesbrough,,23.34794521,2001,0.9,1,0,1,0,0,0,0,,0,0,0,0,0,1,0,0
279,Alfie Gilchrist,eng ENG,DF,Sheffield Utd,,21.43013699,2003,23.4,47,29,36,8,3,33,41,80.5,8,44,22,22,28,75,92,0
280,Ryan Giles,eng ENG,DF,Middlesbrough,,25.26849315,2000,3.4,6,3,6,0,0,5,5,100,0,5,1,4,1,7,15,1
281,Ryan Giles,eng ENG,DF,Hull City,,25.26849315,2000,10,6,4,3,3,0,4,4,100,0,7,2,5,5,11,29,0
282,Josh Ginnelly,eng ENG,FW,Swansea City,,28.11232877,1997,0.4,0,0,0,0,0,0,0,,0,0,0,0,0,0,0,0
283,Tom Glover,au AUS,GK,Middlesbrough,,27.35890411,1997,6.3,1,1,1,0,0,1,1,100,0,0,0,0,0,1,6,1
284,Wilfried Gnonto,it ITA,FW,Leeds United,,21.49315068,2003,25.3,24,13,5,9,10,13,31,41.9,18,21,1,20,13,37,14,0
285,Lynden Gooch,us USA,"DF,FW",Stoke City,,29.35890411,1995,11.5,31,22,17,8,6,18,34,52.9,16,10,3,7,13,44,19,0
286,Tyler Goodhram,eng ENG,"MF,FW",Oxford United,,21.73972603,2003,33.9,65,38,21,31,13,27,68,39.7,41,46,3,43,19,84,49,0
287,Will Goodwin,eng ENG,"FW,MF",Oxford United,,22.98082192,2002,0.3,0,0,0,0,0,0,0,,0,0,0,0,0,0,0,0
288,Kaide Gordon,eng ENG,"FW,MF",Norwich City,,20.57808219,2004,2,7,5,4,1,2,6,9,66.7,3,3,0,3,2,9,3,0
289,Kaide Gordon,eng ENG,"FW,MF",Portsmouth,,20.57808219,2004,1.7,4,4,3,1,0,1,1,100,0,2,0,2,0,4,2,0
290,Kenzo Goudmijn,nl NED,MF,Derby County,,23.37534247,2001,25.8,44,24,20,24,0,25,53,47.2,28,23,2,21,23,67,21,0
291,Dimitris Goutas,gr GRE,DF,Cardiff City,,31.08219178,1994,32.4,41,19,28,12,1,20,26,76.9,6,37,28,9,35,76,220,3
292,Karlan Grant,eng ENG,"FW,MF",West Brom,,27.62465753,1997,32.6,30,17,15,8,7,14,28,50,14,24,3,21,20,50,20,0
293,Andre Gray,jm JAM,FW,Plymouth Argyle,,33.85479452,1991,6.1,3,2,0,3,0,1,1,100,0,1,0,1,1,4,6,0
294,Harry Gray,eng ENG,MF,Leeds United,,16.56986301,2008,0.1,0,0,0,0,0,0,0,,0,0,0,0,0,0,0,0
295,Sam Greenwood,eng ENG,"FW,MF",Preston,,23.26849315,2002,27,46,27,6,26,14,17,43,39.5,26,30,2,28,8,54,18,0
296,Joshua Griffiths,eng ENG,GK,West Brom,,23.66027397,2001,6,0,0,0,0,0,0,1,0,1,0,0,0,0,0,13,0
297,Matt Grimes,eng ENG,MF,Coventry City,,29.80273973,1995,15.2,24,17,12,11,1,16,31,51.6,15,13,6,7,11,35,33,0
298,Matt Grimes,eng ENG,MF,Swansea City,,29.80273973,1995,29,48,26,16,29,3,28,47,59.6,19,24,9,15,21,69,40,3
299,Daniel Grimshaw,eng ENG,GK,Plymouth Argyle,,27.29589041,1998,21,0,0,0,0,0,0,0,,0,1,0,1,0,0,17,2
300,Ilia Gruev,bg BUL,MF,Leeds United,,24.99452055,2000,18.9,38,23,8,23,7,16,27,59.3,11,16,2,14,19,57,21,0
301,Makhtar Gueye,sn SEN,FW,Blackburn,,27.41369863,1997,24.4,23,12,9,13,1,7,18,38.9,11,21,6,15,7,30,62,0
302,Josuha Guilavogui,fr FRA,"MF,DF",Leeds United,,34.62191781,1990,0.7,4,4,1,3,0,3,4,75,1,0,0,0,2,6,2,0
303,Angus Gunn,sct SCO,GK,Norwich City,,29.27945205,1996,34.5,2,1,2,0,0,2,2,100,0,0,0,0,0,2,21,1
304,Darko Gyabi,eng ENG,MF,Plymouth Argyle,,21.20547945,2004,31.6,68,47,21,37,10,29,62,46.8,33,37,6,31,22,90,48,1
305,Hayden Hackney,eng ENG,MF,Middlesbrough,,22.85479452,2002,42.1,93,56,43,40,10,50,99,50.5,49,61,11,50,30,123,41,3
306,Rami Al Hajj,se SWE,MF,Plymouth Argyle,,23.62739726,2001,15.3,31,14,12,15,4,10,13,76.9,3,25,3,22,5,36,27,0
307,Ali Al Hamadi,iq IRQ,FW,Stoke City,,23.17534247,2002,9.2,11,7,4,5,2,3,3,100,0,6,1,5,1,12,8,0
308,Gustavo Hamer,nl NED,"FW,MF",Sheffield Utd,,27.86027397,1997,34.7,47,29,13,25,9,24,53,45.3,29,29,0,29,26,73,28,0
309,Micah Hamilton,eng ENG,FW,Middlesbrough,,21.47123288,2003,3.5,5,4,1,2,2,2,6,33.3,4,1,0,1,0,5,4,1
310,Grant Hanley,sct SCO,DF,Norwich City,,33.45205479,1991,0.9,2,1,1,1,0,0,0,,0,0,0,0,0,2,4,1
311,Ryan Hardie,sct SCO,"FW,MF",Plymouth Argyle,,28.13150685,1997,25.2,13,7,3,10,0,5,30,16.7,25,20,6,14,6,19,23,0
312,Wes Harding,jm JAM,DF,Millwall,,28.5369863,1996,2.1,3,2,1,2,0,2,3,66.7,1,1,0,1,1,4,6,1
313,Marcus Harness,eng ENG,"MF,FW",Derby County,,29.1890411,1996,26.2,60,32,19,29,12,23,45,51.1,22,38,7,31,13,73,33,0
314,Mark Harris,wls WAL,FW,Oxford United,,26.34520548,1998,32.1,28,19,6,15,7,12,31,38.7,19,22,4,18,4,32,15,0
315,Daiki Hashioka,jp JPN,DF,Luton Town,,25.96438356,1999,13.4,30,21,18,11,1,14,21,66.7,7,15,5,10,15,45,64,0
316,Joseph Hatch,wls WAL,MF,Plymouth Argyle,,18.65479452,2006,0,0,0,0,0,0,0,0,,0,0,0,0,0,0,0,0
317,Ryo Hatsuse,jp JPN,"DF,MF",Sheffield Weds,,27.81643836,1997,3.9,6,5,3,2,1,5,11,45.5,6,4,1,3,1,7,13,0
318,Isaac Hayden,eng ENG,MF,Portsmouth,,30.11780822,1995,10.4,31,19,7,16,8,12,20,60,8,16,6,10,10,41,22,0
319,Conor Hazard,nir NIR,GK,Plymouth Argyle,,27.16438356,1998,25,0,0,0,0,0,0,1,0,1,0,0,0,1,1,14,0
320,Ryan Hedges,wls WAL,FW,Blackburn,,29.82191781,1995,28.5,72,47,32,24,16,28,40,70,12,33,4,29,34,106,48,0
321,Torbjørn Heggem,no NOR,DF,West Brom,,26.30684932,1999,44.6,73,47,55,18,0,41,52,78.8,11,53,32,21,31,104,257,3
322,Michał Helik,pl POL,DF,Oxford United,,29.64931507,1995,20,22,11,17,4,1,9,13,69.2,4,24,21,3,18,40,166,0
323,Onel Hernández,cu CUB,"FW,MF",Norwich City,,32.25205479,1993,7.1,5,4,2,3,0,1,2,50,1,5,0,5,3,8,4,0
324,Brad Hills,eng ENG,DF,Norwich City,,21.15068493,2004,0.2,0,0,0,0,0,0,0,,0,0,0,0,0,0,0,0
325,Yu Hirakawa,jp JPN,"FW,MF",Bristol City,,24.32876712,2001,18.4,25,21,15,6,4,12,20,60,8,15,0,15,5,30,22,0
326,Václav Hladký,cz CZE,GK,Burnley,,34.46849315,1990,1,0,0,0,0,0,0,0,,0,0,0,0,0,0,0,0
327,Rob Holding,eng ENG,DF,Sheffield Utd,,29.61917808,1995,4.7,4,3,3,1,0,1,2,50,1,6,6,0,5,9,33,0
328,Mason Holgate,eng ENG,DF,West Brom,,28.53150685,1996,22,35,19,24,8,3,17,32,53.1,15,28,19,9,27,62,126,1
329,Duane Holmes,us USA,"MF,FW",Preston,,30.49041096,1994,9.3,17,12,5,9,3,9,22,40.9,13,8,0,8,6,23,11,0
330,Tom Holmes,eng ENG,DF,Luton Town,,25.14520548,2000,14.6,24,21,8,14,2,9,15,60,6,17,9,8,15,39,76,0
331,George Honeyman,eng ENG,"MF,FW",Millwall,,30.65205479,1994,26.9,76,56,27,35,14,26,44,59.1,18,25,2,23,21,97,35,1
332,Ethan Horvath,us USA,GK,Cardiff City,,29.90136986,1995,17,0,0,0,0,0,0,1,0,1,0,0,0,0,0,11,0
333,Jordan Houghton,eng ENG,MF,Plymouth Argyle,,29.48219178,1995,17,35,23,19,12,4,12,24,50,12,25,7,18,9,44,40,0
334,Andreas Hountondji,bj BEN,"FW,MF",Burnley,,22.81369863,2002,2.3,1,1,0,0,1,1,2,50,1,4,1,3,1,2,4,0
335,Jonny Howson,eng ENG,"DF,MF",Middlesbrough,,36.95342466,1988,15.5,24,15,15,9,0,14,22,63.6,8,14,6,8,19,43,76,3
336,Andrew Hughes,wls WAL,DF,Preston,,32.91232877,1992,36,72,39,37,33,2,37,49,75.5,12,52,23,29,36,108,166,0
337,Charlie Hughes,eng ENG,DF,Hull City,,21.54794521,2003,26.1,26,18,12,13,1,7,11,63.6,4,31,23,8,35,61,167,2
338,Trai Hume,nir NIR,DF,Sunderland,,23.12876712,2002,42.3,119,74,63,43,13,62,112,55.4,50,50,18,32,45,164,149,0
339,Bashir Humphreys,eng ENG,DF,Burnley,,22.1369863,2003,19.7,42,30,23,15,4,30,51,58.8,21,17,1,16,22,64,62,2
340,Shaun Hutchinson,eng ENG,DF,Millwall,,34.44383562,1990,4.4,10,7,6,3,1,9,9,100,0,4,2,2,3,13,20,0
341,Dominic Hyam,sct SCO,DF,Blackburn,,29.36986301,1995,46,46,28,29,15,2,29,43,67.4,14,53,34,19,25,71,352,3
342,Adam Idah,ie IRL,FW,Norwich City,,24.22465753,2001,0.3,0,0,0,0,0,0,1,0,1,0,0,0,0,0,0,0
343,Kelechi Iheanacho,ng NGA,"FW,MF",Middlesbrough,,28.58356164,1996,8.5,11,8,3,5,3,6,12,50,6,7,0,7,0,11,9,0
344,Michael Ihiekwe,eng ENG,DF,Sheffield Weds,,32.45205479,1992,20.2,17,11,13,4,0,13,24,54.2,11,18,16,2,19,36,135,0
345,Samuel Iling-Junior,eng ENG,"DF,FW",Middlesbrough,,21.58082192,2003,11.7,26,16,15,8,3,12,23,52.2,11,13,3,10,11,37,48,0
346,Tom Ince,eng ENG,"MF,FW",Watford,,33.25753425,1992,14.3,15,10,7,6,2,5,11,45.5,6,10,1,9,7,22,18,0
347,Svante Ingelsson,se SWE,"MF,FW",Sheffield Weds,,26.88767123,1998,18.8,48,33,20,20,8,20,39,51.3,19,23,4,19,16,64,19,0
348,Matt Ingram,eng ENG,GK,Oxford United,,31.37534247,1993,1,0,0,0,0,0,0,0,,0,0,0,0,0,0,0,0
349,Dominic Iorfa,eng ENG,DF,Sheffield Weds,,29.86027397,1995,15.9,22,11,12,8,2,11,14,78.6,3,9,5,4,18,40,86,0
350,Wilson Isidor,fr FRA,FW,Sunderland,,24.68493151,2000,34.6,15,6,7,5,3,5,14,35.7,9,14,1,13,7,22,24,0
351,Frederick Issaka,wls WAL,"FW,MF",Plymouth Argyle,,18.76712329,2006,6.6,11,7,6,4,1,6,18,33.3,12,7,1,6,4,15,3,0
352,Vakoun Issouf Bayo,ci CIV,FW,Watford,,28.31232877,1997,24.9,20,13,4,12,4,6,14,42.9,8,18,4,14,3,23,25,0
353,Mihailo Ivanović,rs SRB,"FW,MF",Millwall,,20.42739726,2004,24.2,13,10,3,7,3,1,9,11.1,8,8,1,7,3,16,38,0
354,Kayden Jackson,eng ENG,"FW,DF",Derby County,,31.19452055,1994,28.6,41,22,21,15,5,22,41,53.7,19,30,2,28,13,54,52,0
355,Matty Jacob,eng ENG,DF,Hull City,,23.91780822,2001,5,9,5,5,3,1,1,6,16.7,5,7,2,5,5,14,39,1
356,Daniel James,wls WAL,FW,Leeds United,,27.47945205,1997,29,28,14,3,17,8,13,49,26.5,36,16,0,16,4,32,8,0
357,William Jarvis,eng ENG,"MF,FW",Hull City,,22.37808219,2002,1.8,10,4,6,3,1,3,5,60,2,1,0,1,0,10,3,0
358,Daniel Jebbison,eng ENG,FW,Watford,,21.72328767,2003,4.3,5,1,2,0,3,4,5,80,1,3,0,3,0,5,2,0
359,Lukas Jensen,dk DEN,GK,Millwall,,26.12876712,1999,41,0,0,0,0,0,0,1,0,1,2,0,2,0,0,15,2
360,Eom Jisung,kr KOR,"FW,MF",Swansea City,,22.98630137,2002,25.4,38,20,10,16,12,18,40,45,22,37,6,31,17,55,28,2
361,Viktor Johansson,se SWE,GK,Stoke City,,26.63561644,1998,46,1,0,1,0,0,1,2,50,1,0,0,0,0,1,43,5
362,Daniel Johnson,jm JAM,FW,Stoke City,,32.56986301,1992,0.1,0,0,0,0,0,0,0,,0,0,0,0,0,0,0,0
363,Joseph Johnson,eng ENG,DF,Luton Town,,19.19726027,2006,5.2,10,7,3,7,0,2,3,66.7,1,5,2,3,2,12,15,1
364,Marvin Johnson,eng ENG,"DF,MF",Sheffield Weds,,34.42191781,1990,31.1,63,28,38,20,5,29,53,54.7,24,28,8,20,28,91,85,1
365,Michael Johnston,ie IRL,"FW,MF",West Brom,,26.04109589,1999,23,26,17,10,13,3,11,29,37.9,18,14,1,13,11,37,13,0
366,Alfie Jones,eng ENG,DF,Hull City,,27.57260274,1997,37.7,27,19,16,11,0,19,25,76,6,41,29,12,36,63,182,1
367,Harrison Jones,eng ENG,MF,Sunderland,,20.35616438,2004,1.5,3,3,1,2,0,1,2,50,1,1,0,1,0,3,0,0
368,Isaiah Jones,gy GUY,FW,Middlesbrough,,25.85479452,1999,8.8,21,12,9,8,4,8,12,66.7,4,3,0,3,5,26,16,1
369,Isaiah Jones,gy GUY,"DF,MF",Luton Town,,25.85479452,1999,14.6,29,18,16,7,6,14,27,51.9,13,10,0,10,14,43,31,0
370,Kyle Joseph,sct SCO,FW,Hull City,,23.64657534,2001,11.2,9,6,1,6,2,2,11,18.2,9,12,4,8,5,14,25,0
371,Mateo Joseph,es ESP,FW,Leeds United,,21.53972603,2003,14.3,14,6,3,7,4,5,16,31.3,11,17,2,15,3,17,13,0
372,Mads Juel Andersen,dk DEN,DF,Luton Town,,27.35068493,1997,4.6,6,3,5,1,0,2,4,50,2,3,2,1,6,12,33,0
373,Bae Junho,kr KOR,"FW,MF",Stoke City,,21.70136986,2003,36.2,88,50,38,36,14,30,62,48.4,32,52,3,49,33,121,19,1
374,Matěj Jurásek,cz CZE,"FW,MF",Norwich City,,21.67671233,2003,0.9,0,0,0,0,0,0,1,0,1,2,0,2,0,0,1,0
375,Abdoulaye Kamara,gn GUI,"MF,FW",Portsmouth,,20.49041096,2004,1.4,3,2,3,0,0,1,3,33.3,2,4,1,3,0,3,0,1
376,Abu Kamara,eng ENG,FW,Norwich City,,21.78630137,2003,0.2,3,2,2,0,1,1,1,100,0,0,0,0,1,4,0,0
377,Abu Kamara,eng ENG,"FW,MF",Hull City,,21.78630137,2003,25.1,36,23,20,9,7,13,32,40.6,19,25,0,25,16,52,28,0
378,Thomas Kaminski,be BEL,GK,Luton Town,,32.52876712,1992,44.3,0,0,0,0,0,0,0,,0,0,0,0,0,0,25,1
379,Wilfried Kanga,ci CIV,FW,Cardiff City,,27.19726027,1998,5.1,0,0,0,0,0,0,0,,0,4,1,3,0,0,11,0
380,Augustus Kargbo,sl SLE,FW,Blackburn,,25.69315068,1999,2.1,5,5,2,3,0,1,3,33.3,2,0,0,0,0,5,1,0
381,Nikola Katić,ba BIH,DF,Plymouth Argyle,,28.56438356,1996,13.6,28,19,17,8,3,15,22,68.2,7,24,14,10,13,41,160,2
382,Edo Kayembe,cd COD,"MF,FW",Watford,,26.91780822,1998,35.5,37,25,20,11,6,13,30,43.3,17,26,3,23,15,52,28,3
383,Will Keane,ie IRL,"FW,MF",Preston,,32.30958904,1993,12.5,5,3,3,2,0,3,9,33.3,6,6,1,5,3,8,18,0
384,Kévin Keben Biakolo,cm CMR,DF,Watford,,21.26849315,2004,2.8,4,2,3,1,0,2,2,100,0,1,1,0,1,5,25,0
385,Daniel Kelly,sct SCO,MF,Millwall,,19.58356164,2005,0.2,1,0,0,1,0,1,1,100,0,0,0,0,0,1,0,0
386,Kaine Kesler-Hayden,eng ENG,"DF,FW",Preston,,22.52876712,2002,40.8,68,47,34,30,4,27,45,60,18,41,13,28,21,89,136,1
387,Josh Key,eng ENG,DF,Swansea City,,25.45479452,1999,38.5,56,29,37,13,6,32,55,58.2,23,35,18,17,31,87,104,7
388,Ben Killip,eng ENG,GK,Portsmouth,,29.44109589,1995,2,0,0,0,0,0,0,0,,0,0,0,0,0,0,1,0
389,Peter Kioso,cd COD,DF,Oxford United,,26.71780822,1998,25.6,56,33,34,20,2,38,49,77.6,11,38,18,20,34,90,106,3
390,Liam Kitching,eng ENG,DF,Coventry City,,25.5890411,1999,25.4,35,18,16,17,2,21,29,72.4,8,30,21,9,19,54,148,1
391,Jason Knight,ie IRL,MF,Bristol City,,24.21917808,2001,46,71,41,20,47,4,34,64,53.1,30,33,14,19,39,110,70,2
392,Olaf Kobacki,pl POL,"FW,MF",Sheffield Weds,,23.81643836,2001,4.1,18,8,11,6,1,9,15,60,6,6,2,4,3,21,5,0
393,Luca Koleosho,it ITA,"FW,MF",Burnley,,20.63287671,2004,18.6,33,16,10,16,7,11,24,45.8,13,13,0,13,7,40,4,0
394,Rayan Kolli,dz ALG,FW,QPR,,20.22739726,2005,9.1,8,6,4,2,2,2,3,66.7,1,5,2,3,3,11,13,0
395,Lewis Koumas,wls WAL,"FW,MF",Stoke City,,19.62191781,2005,27.1,50,32,25,11,14,19,47,40.4,28,17,2,15,10,60,13,0
396,Ronan Kpakio,wls WAL,DF,Cardiff City,,17.94246575,2007,1.2,5,3,2,1,2,2,2,100,0,1,0,1,2,7,2,0
397,Tom Krauß,de GER,MF,Luton Town,,23.86575342,2001,17.8,81,53,25,37,19,33,62,53.2,29,36,4,32,16,97,18,0
398,Paddy Lane,nir NIR,"MF,FW",Portsmouth,,24.20547945,2001,11.9,13,9,6,3,4,8,16,50,8,2,2,0,4,17,10,0
399,Callum Lang,eng ENG,"MF,FW",Portsmouth,,26.65205479,1998,27.1,30,19,11,11,8,10,26,38.5,16,32,2,30,11,41,24,0
400,Sondre Langås,no NOR,DF,Derby County,,24.24931507,2001,12.4,22,13,18,4,0,9,15,60,6,11,6,5,9,31,74,0
401,Macaulay Langstaff,eng ENG,FW,Millwall,,28.24657534,1997,15.4,10,6,2,5,3,3,10,30,7,9,0,9,2,12,8,0
402,Will Lankshear,eng ENG,FW,West Brom,,20.03835616,2005,3.9,2,1,1,1,0,1,4,25,3,4,1,3,1,3,1,0
403,Yasser Larouci,dz ALG,"DF,MF",Watford,,24.3369863,2001,23.7,30,20,18,11,1,17,31,54.8,14,24,0,24,29,59,99,1
404,Joël Latibeaudière,jm JAM,DF,Coventry City,,25.32328767,2000,28.6,51,30,27,19,5,25,37,67.6,12,32,20,12,29,80,118,0
405,Emmanuel Latte Lath,ci CIV,FW,Middlesbrough,,26.3369863,1999,19.6,19,14,6,9,4,3,8,37.5,5,23,2,21,6,25,7,0
406,Josh Laurent,eng ENG,MF,Stoke City,,29.99452055,1995,3,7,4,2,4,1,5,9,55.6,4,4,0,4,3,10,6,0
407,Josh Laurent,eng ENG,MF,Burnley,,29.99452055,1995,27.2,52,32,23,26,3,18,36,50,18,29,7,22,29,81,44,1
408,Mohammed Lawal,ie IRL,"DF,MF",Stoke City,,21.92876712,2003,2.3,4,3,2,2,0,2,2,100,0,2,0,2,1,5,10,0
409,Dyaln Lawlor,wls WAL,DF,Cardiff City,,19.3369863,2006,0.6,3,1,2,1,0,2,2,100,0,1,1,0,2,5,2,0
410,Enzo Le Fée,fr FRA,"FW,MF",Sunderland,,25.24657534,2000,11.1,37,23,13,11,13,12,30,40,18,17,1,16,15,52,16,0
411,Tom Leahy,eng ENG,FW,Millwall,,21.09315068,2004,0,0,0,0,0,0,0,0,,0,0,0,0,0,0,0,0
412,Ryan Ledson,eng ENG,MF,Preston,,27.70684932,1997,13.5,32,23,12,15,5,13,26,50,13,20,4,16,11,43,24,0
413,Greg Leigh,jm JAM,DF,Oxford United,,30.59178082,1994,26,38,21,22,14,2,24,32,75,8,25,5,20,34,72,94,1
414,Harry Leonard,eng ENG,"FW,MF",Blackburn,,21.64109589,2003,1.7,1,0,0,1,0,0,0,,0,0,0,0,1,2,4,0
415,Ryan Leonard,eng ENG,DF,Millwall,,32.94520548,1992,29.2,77,50,52,22,3,44,68,64.7,24,17,8,9,35,112,119,1
416,Lincoln,br BRA,"FW,MF",Hull City,,26.48767123,1998,4.7,14,6,9,4,1,6,9,66.7,3,6,3,3,3,17,7,0
417,Liam Lindsay,sct SCO,DF,Preston,,29.55890411,1995,29,39,23,30,9,0,22,33,66.7,11,40,20,20,49,88,226,0
418,Alfie Lloyd,eng ENG,"FW,MF",QPR,,22.0109589,2003,8.3,15,9,5,5,5,7,11,63.6,4,8,0,8,0,15,11,0
419,Ben Lloyd,wls WAL,"MF,FW",Swansea City,,20.13972603,2005,0.1,0,0,0,0,0,0,0,,0,1,0,1,0,0,0,0
420,George Long,eng ENG,GK,Norwich City,,31.49315068,1993,8.5,0,0,0,0,0,0,0,,0,0,0,0,0,0,6,0
421,Sam Long,eng ENG,DF,Oxford United,,30.29589041,1995,18.4,28,16,14,13,1,16,29,55.2,13,36,16,20,25,53,108,2
422,Ryan Longman,eng ENG,"FW,MF",Hull City,,24.49041096,2000,5.3,10,8,1,6,3,4,9,44.4,5,4,0,4,3,13,7,0
423,Imran Louza,ma MAR,MF,Watford,,26.00821918,1999,29.7,63,40,26,29,8,29,51,56.9,22,30,7,23,34,97,38,1
424,Jamal Lowe,jm JAM,"FW,MF",Sheffield Weds,,30.78630137,1994,10.7,11,7,2,4,5,4,11,36.4,7,9,1,8,4,15,11,0
425,Max Lowe,eng ENG,DF,Sheffield Weds,,27.98082192,1997,29.8,83,53,50,27,6,43,62,69.4,19,39,10,29,41,124,153,0
426,Nathan Lowe,eng ENG,"FW,MF",Stoke City,,19.62465753,2005,5.2,6,4,0,4,2,0,5,0,5,3,0,3,1,7,6,0
427,Lucas,br BRA,DF,Burnley,,24.11232877,2001,31,72,40,40,23,9,41,67,61.2,26,28,8,20,45,117,93,2
428,Nicolas Madsen,dk DEN,"MF,FW",QPR,,25.13150685,2000,19.5,17,11,10,4,3,2,12,16.7,10,25,6,19,16,33,25,0
429,Lucien Mahovo,eng ENG,DF,Norwich City,,19.90684932,2005,5.8,10,8,3,7,0,7,11,63.6,4,8,4,4,2,12,14,0
430,Josh Maja,ng NGA,FW,West Brom,,26.35068493,1998,22.8,13,5,1,10,2,3,10,30,7,10,1,9,11,24,11,1
431,Christ Makosso,cg CGO,DF,Luton Town,,20.98630137,2004,10.6,15,9,12,3,0,9,11,81.8,2,9,1,8,6,21,68,0
432,Million Manhoef,nl NED,"FW,MF",Stoke City,,23.33150685,2002,26.9,20,13,7,8,5,7,25,28,18,13,1,12,4,24,13,0
433,Sivert Mannsverk,no NOR,MF,Cardiff City,,22.9890411,2002,11.2,18,12,11,6,1,8,21,38.1,13,13,5,8,15,33,18,1
434,Benson Manuel,ao ANG,"MF,FW",Burnley,,28.10136986,1997,0.5,2,2,0,2,0,1,1,100,0,0,0,0,0,2,0,0
435,Emiliano Marcondes,dk DEN,"MF,FW",Norwich City,,30.15342466,1995,25.3,48,27,20,24,4,16,45,35.6,29,29,10,19,23,71,28,1
436,Ephron Mason-Clark,eng ENG,"FW,MF",Coventry City,,25.69041096,1999,18.1,22,12,8,9,5,8,17,47.1,9,13,2,11,7,29,8,0
437,Han-Noah Massengo,fr FRA,MF,Burnley,,23.82465753,2001,1.1,2,0,1,1,0,0,0,,0,2,1,1,1,3,5,0
438,Zavier Massiah,eng ENG,FW,Watford,,18.29589041,2007,0.6,3,1,2,0,1,2,2,100,0,3,0,3,0,3,0,0
439,Eliot Matazo,be BEL,MF,Hull City,,23.21369863,2002,3.3,3,2,2,1,0,2,2,100,0,0,0,0,5,8,7,0
440,Alex Matos,eng ENG,MF,Oxford United,,20.58356164,2004,10.4,49,29,20,24,5,17,30,56.7,13,26,4,22,18,67,21,0
441,Hayden Matthews,au AUS,DF,Portsmouth,,20.8739726,2004,3.5,6,3,1,5,0,3,4,75,1,2,1,1,1,7,20,0
442,Eliezer Mayenda,es ESP,"FW,MF",Sunderland,,19.9890411,2005,23.9,18,6,9,2,7,4,18,22.2,14,16,0,16,4,22,8,0
443,Fally Mayulu,fr FRA,FW,Bristol City,,22.80273973,2002,4.5,6,4,1,3,2,2,3,66.7,1,2,0,2,0,6,6,0
444,Sam McCallum,eng ENG,"DF,MF",Sheffield Utd,,24.66849315,2000,11.7,22,11,12,9,1,11,21,52.4,10,16,3,13,26,48,49,0
445,Alistair McCann,nir NIR,MF,Preston,,25.41369863,1999,26.9,99,66,41,44,14,36,80,45,44,51,9,42,28,127,51,0
446,Ruairi Mcconville,nir NIR,DF,Norwich City,,20.00821918,2005,2.3,5,3,2,2,1,2,4,50,2,4,3,1,3,8,10,0
447,George McCormick,eng ENG,FW,Middlesbrough,,20.26575342,2005,0,0,0,0,0,0,0,0,,0,0,0,0,0,0,1,0
448,Ross McCrorie,sct SCO,"DF,MF",Bristol City,,27.12876712,1998,16.4,51,32,20,23,8,21,42,50,21,17,5,12,18,69,36,0
449,Josh McEachran,eng ENG,MF,Oxford United,,32.17534247,1993,5.6,17,8,6,9,2,6,8,75,2,5,2,3,7,24,8,0
450,Kyle McFadzean,sct SCO,FW,Blackburn,,38.2,1987,0,0,0,0,0,0,0,0,,0,0,0,0,0,0,0,0
451,Riley McGree,au AUS,FW,Middlesbrough,,26.50136986,1998,10.5,8,5,1,5,2,6,11,54.5,5,6,0,6,2,10,9,0
452,Marcus McGuane,eng ENG,MF,Bristol City,,26.24931507,1999,11.8,27,16,9,11,7,8,16,50,8,14,4,10,7,34,8,0
453,Mark McGuinness,ie IRL,DF,Luton Town,,24.3260274,2001,41.7,47,25,31,14,2,24,42,57.1,18,53,39,14,51,98,276,2
454,Tom McIntyre,sct SCO,DF,Portsmouth,,26.49041096,1998,11.3,18,11,11,7,0,11,18,61.1,7,18,14,4,17,35,54,0
455,Kenny McLean,sct SCO,"MF,DF",Norwich City,,33.31780822,1992,33.3,80,46,33,38,9,43,72,59.7,29,25,8,17,35,115,41,2
456,Sean McLoughlin,ie IRL,DF,Hull City,,28.47123288,1996,35.7,35,22,19,11,5,21,44,47.7,23,52,26,26,36,71,211,3
457,Paddy McNair,nir NIR,DF,West Brom,,30.01917808,1995,1,1,1,0,1,0,0,0,,0,1,1,0,1,2,4,0
458,Luke McNally,ie IRL,DF,Bristol City,,25.61917808,1999,25.8,42,26,24,16,2,22,33,66.7,11,30,21,9,34,76,162,2
459,Luke McNally,ie IRL,"DF,MF",Burnley,,25.61917808,1999,0,1,1,1,0,0,1,2,50,1,0,0,0,0,1,0,0
460,Dan McNamara,ie IRL,DF,Millwall,,26.35068493,1998,7.6,16,8,12,4,0,10,17,58.8,7,11,4,7,11,27,33,0
461,Charlie McNeill,eng ENG,"MF,FW",Sheffield Weds,,21.64931507,2003,0.6,2,1,1,1,0,0,0,,0,0,0,0,1,3,0,0
462,Jayden Meghoma,eng ENG,"DF,FW",Preston,,18.84931507,2006,8.5,21,11,14,5,2,10,13,76.9,3,7,0,7,8,29,25,1
463,Marvin Mehlem,de GER,MF,Hull City,,27.64383562,1997,10,20,11,5,9,6,6,19,31.6,13,8,0,8,5,25,4,0
464,Anis Mehmeti,al ALB,"FW,MF",Bristol City,,24.31506849,2001,28.4,34,22,7,21,6,17,49,34.7,32,22,3,19,7,41,20,1
465,Yakou Méïte,ci CIV,FW,Cardiff City,,29.22465753,1996,13.3,17,13,4,9,4,8,19,42.1,11,7,3,4,7,24,16,0
466,Hannibal Mejbri,tn TUN,"MF,FW",Burnley,,22.28219178,2003,21.4,37,21,11,20,6,14,27,51.9,13,31,1,30,12,49,10,0
467,Nathaniel Mendez-Laing,gt GUA,"FW,MF",Derby County,,33.05205479,1992,23.3,42,34,15,16,11,13,34,38.2,21,27,1,26,24,66,28,1
468,Teden Mengi,eng ENG,DF,Luton Town,,23.0109589,2002,17.4,31,20,23,6,2,19,24,79.2,5,17,14,3,29,60,80,1
469,Chris Mepham,wls WAL,DF,Sunderland,,27.49315068,1997,36.4,52,31,37,14,1,32,50,64,18,47,33,14,34,86,237,3
470,Illan Meslier,fr FRA,GK,Leeds United,,25.17260274,2000,39,0,0,0,0,0,0,0,,0,0,0,0,0,0,19,3
471,Liam Millar,ca CAN,"MF,FW",Hull City,,25.6,1999,6.9,8,6,7,1,0,3,9,33.3,6,12,0,12,4,12,5,0
472,Stanley Mills,eng ENG,"FW,MF",Oxford United,,21.52328767,2003,3.9,13,9,8,3,2,10,15,66.7,5,6,1,5,2,15,7,0
473,Yang Minhyeok,kr KOR,"FW,MF",QPR,,19.04931507,2006,7.7,10,8,2,7,1,1,8,12.5,7,7,0,7,7,17,3,2
474,Billy Mitchell,eng ENG,MF,Millwall,,25.03287671,2000,9.9,27,17,12,13,2,14,22,63.6,8,13,4,9,14,41,19,0
475,Idris El Mizouni,tn TUN,MF,Oxford United,,24.60273973,2000,13.8,45,23,16,27,2,15,36,41.7,21,17,2,15,13,58,15,1
476,Ryan Mmaee,ma MAR,FW,Stoke City,,27.50410959,1997,1.2,0,0,0,0,0,0,0,,0,2,0,2,0,0,1,0
477,Jayson Molumby,ie IRL,MF,West Brom,,25.74246575,1999,30,50,31,19,23,8,20,47,42.6,27,30,9,21,26,76,50,2
478,Kristi Montgomery,sct SCO,DF,Blackburn,,20.9260274,2004,1.5,4,2,3,1,0,3,6,50,3,4,1,3,1,5,3,0
479,Elliott Moore,eng ENG,DF,Oxford United,,28.13424658,1997,22.9,19,11,16,3,0,10,13,76.9,3,29,22,7,16,35,168,0
480,Kieffer Moore,wls WAL,FW,Sheffield Utd,,32.7369863,1992,19.6,11,8,2,8,1,2,8,25,6,12,0,12,4,15,35,1
481,Simon Moore,eng ENG,GK,Sunderland,,34.95890411,1990,4,0,0,0,0,0,0,0,,0,0,0,0,0,0,3,0
482,Andrew Moran,ie IRL,"MF,FW",Stoke City,,21.55068493,2003,26.2,67,41,18,31,18,23,62,37.1,39,26,9,17,18,85,36,0
483,Kieran Morgan,eng ENG,MF,QPR,,19.13150685,2006,17.6,24,14,9,9,6,8,20,40,12,8,3,5,10,34,21,0
484,Aidan Morris,us USA,MF,Middlesbrough,,23.4630137,2001,32.4,97,65,45,43,9,39,74,52.7,35,43,4,39,33,130,29,5
485,Carlton Morris,eng ENG,FW,Luton Town,,29.38082192,1995,34.7,16,9,6,5,5,5,25,20,20,20,3,17,5,21,55,0
486,James Morris,eng ENG,DF,Watford,,23.44383562,2001,12.1,21,19,11,7,3,13,18,72.2,5,12,6,6,8,29,32,2
487,Elijah Morrison,eng ENG,DF,Bristol City,,19.12876712,2006,0.4,3,2,1,1,1,0,1,0,1,0,0,0,1,4,8,0
488,Liam Morrison,sct SCO,DF,QPR,,22.0739726,2003,14.5,15,12,12,3,0,10,14,71.4,4,16,10,6,18,33,95,0
489,Victor Moses,ng NGA,"DF,MF",Luton Town,,34.39178082,1990,12.6,27,16,10,9,8,15,26,57.7,11,27,8,19,7,34,26,0
490,Alex Mowatt,eng ENG,MF,West Brom,,30.21917808,1995,37.2,71,38,35,21,15,33,60,55,27,35,18,17,27,98,56,2
491,Owen Moxon,eng ENG,MF,Portsmouth,,27.29315068,1998,3.1,11,5,3,7,1,5,8,62.5,3,6,1,5,2,13,4,0
492,Bali Mumba,eng ENG,"DF,MF",Plymouth Argyle,,23.56986301,2001,37.7,84,55,51,28,5,42,64,65.6,22,31,8,23,22,106,90,4
493,Romaine Mundle,eng ENG,"FW,MF",Sunderland,,22.02739726,2003,15.9,26,18,7,16,3,8,13,61.5,5,20,1,19,8,34,18,0
494,Josh Murphy,eng ENG,FW,Portsmouth,,30.1890411,1995,38.1,39,22,20,12,7,28,77,36.4,49,62,5,57,26,65,31,1
495,Anthony Musaba,nl NED,"FW,MF",Sheffield Weds,,24.40821918,2000,14.8,11,9,6,4,1,5,15,33.3,10,13,2,11,5,16,4,0
496,Elliot Myles,wls WAL,MF,Norwich City,,18.28493151,2007,0.5,1,0,1,0,0,1,1,100,0,1,0,1,0,1,1,0
497,Amin Nabizada,eng ENG,MF,Watford,,17.86849315,2007,0.2,0,0,0,0,0,0,0,,0,0,0,0,0,0,0,0
498,Kal Naismith,sct SCO,DF,Bristol City,,33.20547945,1992,3.2,7,6,4,3,0,5,6,83.3,1,4,2,2,2,9,10,1
499,Kal Naismith,sct SCO,"DF,MF",Luton Town,,33.20547945,1992,5.1,12,5,5,7,0,7,10,70,3,10,4,6,4,16,38,1
500,Marvelous Nakamba,zw ZIM,MF,Luton Town,,31.28767123,1994,14.4,40,17,17,21,2,13,27,48.1,14,16,5,11,13,53,19,2
501,Paul Nardi,fr FRA,GK,QPR,,30.96164384,1994,45,2,1,2,0,0,2,6,33.3,4,0,0,0,1,3,21,4
502,Kyle Naughton,eng ENG,DF,Swansea City,,36.46027397,1988,9.2,28,18,16,11,1,19,32,59.4,13,8,5,3,10,38,25,0
503,Camiel Neghli,nl NED,"FW,MF",Millwall,,23.49041096,2001,2.1,3,2,1,0,2,2,3,66.7,1,2,0,2,2,5,6,0
504,Dan Neil,eng ENG,MF,Sunderland,,23.3890411,2001,43.1,81,45,33,40,8,31,71,43.7,40,42,15,27,47,128,67,2
505,Benjamin Nelson,eng ENG,DF,Oxford United,,21.12876712,2004,15.2,22,17,14,7,1,15,18,83.3,3,21,15,6,21,43,96,0
506,Curtis Nelson,eng ENG,DF,Derby County,,31.95342466,1993,27,38,21,18,18,2,8,18,44.4,10,36,26,10,28,66,146,1
507,Zack Nelson,eng ENG,"MF,FW",Luton Town,,20.60821918,2004,8.9,17,9,7,9,1,9,17,52.9,8,18,1,17,6,23,12,0
508,Perry Ng,eng ENG,DF,Cardiff City,,29.01917808,1996,31,79,49,45,23,11,40,58,69,18,39,16,23,26,105,99,1
509,Jeremy Ngakia,,DF,Watford,,24.65479452,2000,20.9,89,57,62,22,5,44,68,64.7,24,35,8,27,28,117,69,1
510,Kevin Nisbet,sct SCO,FW,Millwall,,28.15616438,1997,0.1,1,0,0,1,0,0,0,,0,0,0,0,0,1,0,0
511,Lasse Nordås,no NOR,"FW,MF",Luton Town,,23.22739726,2002,2.8,2,0,0,1,1,0,3,0,3,2,0,2,1,3,10,0
512,Casper de Norre,be BEL,MF,Millwall,,28.23561644,1997,40.1,105,65,41,52,12,38,66,57.6,28,50,13,37,66,171,68,0
513,Rhys Norrington-Davies,wls WAL,DF,Sheffield Utd,,26.03287671,1999,2.8,4,1,3,1,0,3,5,60,2,4,2,2,3,7,13,0
514,Will Norris,eng ENG,GK,Portsmouth,,31.7260274,1993,8,1,1,1,0,0,1,1,100,0,0,0,0,0,1,4,1
515,Marcelino Núñez,cl CHI,MF,Norwich City,,25.17534247,2000,24.9,72,37,29,34,9,41,79,51.9,38,30,5,25,13,85,38,1
516,Tanatswa Nyakuhwa,wls WAL,DF,Cardiff City,,19.62739726,2005,0.2,0,0,0,0,0,0,0,,0,1,0,1,0,0,1,0
517,Ryan Nyambe,na NAM,DF,Derby County,,27.41369863,1997,12.5,28,19,13,14,1,13,18,72.2,5,18,3,15,13,41,23,1
518,Lewis O'Brien,eng ENG,MF,Swansea City,,26.55342466,1998,15.8,30,23,7,18,5,11,22,50,11,20,6,14,10,40,22,1
519,Gatlin O'Donkor,eng ENG,FW,Oxford United,,0,,0,1,1,0,0,1,0,0,,0,0,0,0,0,1,0,0
520,Callum O'Dowda,ie IRL,"DF,FW",Cardiff City,,30.03013699,1995,39.4,77,55,42,25,10,43,71,60.6,28,33,5,28,34,111,110,0
521,Callum O'Hare,eng ENG,"MF,FW",Sheffield Utd,,27.00821918,1998,34.9,43,32,14,19,10,13,47,27.7,34,33,1,32,8,51,23,0
522,Max O'Leary,ie IRL,GK,Bristol City,,28.56438356,1996,46,1,0,1,0,0,1,3,33.3,2,0,0,0,0,1,36,3
523,Mark O'Mahony,ie IRL,FW,Portsmouth,,20.30136986,2005,6.6,4,2,1,1,2,1,3,33.3,2,11,0,11,2,6,9,0
524,Luke O'Nien,eng ENG,DF,Sunderland,,30.44931507,1994,43.7,49,31,27,17,5,28,39,71.8,11,49,30,19,45,94,180,2
525,Dara O'Shea,ie IRL,DF,Burnley,,26.16712329,1999,2,1,0,1,0,0,0,1,0,1,2,1,1,3,4,9,0
526,Michael Obafemi,ie IRL,"FW,MF",Plymouth Argyle,,24.82739726,2000,13.3,10,4,2,6,2,4,11,36.4,7,11,1,10,1,11,3,0
527,Wilson Odobert,fr FRA,MF,Burnley,,20.43013699,2004,1,1,1,1,0,0,0,0,,0,2,1,1,0,1,1,1
528,Chiedozie Ogbene,ie IRL,"DF,MF",Luton Town,,28.00821918,1997,2.7,2,1,1,1,0,1,2,50,1,0,0,0,1,3,2,0
529,Nathanael Ogbeta,eng ENG,DF,Plymouth Argyle,,24.04383562,2001,7,20,12,16,3,1,14,19,73.7,5,5,1,4,5,25,38,0
530,Angelo Ogbonna,it ITA,DF,Watford,,36.94794521,1988,4.4,6,5,6,0,0,3,4,75,1,8,4,4,8,14,19,0
531,Connor Ogilvie,eng ENG,DF,Portsmouth,,29.21643836,1996,44.8,44,27,13,24,7,28,41,68.3,13,39,25,14,58,102,181,0
532,Yuki Ohashi,jp JPN,"FW,MF",Blackburn,,28.76986301,1996,24.7,35,21,8,18,9,9,22,40.9,13,26,3,23,6,41,24,0
533,Jeppe Okkels,dk DEN,"FW,MF",Preston,,25.76986301,1999,1.4,1,1,0,1,0,0,0,,0,1,0,1,1,2,1,0
534,Abdülkadir Ömür,tr TUR,"MF,FW",Hull City,,25.85753425,1999,11.8,16,12,5,11,0,3,12,25,9,9,1,8,5,21,5,0
535,Ryan One,sct SCO,FW,Sheffield Utd,,18.85479452,2006,3.2,2,0,0,1,1,1,1,100,0,1,0,1,1,3,4,0
536,Ben Osborn,eng ENG,"MF,DF",Derby County,,30.74520548,1994,18.9,36,20,18,16,2,13,24,54.2,11,17,2,15,21,57,31,1
537,Milutin Osmajić,me MNE,FW,Preston,,25.77534247,1999,21.3,9,5,2,6,1,1,4,25,3,11,0,11,1,10,9,1
538,Gabriel Otegbayo,,DF,Sheffield Weds,,0,,5.3,7,3,4,3,0,4,4,100,0,6,4,2,5,12,26,1
539,David Ozoh,eng ENG,MF,Derby County,,19.9260274,2005,7.8,36,24,20,12,4,15,21,71.4,6,15,1,14,13,49,6,1
540,Kenneth Paal,sr SUR,DF,QPR,,27.86027397,1997,32,52,29,31,18,3,29,51,56.9,22,40,7,33,38,90,130,1
541,Marlon Pack,eng ENG,"DF,MF",Portsmouth,,34.10958904,1991,30.1,37,18,17,16,4,13,34,38.2,21,31,17,14,31,68,111,1
542,Alex Palmer,eng ENG,GK,West Brom,,28.73150685,1996,30,3,2,3,0,0,3,3,100,0,0,0,0,0,3,18,1
543,Kasey Palmer,jm JAM,"MF,FW",Hull City,,28.48219178,1996,12.1,14,11,2,9,3,3,7,42.9,4,5,1,4,4,18,10,0
544,Kasey Palmer,jm JAM,"MF,FW",Coventry City,,28.48219178,1996,0.6,1,0,0,1,0,0,3,0,3,1,0,1,0,1,0,0
545,Liam Palmer,sct SCO,"DF,MF",Sheffield Weds,,33.62191781,1991,9.7,13,10,8,5,0,2,5,40,3,5,3,2,7,20,24,0
546,Victor Pálsson,is ISL,DF,Plymouth Argyle,,34.0109589,1991,19.3,33,18,26,7,0,18,31,58.1,13,37,23,14,31,64,170,0
547,Ivor Pandur,hr CRO,GK,Hull City,,25.10958904,2000,44,0,0,0,0,0,0,0,,0,0,0,0,0,0,38,6
548,Samuel Parker,wls WAL,"FW,DF",Swansea City,,18.82465753,2006,1,2,2,1,1,0,1,2,50,1,2,0,2,1,3,2,0
549,Callum Paterson,sct SCO,"FW,MF",Sheffield Weds,,30.55616438,1994,13.2,16,11,7,6,3,7,16,43.8,9,9,3,6,7,23,48,0
550,Jamie Paterson,eng ENG,"FW,MF",Coventry City,,33.36986301,1991,0.9,2,2,0,1,1,0,1,0,1,3,0,3,1,3,0,0
551,Anthony Patterson,eng ENG,GK,Sunderland,,24.98356164,2000,42,1,1,1,0,0,0,0,,0,0,0,0,0,1,16,3
552,Aynsley Pears,eng ENG,GK,Blackburn,,27.03013699,1998,40,2,1,2,0,0,2,3,66.7,1,0,0,0,1,3,18,6
553,Ben Pearson,eng ENG,MF,Stoke City,,30.32876712,1995,6.3,16,11,6,7,3,4,6,66.7,2,4,0,4,7,23,7,0
554,Myles Peart-Harris,eng ENG,"FW,MF",Swansea City,,22.62465753,2002,18.5,18,11,3,12,3,8,21,38.1,13,21,3,18,9,27,21,0
555,Sydie Peck,eng ENG,MF,Sheffield Utd,,20.63835616,2004,32.5,66,35,27,31,8,27,47,57.4,20,51,18,33,20,86,85,1
556,João Pedro,it ITA,FW,Hull City,,33.15342466,1992,23.8,11,6,1,8,2,2,12,16.7,10,10,2,8,4,15,19,0
557,Ashley Phillips,wls WAL,DF,Stoke City,,19.77260274,2005,34.2,23,15,11,11,1,8,10,80,2,48,42,6,34,57,208,1
558,Joshua Phillips,eng ENG,DF,Luton Town,,19.71232877,2005,0,0,0,0,0,0,0,0,,0,0,0,0,0,0,0,0
559,Matt Phillips,sct SCO,"FW,MF",Oxford United,,34.14246575,1991,10.6,12,6,3,8,1,8,18,44.4,10,12,1,11,5,17,23,0
560,Nathaniel Phillips,eng ENG,DF,Derby County,,28.12054795,1997,24.8,38,24,22,14,2,24,35,68.6,11,36,29,7,20,58,165,2
561,Harry Pickering,eng ENG,DF,Blackburn,,26.34520548,1998,11.5,17,10,7,8,2,8,14,57.1,6,8,3,5,10,27,42,0
562,Erik Pieters,nl NED,DF,Derby County,,36.73972603,1988,0,0,0,0,0,0,0,0,,0,0,0,0,0,0,0,0
563,Joël Piroe,nl NED,FW,Leeds United,,25.75342466,1999,34.2,17,11,0,10,7,7,12,58.3,5,13,1,12,8,25,32,0
564,Julio Pleguezuelo,es ESP,DF,Plymouth Argyle,,28.26849315,1997,21.8,67,44,47,19,1,43,52,82.7,9,26,15,11,34,101,187,3
565,Matthew Pollock,eng ENG,DF,Watford,,23.59726027,2001,42.4,47,32,28,17,2,35,51,68.6,16,56,43,13,60,107,256,2
566,Regan Poole,wls WAL,DF,Portsmouth,,26.87671233,1998,23.8,38,20,19,17,2,21,33,63.6,12,31,23,8,41,79,137,3
567,Ryan Porteous,sct SCO,DF,Preston,,26.10958904,1999,9.1,22,16,14,6,2,9,21,42.9,12,3,3,0,9,31,67,0
568,Ryan Porteous,sct SCO,DF,Watford,,26.10958904,1999,18.5,36,24,25,9,2,23,46,50,23,20,11,9,28,64,84,1
569,Brad Potts,eng ENG,"DF,MF",Preston,,30.83561644,1994,22.8,54,35,28,18,8,25,62,40.3,37,37,7,30,15,69,40,0
570,Freddie Potts,eng ENG,MF,Portsmouth,,21.64109589,2003,34,64,35,19,38,7,26,53,49.1,27,37,8,29,39,103,48,2
571,Ian Poveda,eng ENG,"FW,MF",Sunderland,,25.23013699,2000,1,5,5,2,3,0,3,5,60,2,1,0,1,0,5,0,0
572,Isaac Price,nir NIR,"MF,FW",West Brom,,21.60273973,2003,11.7,29,19,16,11,2,9,28,32.1,19,21,6,15,11,40,34,0
573,Cameron Pring,eng ENG,"DF,MF",Bristol City,,27.27945205,1998,24.8,57,35,26,26,5,26,46,56.5,20,34,10,24,23,80,99,1
574,Tymoteusz Puchacz,pl POL,DF,Plymouth Argyle,,26.27671233,1999,12.5,20,15,8,11,1,14,29,48.3,15,9,0,9,19,39,59,1
575,Gustavo Puerta,co COL,MF,Hull City,,21.78082192,2003,21,40,30,14,22,4,18,37,48.6,19,22,3,19,8,48,18,2
576,Przemysław Płacheta,pl POL,"FW,MF",Oxford United,,27.11506849,1998,23,33,19,14,16,3,16,42,38.1,26,10,0,10,13,46,19,0
577,Uroš Račić,rs SRB,MF,West Brom,,27.13150685,1998,10.2,25,14,6,15,4,13,24,54.2,11,8,3,5,10,35,21,0
578,Mileta Rajovic,dk DEN,FW,Watford,,25.79726027,1999,0.5,0,0,0,0,0,0,0,,0,1,1,0,0,0,2,0
579,Jesurun Rak Sakyi,eng ENG,"FW,MF",Sheffield Utd,,22.57808219,2002,19.2,37,22,19,14,4,17,34,50,17,23,3,20,11,48,8,1
580,Joe Ralls,eng ENG,MF,Cardiff City,,31.55890411,1993,12.8,22,11,6,15,1,10,24,41.7,14,14,6,8,14,36,11,0
581,Largie Ramazani,be BEL,FW,Leeds United,,24.18082192,2001,8.9,22,13,10,11,1,13,25,52,12,8,0,8,3,25,4,0
582,Aaron Ramsey,wls WAL,MF,Cardiff City,,34.35342466,1990,6.2,16,9,3,10,3,7,12,58.3,5,2,1,1,6,22,3,0
583,Aaron Ramsey,eng ENG,MF,Burnley,,22.28219178,2003,0.1,0,0,0,0,0,0,0,,0,2,0,2,0,0,0,0
584,Adam Randell,eng ENG,MF,Plymouth Argyle,,24.5890411,2000,37.5,66,39,22,38,6,32,63,50.8,31,48,24,24,49,115,104,5
585,Joe Rankin-Costello,eng ENG,"DF,FW",Blackburn,,25.77260274,1999,13.9,29,19,15,10,4,16,31,51.6,15,16,7,9,21,50,57,1
586,Nathan Redmond,eng ENG,FW,Burnley,,31.16164384,1994,0.2,0,0,0,0,0,0,0,,0,0,0,0,0,0,0,0
587,Michael Reindorf,eng ENG,FW,Cardiff City,,19.98356164,2005,0.6,1,0,0,0,1,1,1,100,0,0,0,0,0,1,0,0
588,Vicente Reyes,cl CHI,GK,Norwich City,,21.45479452,2003,3,0,0,0,0,0,0,0,,0,0,0,0,0,0,3,0
589,Yuri Ribeiro,pt POR,DF,Blackburn,,28.2739726,1997,15,24,15,16,4,4,13,20,65,7,11,2,9,16,40,56,0
590,Chris Rigg,eng ENG,"MF,FW",Sunderland,,17.87671233,2007,33.9,51,29,14,29,8,30,65,46.2,35,38,7,31,17,68,39,1
591,Emil Riis Jakobsen,dk DEN,FW,Preston,,26.86027397,1998,30.2,26,16,5,14,7,8,17,47.1,9,17,2,15,8,34,16,0
592,Andy Rinomhota,zw ZIM,"DF,MF",Cardiff City,,28.03561644,1997,23.4,69,40,34,29,6,34,51,66.7,17,24,9,15,20,89,80,2
593,Matt Ritchie,sct SCO,FW,Portsmouth,,35.64657534,1989,24.3,35,14,6,14,15,13,24,54.2,11,24,3,21,7,42,32,0
594,Caleb Roberts,eng ENG,MF,Plymouth Argyle,,20.5260274,2004,2.1,7,4,1,4,2,2,5,40,3,8,2,6,6,13,3,0
595,Connor Roberts,wls WAL,DF,Burnley,,29.6109589,1995,40.4,46,31,20,19,7,28,42,66.7,14,35,16,19,17,63,85,1
596,Haydon Roberts,eng ENG,"DF,MF",Bristol City,,22.98356164,2002,18.2,16,9,8,4,4,12,18,66.7,6,17,8,9,11,27,47,0
597,Liam Roberts,eng ENG,GK,Millwall,,30.44931507,1994,1,0,0,0,0,0,0,0,,0,0,0,0,0,0,1,0
598,Patrick Roberts,eng ENG,"FW,MF",Sunderland,,28.24109589,1997,36.4,62,42,28,24,10,26,85,30.6,59,29,4,25,19,81,37,0
599,Alexander Robertson,au AUS,MF,Cardiff City,,22.04657534,2003,26.8,65,37,25,22,18,29,51,56.9,22,43,10,33,36,101,23,0
600,Callum Robinson,ie IRL,"FW,MF",Cardiff City,,30.24931507,1995,22.5,7,6,2,2,3,5,8,62.5,3,11,2,9,6,13,5,1
601,Jack Robinson,eng ENG,DF,Sheffield Utd,,31.67123288,1993,31.6,39,27,21,17,1,19,24,79.2,5,23,16,7,23,62,171,1
602,Joe Rodon,wls WAL,DF,Leeds United,,27.53150685,1997,45.9,42,25,27,12,3,17,22,77.3,5,31,20,11,29,71,237,2
603,Ruben Rodrigues,pt POR,"MF,FW",Oxford United,,28.75342466,1996,25,50,26,19,20,11,19,38,50,19,32,6,26,19,69,22,2
604,Jay Rodriguez,eng ENG,FW,Burnley,,35.76438356,1989,8.3,9,7,1,7,1,3,6,50,3,7,2,5,2,11,12,0
605,Ole Romeny,id IDN,"FW,MF",Oxford United,,24.87123288,2000,6.6,2,1,1,1,0,2,5,40,3,2,0,2,0,2,5,0
606,Ronald,br BRA,"FW,MF",Swansea City,,23.88767123,2001,41.8,85,58,32,43,10,29,70,41.4,41,65,0,65,30,115,50,1
607,Kemar Roofe,jm JAM,"FW,MF",Derby County,,32.32328767,1993,0.1,0,0,0,0,0,0,0,,0,0,0,0,0,0,1,0
608,Michael Rose,sct SCO,DF,Stoke City,,29.56164384,1995,14.4,13,9,11,2,0,8,15,53.3,7,11,8,3,12,25,80,3
609,Joe Rothwell,eng ENG,MF,Leeds United,,30.30958904,1995,25,23,13,6,14,3,11,23,47.8,12,12,2,10,25,48,15,1
610,Pelly Ruddock Mpanzu,cd COD,MF,Luton Town,,31.79726027,1993,2.5,3,2,3,0,0,2,4,50,2,3,0,3,1,4,8,0
611,Jack Rudoni,eng ENG,"MF,FW",Coventry City,,24.93972603,2000,38.9,53,31,17,22,14,28,49,57.1,21,39,7,32,24,77,47,1
612,Carl Rushworth,eng ENG,GK,Hull City,,23.83835616,2001,2,0,0,0,0,0,0,0,,0,0,0,0,0,0,3,0
613,Nazariy Rusyn,ua UKR,FW,Sunderland,,26.52328767,1998,0.8,2,2,0,1,1,0,1,0,1,1,0,1,0,2,1,0
614,Georginio Rutter,fr FRA,"MF,FW",Leeds United,,23.03835616,2002,1,0,0,0,0,0,0,1,0,1,1,0,1,0,0,0,0
615,Sai Sachdev,eng ENG,DF,Sheffield Utd,,20.15342466,2005,0,0,0,0,0,0,0,0,,0,0,0,0,0,0,1,0
616,Borja Sainz,es ESP,FW,Norwich City,,24.25205479,2001,40.1,60,38,16,31,13,23,75,30.7,52,29,1,28,15,75,9,0
617,Koki Saito,jp JPN,"FW,MF",QPR,,23.73150685,2001,25.5,72,41,40,26,6,39,71,54.9,32,21,1,20,15,87,21,0
618,Tatsuhiro Sakamoto,jp JPN,"FW,MF",Coventry City,,28.53150685,1996,28.7,49,27,17,24,8,24,40,60,16,28,2,26,10,59,32,0
619,Yousef Salech,dk DEN,FW,Cardiff City,,23.29315068,2002,14.2,13,9,1,6,6,3,8,37.5,5,7,2,5,3,16,24,0
620,Lars-Jørgen Salvesen,no NOR,FW,Derby County,,29.20273973,1996,5.4,4,4,0,4,0,1,4,25,3,2,0,2,0,4,4,0
621,Shurandy Sambo,nl NED,MF,Burnley,,23.70684932,2001,0.2,1,0,0,0,1,0,1,0,1,0,0,0,2,3,0,0
622,Dion Sanderson,eng ENG,DF,Blackburn,,25.38356164,1999,6.3,3,0,2,1,0,3,3,100,0,6,4,2,6,9,38,0
623,Hevertton Santos,br BRA,DF,QPR,,24.25205479,2001,3.5,8,4,7,1,0,4,10,40,6,6,1,5,4,12,13,0
624,Josh Sargent,us USA,FW,Norwich City,,25.2,2000,27.8,19,12,6,9,4,7,16,43.8,9,16,4,12,2,21,26,0
625,Jeremy Sarmiento,ec ECU,"FW,MF",Burnley,,22.88219178,2002,13,36,21,9,20,7,17,34,50,17,13,0,13,7,43,8,0
626,George Saville,nir NIR,MF,Millwall,,31.92328767,1993,36.7,100,65,39,51,10,32,68,47.1,36,47,20,27,58,158,59,1
627,Christian Saydee,lr LBR,"MF,FW",Portsmouth,,22.98356164,2002,12.8,11,7,1,2,8,6,14,42.9,8,11,2,9,8,19,12,0
628,Calum Scanlon,eng ENG,"FW,DF",Millwall,,20.21643836,2005,1.9,6,3,2,4,0,1,2,50,1,3,1,2,1,7,3,0
629,Dane Scarlett,eng ENG,FW,Oxford United,,21.11232877,2004,8.8,3,0,0,2,1,0,5,0,5,0,0,0,6,9,8,0
630,Nicolas Schmid,at AUT,GK,Portsmouth,,28.19452055,1997,34.3,0,0,0,0,0,0,4,0,4,0,0,0,0,0,39,2
631,Isaac Schmidt,ch SUI,"FW,DF",Leeds United,,25.40547945,1999,0.9,5,3,3,0,2,4,5,80,1,0,0,0,4,9,5,0
632,Oscar Schwartau,dk DEN,"FW,MF",Norwich City,,18.96438356,2006,17.4,17,8,7,8,2,6,27,22.2,21,29,1,28,12,29,15,1
633,Jenson Seelt,nl NED,DF,Sunderland,,21.94794521,2003,0.2,1,0,1,0,0,1,1,100,0,1,0,1,0,1,1,0
634,Tatsuki Seko,jp JPN,MF,Stoke City,,27.36438356,1997,17.7,41,24,13,25,3,19,48,39.6,29,32,11,21,16,57,47,1
635,Tyrell Sellars-Fleming,eng ENG,"MF,FW",Hull City,,19.9260274,2005,0.1,0,0,0,0,0,0,0,,0,0,0,0,1,1,0,0
636,Egil Selvik,no NOR,GK,Watford,,27.76164384,1997,16,1,1,1,0,0,1,1,100,0,0,0,0,0,1,15,1
637,Ken Sema,se SWE,"DF,MF",Watford,,31.59178082,1993,5.8,17,12,12,4,1,10,20,50,10,4,1,3,5,22,12,1
638,Femi Seriki,eng ENG,DF,Sheffield Utd,,23.01643836,2002,12.1,33,25,17,15,1,16,23,69.6,7,18,6,12,9,42,41,2
639,Jamie Shackleton,eng ENG,"DF,FW",Sheffield Utd,,25.56986301,1999,3.2,10,9,8,2,0,6,11,54.5,5,3,0,3,1,11,6,0
640,Conor Shaughnessy,ie IRL,DF,Portsmouth,,28.84383562,1996,5.7,1,0,1,0,0,0,1,0,1,7,6,1,10,11,44,0
641,James Shea,eng ENG,GK,Luton Town,,33.88219178,1991,1.6,0,0,0,0,0,0,0,,0,0,0,0,0,0,0,0
642,Ben Sheaf,eng ENG,MF,Coventry City,,27.24109589,1998,23.7,63,32,35,20,8,31,54,57.4,23,32,12,20,21,84,28,0
643,Jonjo Shelvey,eng ENG,"MF,FW",Burnley,,33.18082192,1992,0.1,0,0,0,0,0,0,0,,0,0,0,0,1,1,1,0
644,Louie Sibley,eng ENG,MF,Oxford United,,23.67123288,2001,1.9,5,1,1,4,0,1,5,20,4,1,0,1,0,5,6,0
645,Sol Sidibé,fr FRA,MF,Stoke City,,18.22739726,2007,3.4,4,2,0,3,1,1,3,33.3,2,2,0,2,2,6,3,0
646,Francisco Sierralta,cl CHI,DF,Watford,,27.99452055,1997,21.1,36,24,23,13,0,17,28,60.7,11,32,24,8,26,62,152,1
647,Arnór Sigurðsson,is ISL,"FW,MF",Blackburn,,25.96986301,1999,0.7,1,1,0,1,0,1,1,100,0,1,0,1,0,1,0,0
648,Sam Silvera,au AUS,"FW,MF",Portsmouth,,24.52328767,2000,5,13,7,0,9,4,7,12,58.3,5,3,0,3,1,14,2,0
649,Ellis Simms,eng ENG,FW,Coventry City,,24.3260274,2001,25.4,3,2,1,0,2,0,1,0,1,3,0,3,2,5,16,2
650,Xavier Simons,eng ENG,MF,Hull City,,22.2,2003,13.4,22,12,7,12,3,10,16,62.5,6,20,15,5,12,34,30,0
651,Nathan Simpson,eng ENG,FW,Middlesbrough,,21.1890411,2004,0,0,0,0,0,0,0,0,,0,0,0,0,0,0,0,0
652,Emmanouil Siopis,gr GRE,MF,Cardiff City,,30.97260274,1994,16,46,28,19,22,5,21,44,47.7,23,25,4,21,22,68,24,0
653,Moussa Sissoko,fr FRA,"MF,FW",Watford,,35.71506849,1989,32.1,46,29,19,20,7,19,31,61.3,12,27,9,18,16,62,43,0
654,Regan Slater,eng ENG,MF,Hull City,,25.64383562,1999,33,38,26,13,13,12,17,50,34,33,29,9,20,14,52,46,0
655,Michael Smith,eng ENG,FW,Sheffield Weds,,33.54520548,1991,20.5,14,10,1,7,6,2,7,28.6,5,15,6,9,6,20,49,0
656,Paul Smyth,nir NIR,"FW,MF",QPR,,27.64657534,1997,30.8,44,30,10,25,9,21,47,44.7,26,30,3,27,12,56,25,0
657,Manor Solomon,il ISR,FW,Leeds United,,25.77808219,1999,28.8,30,24,10,6,14,16,37,43.2,21,23,0,23,12,42,5,1
658,Oliver Sonne,pe PER,DF,Burnley,,24.47945205,2000,0.3,0,0,0,0,0,0,0,,0,0,0,0,0,0,4,0
659,Matthew Sorinola,eng ENG,"DF,MF",Plymouth Argyle,,24.20273973,2001,18.6,45,34,24,16,5,22,39,56.4,17,34,10,24,19,64,80,0
660,Harry Souttar,au AUS,DF,Sheffield Utd,,26.53150685,1998,19.6,22,12,14,7,1,14,24,58.3,10,19,12,7,25,47,109,1
661,Vinicius Souza,br BRA,MF,Sheffield Utd,,25.87945205,1999,31,109,73,49,50,10,40,65,61.5,25,50,13,37,35,144,78,3
662,Jack Stacey,eng ENG,DF,Norwich City,,29.07671233,1996,23.8,55,41,31,14,10,28,49,57.1,21,29,9,20,20,75,74,0
663,Enda Stevens,ie IRL,DF,Stoke City,,34.81917808,1990,13.3,27,19,15,10,2,15,24,62.5,9,10,3,7,10,37,49,0
664,Ben Stevenson,eng ENG,MF,Portsmouth,,28.11506849,1997,0.1,0,0,0,0,0,0,0,,0,0,0,0,0,0,0,0
665,Jordan Storey,eng ENG,DF,Preston,,27.66849315,1997,34,52,33,31,15,6,32,45,71.1,13,45,25,20,57,109,106,1
666,Pascal Struijk,nl NED,DF,Leeds United,,25.72876712,1999,31.4,33,24,14,14,5,18,28,64.3,10,25,13,12,28,61,141,0
667,Zak Sturge,eng ENG,DF,Millwall,,20.88493151,2004,3.4,8,8,5,3,0,4,6,66.7,2,4,2,2,2,10,11,0
668,Callum Styles,hu HUN,DF,West Brom,,25.10136986,2000,29,65,47,41,17,7,36,55,65.5,19,32,7,25,40,105,98,0
669,Emmerson Sutton,eng ENG,FW,QPR,,18.34794521,2006,0.6,1,1,0,1,0,1,2,50,1,0,0,0,0,1,0,0
670,Zak Swanson,eng ENG,DF,Portsmouth,,24.59726027,2000,21.9,62,39,31,25,6,31,59,52.5,28,30,11,19,39,101,62,2
671,John Swift,eng ENG,MF,West Brom,,29.8630137,1995,19.3,35,19,15,13,7,18,29,62.1,11,13,1,12,6,41,19,2
672,Mark Sykes,ie IRL,"MF,DF",Bristol City,,27.74794521,1997,19,27,17,9,14,4,14,33,42.4,19,34,8,26,18,45,39,1
673,Sammie Szmodics,ie IRL,MF,Blackburn,,29.60821918,1995,0.3,0,0,0,0,0,0,1,0,1,0,0,0,0,0,0,0
674,Kornél Szűcs,hu HUN,DF,Plymouth Argyle,,23.60821918,2001,31.5,42,23,26,15,1,22,29,75.9,7,46,32,14,27,69,154,1
675,Elias Sørensen,dk DEN,"FW,MF",Portsmouth,,25.62465753,1999,3.6,4,4,4,0,0,2,7,28.6,5,4,0,4,2,6,3,0
676,Jakob Sørensen,dk DEN,"MF,DF",Norwich City,,27.16986301,1998,14.7,37,22,20,9,8,13,21,61.9,8,18,6,12,12,49,38,1
677,Maksym Talovierov,ua UKR,DF,Plymouth Argyle,,24.84931507,2000,10.4,28,19,18,9,1,12,20,60,8,12,5,7,8,36,74,0
678,Ao Tanaka,jp JPN,MF,Leeds United,,26.64657534,1998,36.8,93,55,37,39,17,46,91,50.5,45,46,7,39,54,147,40,2
679,Japhet Tanganga,eng ENG,DF,Millwall,,26.09315068,1999,39.5,56,37,36,19,1,21,31,67.7,10,39,24,15,36,92,220,2
680,George Tanner,eng ENG,DF,Bristol City,,25.4630137,1999,22.2,57,39,38,15,4,40,61,65.6,21,30,12,18,20,77,75,0
681,Ollie Tanner,eng ENG,"FW,MF",Cardiff City,,22.97534247,2002,15.4,43,29,15,22,6,17,38,44.7,21,16,1,15,11,54,15,0
682,Fabio Tavares,eng ENG,FW,Coventry City,,24.27945205,2001,0,0,0,0,0,0,0,0,,0,0,0,0,0,0,0,0
683,Joseph Taylor,wls WAL,"FW,MF",Luton Town,,22.45753425,2002,1.7,0,0,0,0,0,0,3,0,3,3,0,3,0,0,1,0
684,Junior Tchamadeu,cm CMR,DF,Stoke City,,21.36438356,2003,34.8,45,30,24,12,9,21,39,53.8,18,38,11,27,23,68,91,2
685,Hidde ter Avest,nl NED,DF,Oxford United,,27.95616438,1997,11.1,27,14,13,9,5,16,22,72.7,6,13,5,8,14,41,63,0
686,Emre Tezgel,eng ENG,"FW,MF",Stoke City,,19.62191781,2005,3.3,2,1,1,0,1,1,1,100,0,4,0,4,2,4,3,0
687,Bobby Thomas,eng ENG,DF,Coventry City,,0,,37,44,32,28,14,2,27,45,60,18,52,30,22,38,82,214,0
688,Joshua Thomas,wls WAL,MF,Swansea City,,22.60821918,2002,0,0,0,0,0,0,0,0,,0,0,0,0,0,0,0,0
689,Brandon Thomas-Asante,gh GHA,FW,Coventry City,,26.34520548,1998,16.1,14,6,6,3,5,2,6,33.3,4,8,1,7,11,25,9,0
690,Jordan Thompson,nir NIR,"MF,DF",Stoke City,,28.33150685,1997,15,15,10,6,7,2,6,13,46.2,7,9,5,4,14,29,34,1
691,Liam Thompson,eng ENG,MF,Derby County,,23.01369863,2002,17.9,29,18,13,13,3,14,32,43.8,18,16,1,15,19,48,17,2
692,Jordan Thorniley,eng ENG,DF,Oxford United,,28.44109589,1996,0.9,0,0,0,0,0,0,0,,0,1,1,0,2,2,5,0
693,Muhamed Tijani,ng NGA,"FW,MF",Plymouth Argyle,,24.77260274,2000,5,2,1,1,0,1,0,2,0,2,5,2,3,1,3,8,0
694,Nathan Tjoe-A-On,id IDN,DF,Swansea City,,23.36438356,2001,0,0,0,0,0,0,0,0,,0,1,0,1,0,0,0,0
695,Victor Torp,dk DEN,MF,Coventry City,,25.76164384,1999,23.4,51,32,19,24,8,18,40,45,22,32,6,26,29,80,33,1
696,Balázs Tóth,hu HUN,GK,Blackburn,,27.6630137,1997,6,0,0,0,0,0,0,0,,0,1,0,1,0,0,1,0
697,Ryley Towler,eng ENG,DF,Portsmouth,,24.00547945,2001,10.4,13,3,7,4,2,6,11,54.5,5,12,8,4,6,19,54,0
698,Andros Townsend,eng ENG,MF,Luton Town,,33.8,1991,0.1,0,0,0,0,0,0,0,,0,0,0,0,0,0,0,0
699,James Trafford,eng ENG,GK,Burnley,,22.56438356,2002,45,1,1,1,0,0,1,1,100,0,0,0,0,0,1,20,2
700,Mark Travers,ie IRL,GK,Middlesbrough,,25.96164384,1999,17,0,0,0,0,0,0,1,0,1,0,0,0,0,0,11,1
701,Lewis Travis,eng ENG,MF,Blackburn,,27.54794521,1997,35.7,103,63,40,56,7,55,118,46.6,63,46,7,39,36,139,47,0
702,Nectarios Triantis,au AUS,FW,Sunderland,,21.98082192,2003,0,0,0,0,0,0,0,0,,0,0,0,0,0,0,0,0
703,Sondre Tronstad,no NOR,MF,Blackburn,,29.68767123,1995,34.8,92,66,43,43,6,42,68,61.8,26,53,16,37,43,135,58,2
704,Auston Trusty,us USA,DF,Sheffield Utd,,26.7260274,1998,1,1,0,0,1,0,0,1,0,1,0,0,0,0,1,0,0
705,David Turnbull,sct SCO,MF,Cardiff City,,25.81643836,1999,9.2,17,13,8,6,3,8,15,53.3,7,10,2,8,6,23,9,1
706,Scott Twine,eng ENG,"FW,MF",Bristol City,,25.80547945,1999,23.5,48,27,13,22,13,18,36,50,18,17,0,17,16,64,14,0
707,Igor Tyjon,eng ENG,FW,Blackburn,,17.12328767,2008,0.1,0,0,0,0,0,0,1,0,1,1,0,1,0,0,0,0
708,Josh Tymon,eng ENG,DF,Swansea City,,25.95068493,1999,43.8,47,29,27,13,7,29,51,56.9,22,30,6,24,59,106,84,3
709,Ike Ugbo,ca CAN,FW,Sheffield Weds,,26.61643836,1998,14.2,7,7,3,3,1,2,6,33.3,4,11,0,11,6,13,7,1
710,Pol Valentín,es ESP,"DF,MF",Sheffield Weds,,28.19726027,1997,17,43,25,21,16,6,19,36,52.8,17,20,4,16,21,64,58,0
711,Yan Valery,tn TUN,"DF,MF",Sheffield Weds,,26.19452055,1999,35,54,31,26,22,6,18,33,54.5,15,34,6,28,51,105,100,2
712,Jonathan Varane,mq MTQ,MF,QPR,,23.64931507,2001,28.9,75,41,38,32,5,31,45,68.9,14,50,11,39,46,121,75,0
713,Rocco Vata,ie IRL,"FW,MF",Watford,,20.04383562,2005,17.1,31,17,11,14,6,16,35,45.7,19,18,0,18,11,42,10,1
714,Harry Vaughan,ie IRL,FW,Hull City,,21.07671233,2004,1.1,3,3,1,0,2,1,2,50,1,1,0,1,1,4,1,0
715,Will Vaulks,wls WAL,MF,Oxford United,,31.63835616,1993,37.1,88,54,41,42,5,49,107,45.8,58,56,13,43,37,125,89,4
716,Josh Vickers,eng ENG,GK,Derby County,,29.42191781,1995,6,0,0,0,0,0,0,0,,0,0,0,0,0,0,1,0
717,André Vidigal,ao ANG,"MF,FW",Stoke City,,26.71232877,1998,1.2,3,2,1,2,0,0,1,0,1,2,0,2,2,5,0,0
718,Lawrence Vigouroux,cl CHI,GK,Swansea City,,31.45479452,1993,46,2,1,2,0,0,2,4,50,2,0,0,0,0,2,18,7
719,Žan Vipotnik,si SVN,FW,Swansea City,,23.12876712,2002,23.2,6,3,0,3,3,0,4,0,4,15,5,10,2,8,22,1
720,Vitinho,br BRA,"MF,FW",Burnley,,25.78082192,1999,2.6,8,6,4,1,3,6,10,60,4,4,1,3,1,9,4,0
721,Zak Vyner,ke KEN,DF,Bristol City,,27.97260274,1997,46,67,51,41,24,2,34,58,58.6,24,58,37,21,44,111,202,2
722,Thomas Waddingham,au AUS,FW,Portsmouth,,20,2005,1.1,3,0,0,1,2,3,3,100,0,0,0,0,0,3,1,0
723,Ben Waine,nz NZL,FW,Plymouth Argyle,,23.89589041,2001,0.1,0,0,0,0,0,0,0,,0,0,0,0,0,0,0,0
724,Jed Wallace,eng ENG,"FW,MF",West Brom,,31.10684932,1994,9,17,13,5,11,1,6,16,37.5,10,9,1,8,2,19,10,1
725,Murray Wallace,sct SCO,DF,Millwall,,32.31232877,1993,8.1,7,5,4,3,0,4,4,100,0,7,5,2,5,12,59,0
726,Joe Walsh,eng ENG,GK,QPR,,23.09041096,2002,1,0,0,0,0,0,0,0,,0,0,0,0,0,0,0,0
727,Liam Walsh,eng ENG,MF,Luton Town,,27.63287671,1997,15.7,34,18,14,13,7,19,37,51.4,18,12,4,8,9,43,29,0
728,Reuell Walters,eng ENG,DF,Luton Town,,20.38082192,2004,10.9,40,28,17,15,8,20,23,87,3,5,3,2,3,43,23,2
729,Joe Ward,eng ENG,DF,Derby County,,29.69863014,1995,1.7,2,2,2,0,0,1,2,50,1,1,0,1,4,6,3,0
730,Duncan Watmore,eng ENG,"FW,MF",Millwall,,31.15616438,1994,17.5,23,12,6,11,6,10,28,35.7,18,16,2,14,7,30,11,0
731,Tom Watson,eng ENG,"FW,MF",Sunderland,,19.07123288,2006,9.9,15,10,8,4,3,10,24,41.7,14,18,2,16,5,20,14,0
732,Wout Weghorst,nl NED,FW,Burnley,,32.73972603,1992,0.3,0,0,0,0,0,0,0,,0,0,0,0,0,0,0,0
733,Andreas Weimann,at AUT,"FW,MF",Blackburn,,33.74520548,1991,15.7,9,4,2,6,1,3,6,50,3,11,0,11,4,13,22,0
734,Nahki Wells,bm BER,FW,Bristol City,,34.92328767,1990,22.8,30,20,8,14,8,7,26,26.9,19,21,2,19,12,42,5,1
735,Jack Whatmough,eng ENG,DF,Preston,,28.70684932,1996,12.4,27,16,15,9,3,14,16,87.5,2,24,19,5,13,40,80,1
736,Lennon Wheeldon,eng ENG,FW,Derby County,,18.38082192,2006,0,0,0,0,0,0,0,0,,0,0,0,0,0,0,0,0
737,Ben Whiteman,eng ENG,MF,Preston,,28.87945205,1996,27.7,50,23,28,16,6,32,53,60.4,21,39,13,26,20,70,71,0
738,Morgan Whittaker,eng ENG,"FW,MF",Plymouth Argyle,,24.32054795,2001,19.4,36,23,18,13,5,13,31,41.9,18,19,3,16,3,39,20,0
739,Morgan Whittaker,eng ENG,"MF,FW",Middlesbrough,,24.32054795,2001,11,9,4,3,2,4,4,11,36.4,7,11,1,10,6,15,13,0
740,Harry Whitwell,eng ENG,FW,West Brom,,19.4630137,2005,0.1,1,1,1,0,0,0,0,,0,1,1,0,0,1,1,0
741,Jacob Widell Zetterström,se SWE,GK,Derby County,,26.81369863,1998,40,2,2,2,0,0,2,5,40,3,0,0,0,1,3,20,4
742,Joe Wildsmith,eng ENG,GK,West Brom,,29.34794521,1995,10,1,1,1,0,0,1,1,100,0,0,0,0,0,1,8,1
743,Caleb Wiley,us USA,"DF,MF",Watford,,20.36438356,2004,8,17,11,11,5,1,10,16,62.5,6,7,1,6,5,22,27,0
744,Joe Williams,eng ENG,MF,Bristol City,,28.40273973,1996,15.7,30,18,9,18,3,12,25,48,13,16,9,7,13,43,25,1
745,Jordan Williams,eng ENG,DF,Portsmouth,,25.53150685,1999,14.1,45,30,29,15,1,23,34,67.6,11,20,10,10,21,66,36,0
746,Chris Willock,eng ENG,FW,Cardiff City,,27.25479452,1998,17.2,26,22,12,10,4,16,29,55.2,13,10,0,10,7,33,4,0
747,Ben Wilmot,eng ENG,DF,Stoke City,,25.49589041,1999,36,54,35,36,15,3,26,40,65,14,60,30,30,45,99,227,2
748,Ben Wilson,eng ENG,GK,Coventry City,,32.73424658,1992,4,0,0,0,0,0,0,0,,0,0,0,0,0,0,3,1
749,Kane Wilson,eng ENG,DF,Derby County,,25.14794521,2000,27,52,30,27,11,14,19,29,65.5,10,25,5,20,15,67,86,0
750,Josh Wilson-Esbrand,eng ENG,"DF,FW",Stoke City,,22.35342466,2002,3,2,1,0,2,0,1,6,16.7,5,4,0,4,2,4,4,1
751,Josh Windass,eng ENG,"MF,FW",Sheffield Weds,,31.31506849,1994,35.8,36,19,15,18,3,17,35,48.6,18,21,1,20,12,48,31,1
752,Ryan Wintle,eng ENG,MF,Millwall,,27.89041096,1997,5.7,11,4,6,5,0,3,10,30,7,8,3,5,8,19,15,0
753,Maximilian Wöber,at AUT,DF,Leeds United,,27.24383562,1998,3.7,10,6,6,2,2,6,8,75,2,5,0,5,10,20,14,0
754,Freddie Woodman,eng ENG,GK,Preston,,28.16712329,1997,37,1,1,1,0,0,1,3,33.3,2,2,0,2,0,1,35,5
755,Cauley Woodrow,eng ENG,"MF,FW",Blackburn,,30.41917808,1994,2.5,2,0,1,1,0,1,4,25,3,1,0,1,0,2,3,0
756,Cauley Woodrow,eng ENG,"MF,FW",Luton Town,,30.41917808,1994,3,5,3,3,1,1,2,5,40,3,8,0,8,1,6,3,0
757,Joe Worrall,eng ENG,DF,Burnley,,28.31232877,1997,3.2,3,2,3,0,0,2,2,100,0,2,1,1,2,5,14,0
758,Callum Wright,eng ENG,"MF,FW",Plymouth Argyle,,25.00547945,2000,16.2,24,15,10,8,6,7,29,24.1,22,17,2,15,5,29,23,1
759,Haji Wright,us USA,FW,Coventry City,,27.10410959,1998,21.6,17,11,4,9,4,5,12,41.7,7,9,3,6,6,23,25,0
760,Jacob Wright,eng ENG,MF,Norwich City,,19.61643836,2005,9.9,27,20,9,15,3,13,34,38.2,21,14,4,10,11,38,13,0
761,Jerry Yates,eng ENG,FW,Derby County,,28.47945205,1996,38,14,8,3,7,4,5,22,22.7,17,22,1,21,7,21,21,0
762,Kusini Yengi,au AUS,"FW,MF",Portsmouth,,26.29863014,1999,6,3,2,0,2,1,1,4,25,3,5,1,4,0,3,8,0
763,Óscar Zambrano,ec ECU,MF,Hull City,,21.03835616,2004,4.3,11,5,5,4,2,8,13,61.5,5,9,4,5,2,13,4,1
764,Anass Zaroury,ma MAR,"FW,MF",Burnley,,24.48767123,2000,0.3,1,1,1,0,0,1,1,100,0,1,0,1,0,1,0,0
765,Stefán Þórðarson,is ISL,MF,Preston,,26.54794521,1998,27.8,33,22,14,14,5,15,39,38.5,24,20,4,16,21,54,33,1